year,Team,college,PLAYER,player_height,player_weight,Pos_x,GP,MIN,FGM,FGA,FG_PCT,FG3M,FG3A,FG3_PCT,FTM,FTA,FT_PCT,OREB,DREB,REB,AST,STL,BLK,TOV,PF,PTS,FGMI,FG3MI,FTMI,fg_production,fg3_production,ft_production,ancillary_production,shooting_production,total_production,fg_efficiency,fg3_efficiency,ft_efficiency
2020,Golden State Warriors,Davidson,Stephen Curry,190.5,83.91452,PG,63,2152,658,1365,0.482,337,801,0.421,362,395,0.916,29,316,345,363,77,8,213,119,2015,707,464,33,-98,-381,329,114.3,-150,-35.7,0.48205128205128206,0.4207240948813982,0.9164556962025316
2020,Portland Trail Blazers,Weber State,Damian Lillard,187.96,88.45044,PG,67,2398,602,1334,0.451,275,704,0.391,449,484,0.928,32,251,283,505,62,17,203,102,1928,732,429,35,-260,-462,414,137.9,-308,-170.1,0.4512743628185907,0.390625,0.9276859504132231
2020,Washington Wizards,Florida,Bradley Beal,190.5,93.893544,SG,60,2147,670,1382,0.485,130,373,0.349,408,459,0.889,72,211,283,265,69,22,187,140,1878,712,243,51,-84,-339,357,100.0,-66,34.0,0.48480463096960924,0.3485254691689008,0.8888888888888888
2020,Milwaukee Bucks,,Giannis Antetokounmpo,210.82,109.769264,PF,61,2013,626,1100,0.569,67,221,0.303,398,581,0.685,97,574,671,357,72,73,207,168,1717,474,154,183,304,-261,215,241.85,258,499.85,0.5690909090909091,0.3031674208144796,0.685025817555938
2020,Phoenix Suns,Kentucky,Devin Booker,195.58,93.439952,SG,67,2270,623,1287,0.484,126,371,0.34,340,392,0.867,34,247,281,289,53,16,207,181,1712,664,245,52,-82,-357,288,72.95,-151,-78.05,0.4840714840714841,0.33962264150943394,0.8673469387755102
2020,New York Knicks,Kentucky,Julius Randle,203.2,113.398,PF,71,2667,602,1321,0.456,160,389,0.411,348,429,0.811,84,640,724,427,64,18,241,225,1712,719,229,81,-234,-207,267,218.0,-174,44.0,0.45571536714610145,0.41131105398457585,0.8111888111888111
2020,Boston Celtics,Duke,Jayson Tatum,203.2,95.25432,SF,64,2290,605,1318,0.459,187,485,0.386,295,340,0.868,50,422,472,276,75,31,171,122,1692,713,298,45,-216,-333,250,160.9,-299,-138.1,0.4590288315629742,0.38556701030927837,0.8676470588235294
2020,New Orleans Pelicans,Duke,Zion Williamson,200.66,128.820128,PF,61,2026,634,1037,0.611,10,34,0.294,369,529,0.698,167,274,441,226,57,39,167,135,1647,403,24,160,462,-42,209,166.25,629,795.25,0.6113789778206364,0.29411764705882354,0.6975425330812854
2020,Atlanta Hawks,Oklahoma,Trae Young,185.42,81.64656,PG,63,2125,487,1112,0.438,136,397,0.343,484,546,0.886,38,207,245,594,53,12,261,111,1594,625,261,62,-276,-375,422,115.7,-229,-113.3,0.4379496402877698,0.3425692695214106,0.8864468864468864
2020,Chicago Bulls,UCLA,Zach LaVine,195.58,90.7184,SG,58,2034,569,1123,0.507,200,477,0.419,253,298,0.849,36,253,289,282,46,27,203,138,1591,554,277,45,30,-231,208,79.85,7,86.85,0.5066785396260017,0.4192872117400419,0.8489932885906041
2020,Sacramento Kings,Kentucky,De'Aaron Fox,190.5,83.91452,PG,58,2036,529,1110,0.477,103,320,0.322,300,417,0.719,33,170,203,417,87,27,174,170,1461,581,217,117,-104,-342,183,124.75,-263,-138.25,0.4765765765765766,0.321875,0.7194244604316546
2020,Cleveland Cavaliers,Alabama,Collin Sexton,185.42,86.18248,SG,60,2115,525,1105,0.475,98,264,0.371,312,383,0.815,58,129,187,262,62,10,167,157,1460,580,166,71,-110,-204,241,71.4,-73,-1.5999999999999943,0.4751131221719457,0.3712121212121212,0.814621409921671
2020,Philadelphia 76ers,Kansas,Joel Embiid,213.36,127.00576,C,51,1585,461,899,0.513,58,154,0.377,471,548,0.859,113,426,539,145,50,69,159,123,1451,438,96,77,46,-114,394,173.1,326,499.1,0.5127919911012235,0.37662337662337664,0.8594890510948905
2020,Brooklyn Nets,Duke,Kyrie Irving,187.96,88.45044,PG,54,1886,549,1086,0.506,152,378,0.402,201,218,0.922,52,205,257,324,76,37,130,140,1451,537,226,17,24,-222,184,142.75,-14,128.75,0.505524861878453,0.4021164021164021,0.9220183486238532
2020,New Orleans Pelicans,Duke,Brandon Ingram,203.2,86.18248,SF,61,2092,513,1101,0.466,143,375,0.381,281,320,0.878,34,265,299,296,42,36,154,124,1450,588,232,39,-150,-267,242,113.05,-175,-61.95,0.4659400544959128,0.38133333333333336,0.878125
2020,Washington Wizards,UCLA,Russell Westbrook,190.5,90.7184,PG,65,2369,544,1238,0.439,86,273,0.315,271,413,0.656,109,641,750,763,89,23,312,190,1445,694,187,142,-300,-303,129,296.0,-474,-178.0,0.4394184168012924,0.315018315018315,0.6561743341404358
2020,Boston Celtics,California,Jaylen Brown,198.12,101.151016,SG,58,1999,538,1111,0.484,163,411,0.397,191,250,0.764,71,276,347,195,72,32,158,168,1430,573,248,59,-70,-255,132,117.85,-193,-75.15,0.48424842484248426,0.39659367396593675,0.764
2020,Charlotte Hornets,Louisville,Terry Rozier,185.42,86.18248,SG,69,2383,510,1134,0.45,222,571,0.389,165,202,0.817,47,255,302,293,87,26,128,119,1407,624,349,37,-228,-381,128,147.05,-481,-333.95,0.4497354497354497,0.38879159369527144,0.8168316831683168
2020,Utah Jazz,Louisville,Donovan Mitchell,185.42,97.52228,PG,53,1771,478,1091,0.438,178,461,0.386,267,316,0.845,50,185,235,277,52,15,147,117,1401,613,283,49,-270,-315,218,94.65,-367,-272.35,0.4381301558203483,0.38611713665943603,0.8449367088607594
2020,Minnesota Timberwolves,Georgia,Anthony Edwards,193.04,102.0582,SG,72,2314,505,1211,0.417,171,520,0.329,211,272,0.776,59,277,336,211,82,36,160,129,1392,706,349,61,-402,-534,150,124.05,-786,-661.95,0.41701073492981006,0.32884615384615384,0.7757352941176471
2020,Milwaukee Bucks,Texas A&M,Khris Middleton,200.66,100.697424,SF,68,2269,511,1074,0.476,151,365,0.414,212,236,0.898,54,352,406,370,74,9,178,160,1385,563,214,24,-104,-189,188,152.0,-105,47.0,0.4757914338919926,0.4136986301369863,0.8983050847457628
2020,Golden State Warriors,Kansas,Andrew Wiggins,200.66,89.357624,PF,71,2364,505,1058,0.477,140,368,0.38,170,238,0.714,82,265,347,167,67,70,126,159,1320,553,228,68,-96,-264,102,146.55,-258,-111.44999999999999,0.4773156899810964,0.3804347826086957,0.7142857142857143
2020,San Antonio Spurs,Southern California,DeMar DeRozan,198.12,99.79024,PF,61,2056,455,920,0.495,19,74,0.257,387,440,0.88,40,219,259,422,56,15,119,128,1316,465,55,53,-20,-108,334,149.85,206,355.85,0.4945652173913043,0.25675675675675674,0.8795454545454545
2020,Los Angeles Clippers,San Diego State,Kawhi Leonard,200.66,102.0582,SF,52,1772,465,908,0.512,101,254,0.398,261,295,0.885,55,282,337,269,81,21,105,82,1292,443,153,34,44,-156,227,159.65,115,274.65,0.512114537444934,0.39763779527559057,0.8847457627118644
2020,Portland Trail Blazers,UCLA,Norman Powell,190.5,97.52228,SG,69,2206,438,918,0.477,171,416,0.411,236,271,0.871,42,173,215,129,82,18,119,160,1283,480,245,35,-84,-222,201,79.0,-105,-26.0,0.477124183006536,0.4110576923076923,0.8708487084870848
2020,Portland Trail Blazers,UCLA,Norman Powell,190.5,97.52228,SG,69,2206,438,918,0.477,171,416,0.411,236,271,0.871,42,173,215,129,82,18,119,160,1283,480,245,35,-84,-222,201,79.0,-105,-26.0,0.477124183006536,0.4110576923076923,0.8708487084870848
2020,Portland Trail Blazers,UCLA,Norman Powell,190.5,97.52228,SG,69,2206,438,918,0.477,171,416,0.411,236,271,0.871,42,173,215,129,82,18,119,160,1283,480,245,35,-84,-222,201,79.0,-105,-26.0,0.477124183006536,0.4110576923076923,0.8708487084870848
2020,Portland Trail Blazers,UCLA,Norman Powell,190.5,97.52228,SG,69,2206,438,918,0.477,171,416,0.411,236,271,0.871,42,173,215,129,82,18,119,160,1283,480,245,35,-84,-222,201,79.0,-105,-26.0,0.477124183006536,0.4110576923076923,0.8708487084870848
2020,Portland Trail Blazers,UCLA,Norman Powell,190.5,97.52228,SG,69,2206,438,918,0.477,171,416,0.411,236,271,0.871,42,173,215,129,82,18,119,160,1283,480,245,35,-84,-222,201,79.0,-105,-26.0,0.477124183006536,0.4110576923076923,0.8708487084870848
2020,Portland Trail Blazers,UCLA,Norman Powell,190.5,97.52228,SG,69,2206,438,918,0.477,171,416,0.411,236,271,0.871,42,173,215,129,82,18,119,160,1283,480,245,35,-84,-222,201,79.0,-105,-26.0,0.477124183006536,0.4110576923076923,0.8708487084870848
2020,Portland Trail Blazers,UCLA,Norman Powell,190.5,97.52228,SF,69,2206,438,918,0.477,171,416,0.411,236,271,0.871,42,173,215,129,82,18,119,160,1283,480,245,35,-84,-222,201,79.0,-105,-26.0,0.477124183006536,0.4110576923076923,0.8708487084870848
2020,Portland Trail Blazers,UCLA,Norman Powell,190.5,97.52228,SF,69,2206,438,918,0.477,171,416,0.411,236,271,0.871,42,173,215,129,82,18,119,160,1283,480,245,35,-84,-222,201,79.0,-105,-26.0,0.477124183006536,0.4110576923076923,0.8708487084870848
2020,Portland Trail Blazers,UCLA,Norman Powell,190.5,97.52228,SF,69,2206,438,918,0.477,171,416,0.411,236,271,0.871,42,173,215,129,82,18,119,160,1283,480,245,35,-84,-222,201,79.0,-105,-26.0,0.477124183006536,0.4110576923076923,0.8708487084870848
2020,New York Knicks,Duke,RJ Barrett,198.12,97.068688,SG,72,2511,467,1060,0.441,124,309,0.401,206,276,0.746,68,346,414,217,53,20,139,188,1264,593,185,70,-252,-183,136,132.35,-299,-166.65,0.44056603773584907,0.40129449838187703,0.7463768115942029
2020,Indiana Pacers,Gonzaga,Domantas Sabonis,210.82,108.86208,PF,62,2231,484,904,0.535,52,162,0.321,240,328,0.732,150,592,742,415,76,33,213,203,1260,420,110,88,128,-174,152,264.6,106,370.6,0.5353982300884956,0.32098765432098764,0.7317073170731707
2020,Los Angeles Clippers,Fresno State,Paul George,203.2,99.79024,SF,54,1821,445,953,0.467,171,416,0.411,198,228,0.868,45,314,359,280,62,24,179,132,1259,508,245,30,-126,-222,168,117.9,-180,-62.099999999999994,0.4669464847848898,0.4110576923076923,0.868421052631579
2020,Utah Jazz,Missouri,Jordan Clarkson,193.04,87.996848,SG,68,1818,457,1075,0.425,208,599,0.347,129,144,0.896,47,227,274,168,61,10,115,110,1251,618,391,15,-322,-549,114,94.75,-757,-662.25,0.42511627906976746,0.34724540901502504,0.8958333333333334
2020,Minnesota Timberwolves,Kentucky,Karl-Anthony Towns,210.82,112.490816,C,50,1689,425,875,0.486,122,315,0.387,267,311,0.859,133,396,529,225,39,57,160,186,1239,450,193,44,-50,-213,223,180.45,-40,140.45,0.4857142857142857,0.3873015873015873,0.8585209003215434
2020,Philadelphia 76ers,Tennessee,Tobias Harris,203.2,102.511792,PF,62,2014,473,924,0.512,82,208,0.394,182,204,0.892,62,357,419,220,55,51,107,119,1210,451,126,22,44,-132,160,168.8,72,240.8,0.5119047619047619,0.3942307692307692,0.8921568627450981
2020,Detroit Pistons,Syracuse,Jerami Grant,203.2,95.25432,SF,54,1829,400,932,0.429,115,329,0.35,290,343,0.845,35,215,250,152,35,58,109,125,1205,532,214,53,-264,-297,237,95.0,-324,-229.0,0.4291845493562232,0.3495440729483283,0.8454810495626822
2020,Memphis Grizzlies,Murray State,Ja Morant,190.5,78.92500799999999,PG,63,2053,430,957,0.449,73,241,0.303,271,372,0.728,59,193,252,465,57,13,203,87,1204,527,168,101,-194,-285,170,123.15,-309,-185.85,0.44932079414838033,0.3029045643153527,0.728494623655914
2020,Miami Heat,Kentucky,Bam Adebayo,205.74,115.66596,C,64,2143,456,800,0.57,2,8,0.25,283,354,0.799,142,431,573,346,75,66,169,145,1197,344,6,71,224,-12,212,244.0,424,668.0,0.57,0.25,0.7994350282485876
2020,Toronto Raptors,New Mexico State,Pascal Siakam,205.74,104.32616,PF,56,2006,437,961,0.455,73,246,0.297,249,301,0.827,95,310,405,250,64,37,130,174,1196,524,173,52,-174,-300,197,164.3,-277,-112.69999999999999,0.4547346514047867,0.2967479674796748,0.8272425249169435
2020,Indiana Pacers,Virginia,Malcolm Brogdon,195.58,103.872568,PG,56,1930,444,980,0.453,145,374,0.388,153,177,0.864,58,236,294,329,49,15,115,110,1186,536,229,24,-184,-252,129,139.25,-307,-167.75,0.4530612244897959,0.3877005347593583,0.864406779661017
2020,Sacramento Kings,Oklahoma,Buddy Hield,193.04,99.79024,SG,71,2433,403,992,0.406,282,721,0.391,88,104,0.846,29,305,334,257,63,30,130,175,1176,589,439,16,-372,-471,72,127.75,-771,-643.25,0.40625,0.391123439667129,0.8461538461538461
2020,Dallas Mavericks,Michigan,Tim Hardaway Jr.,195.58,92.98636,SG,70,1985,407,911,0.447,207,529,0.391,142,174,0.816,20,209,229,126,31,11,64,111,1163,504,322,32,-194,-345,110,77.2,-429,-351.8,0.446761800219539,0.391304347826087,0.8160919540229885
2020,Denver Nuggets,Missouri,Michael Porter Jr.,208.28,98.883056,SF,61,1912,443,817,0.542,170,382,0.445,106,134,0.791,91,354,445,70,40,54,77,126,1162,374,212,28,138,-126,78,153.7,90,243.7,0.5422276621787026,0.44502617801047123,0.7910447761194029
2020,Memphis Grizzlies,Oregon,Dillon Brooks,200.66,102.0582,SF,67,1997,432,1031,0.419,128,372,0.344,159,195,0.815,53,143,196,157,78,26,119,237,1151,599,244,36,-334,-348,123,82.15,-559,-476.85,0.4190106692531523,0.34408602150537637,0.8153846153846154
2020,Phoenix Suns,Wake Forest,Chris Paul,182.88,79.3786,PG,70,2200,439,879,0.499,102,258,0.395,169,181,0.934,25,287,312,622,99,19,156,166,1149,440,156,12,-2,-162,157,212.45,-7,205.45,0.49943117178612056,0.3953488372093023,0.9337016574585635
2020,Los Angeles Lakers,,LeBron James,205.74,113.398,PG,45,1504,422,823,0.513,104,285,0.365,178,255,0.698,29,317,346,350,48,25,168,70,1126,401,181,77,42,-231,101,130.25,-88,42.25,0.5127582017010935,0.3649122807017544,0.6980392156862745
2020,Miami Heat,Marquette,Jimmy Butler,200.66,104.32616,SF,52,1745,366,736,0.497,25,102,0.245,359,416,0.863,94,265,359,369,108,18,109,71,1116,370,77,57,-8,-156,302,210.45,138,348.45,0.49728260869565216,0.24509803921568626,0.8629807692307693
2020,Atlanta Hawks,Wake Forest,John Collins,205.74,106.59412,PF,63,1848,429,771,0.556,83,208,0.399,170,204,0.833,118,349,467,78,34,63,84,193,1111,342,125,34,174,-126,136,162.6,184,346.6,0.556420233463035,0.39903846153846156,0.8333333333333334
2020,Portland Trail Blazers,Lehigh,CJ McCollum,190.5,86.18248,SG,47,1600,405,884,0.458,169,420,0.402,108,133,0.812,30,155,185,223,44,21,65,87,1087,479,251,25,-148,-246,83,105.15,-311,-205.85,0.4581447963800905,0.4023809523809524,0.8120300751879699
2020,Brooklyn Nets,Arizona State,James Harden,195.58,99.79024,PG,44,1609,342,734,0.466,121,334,0.362,278,323,0.861,35,313,348,475,53,33,177,99,1083,392,213,45,-100,-276,233,164.05,-143,21.05000000000001,0.4659400544959128,0.36227544910179643,0.8606811145510835
2020,Brooklyn Nets,Arizona State,James Harden,195.58,99.79024,PG,44,1609,342,734,0.466,121,334,0.362,278,323,0.861,35,313,348,475,53,33,177,99,1083,392,213,45,-100,-276,233,164.05,-143,21.05000000000001,0.4659400544959128,0.36227544910179643,0.8606811145510835
2020,Brooklyn Nets,Arizona State,James Harden,195.58,99.79024,PG,44,1609,342,734,0.466,121,334,0.362,278,323,0.861,35,313,348,475,53,33,177,99,1083,392,213,45,-100,-276,233,164.05,-143,21.05000000000001,0.4659400544959128,0.36227544910179643,0.8606811145510835
2020,Brooklyn Nets,Arizona State,James Harden,195.58,99.79024,PG,44,1609,342,734,0.466,121,334,0.362,278,323,0.861,35,313,348,475,53,33,177,99,1083,392,213,45,-100,-276,233,164.05,-143,21.05000000000001,0.4659400544959128,0.36227544910179643,0.8606811145510835
2020,Brooklyn Nets,Arizona State,James Harden,195.58,99.79024,PG,44,1609,342,734,0.466,121,334,0.362,278,323,0.861,35,313,348,475,53,33,177,99,1083,392,213,45,-100,-276,233,164.05,-143,21.05000000000001,0.4659400544959128,0.36227544910179643,0.8606811145510835
2020,Brooklyn Nets,Arizona State,James Harden,195.58,99.79024,PG,44,1609,342,734,0.466,121,334,0.362,278,323,0.861,35,313,348,475,53,33,177,99,1083,392,213,45,-100,-276,233,164.05,-143,21.05000000000001,0.4659400544959128,0.36227544910179643,0.8606811145510835
2020,Brooklyn Nets,Arizona State,James Harden,195.58,99.79024,PG,44,1609,342,734,0.466,121,334,0.362,278,323,0.861,35,313,348,475,53,33,177,99,1083,392,213,45,-100,-276,233,164.05,-143,21.05000000000001,0.4659400544959128,0.36227544910179643,0.8606811145510835
2020,Brooklyn Nets,Arizona State,James Harden,195.58,99.79024,PG,44,1609,342,734,0.466,121,334,0.362,278,323,0.861,35,313,348,475,53,33,177,99,1083,392,213,45,-100,-276,233,164.05,-143,21.05000000000001,0.4659400544959128,0.36227544910179643,0.8606811145510835
2020,Brooklyn Nets,Arizona State,James Harden,195.58,99.79024,PG,44,1609,342,734,0.466,121,334,0.362,278,323,0.861,35,313,348,475,53,33,177,99,1083,392,213,45,-100,-276,233,164.05,-143,21.05000000000001,0.4659400544959128,0.36227544910179643,0.8606811145510835
2020,San Antonio Spurs,Washington,Dejounte Murray,193.04,81.64656,PG,67,2139,441,974,0.453,63,199,0.317,106,134,0.791,58,415,473,363,101,7,117,135,1051,533,136,28,-184,-219,78,212.25,-325,-112.75,0.4527720739219713,0.3165829145728643,0.7910447761194029
2020,Milwaukee Bucks,UCLA,Jrue Holiday,190.5,92.98636,PG,59,1907,414,823,0.503,111,283,0.392,107,136,0.787,73,195,268,357,96,37,127,98,1046,409,172,29,10,-183,78,172.6,-95,77.6,0.503037667071689,0.392226148409894,0.7867647058823529
2020,Chicago Bulls,North Carolina,Coby White,195.58,88.45044,PG,69,2156,375,902,0.416,163,454,0.359,128,142,0.901,28,256,284,328,38,15,156,179,1041,527,291,14,-304,-384,114,99.55,-574,-474.45,0.4157427937915743,0.3590308370044053,0.9014084507042254
2020,Toronto Raptors,Wichita State,Fred VanVleet,185.42,89.357624,SG,52,1899,338,870,0.389,174,476,0.366,169,191,0.885,32,188,220,328,87,37,95,119,1019,532,302,22,-388,-384,147,153.55,-625,-471.45,0.38850574712643676,0.36554621848739494,0.8848167539267016
2020,Denver Nuggets,Kentucky,Jamal Murray,190.5,97.52228,PG,48,1704,378,792,0.477,129,316,0.408,133,153,0.869,37,157,194,231,64,13,108,95,1018,414,187,20,-72,-174,113,95.25,-133,-37.75,0.4772727272727273,0.40822784810126583,0.869281045751634
2020,Utah Jazz,,Rudy Gobert,215.9,117.026736,C,71,2187,391,579,0.675,0,4,0.0,233,374,0.623,240,720,960,89,40,190,118,163,1015,188,4,141,406,-12,92,370.1,486,856.1,0.6753022452504318,0.0,0.6229946524064172
2020,Phoenix Suns,Arizona,Deandre Ayton,210.82,113.398,C,69,2115,430,687,0.626,4,20,0.2,133,173,0.769,228,499,727,99,41,81,103,196,997,257,16,40,346,-36,93,263.2,403,666.2,0.6259097525473072,0.2,0.7687861271676301
2020,Brooklyn Nets,Virginia,Joe Harris,198.12,99.79024,SF,69,2142,357,707,0.505,211,444,0.475,49,63,0.778,43,205,248,130,46,14,62,141,974,350,233,14,14,-66,35,97.2,-17,80.2,0.504950495049505,0.4752252252252252,0.7777777777777778
2020,Phoenix Suns,Villanova,Mikal Bridges,198.12,94.800728,SF,72,2348,363,669,0.543,134,315,0.425,110,131,0.84,76,233,309,152,76,63,57,116,970,306,181,21,114,-141,89,169.45,62,231.45,0.5426008968609866,0.4253968253968254,0.8396946564885496
2020,Atlanta Hawks,,Clint Capela,208.28,108.86208,C,63,1898,413,695,0.594,0,0,0.0,130,227,0.573,297,606,903,49,44,129,73,145,956,282,0,97,262,0,33,355.0,295,650.0,0.5942446043165468,,0.5726872246696035
2020,Indiana Pacers,Michigan,Caris LeVert,198.12,92.98636,SG,47,1485,359,814,0.441,84,258,0.326,146,180,0.811,33,181,214,245,66,30,102,105,948,455,174,34,-192,-270,112,114.75,-350,-235.25,0.44103194103194104,0.32558139534883723,0.8111111111111111
2020,Indiana Pacers,Michigan,Caris LeVert,198.12,92.98636,SG,47,1485,359,814,0.441,84,258,0.326,146,180,0.811,33,181,214,245,66,30,102,105,948,455,174,34,-192,-270,112,114.75,-350,-235.25,0.44103194103194104,0.32558139534883723,0.8111111111111111
2020,Indiana Pacers,Michigan,Caris LeVert,198.12,92.98636,SG,47,1485,359,814,0.441,84,258,0.326,146,180,0.811,33,181,214,245,66,30,102,105,948,455,174,34,-192,-270,112,114.75,-350,-235.25,0.44103194103194104,0.32558139534883723,0.8111111111111111
2020,Indiana Pacers,Michigan,Caris LeVert,198.12,92.98636,SG,47,1485,359,814,0.441,84,258,0.326,146,180,0.811,33,181,214,245,66,30,102,105,948,455,174,34,-192,-270,112,114.75,-350,-235.25,0.44103194103194104,0.32558139534883723,0.8111111111111111
2020,Indiana Pacers,Michigan,Caris LeVert,198.12,92.98636,SG,47,1485,359,814,0.441,84,258,0.326,146,180,0.811,33,181,214,245,66,30,102,105,948,455,174,34,-192,-270,112,114.75,-350,-235.25,0.44103194103194104,0.32558139534883723,0.8111111111111111
2020,Indiana Pacers,Michigan,Caris LeVert,198.12,92.98636,SG,47,1485,359,814,0.441,84,258,0.326,146,180,0.811,33,181,214,245,66,30,102,105,948,455,174,34,-192,-270,112,114.75,-350,-235.25,0.44103194103194104,0.32558139534883723,0.8111111111111111
2020,Indiana Pacers,Michigan,Caris LeVert,198.12,92.98636,SG,47,1485,359,814,0.441,84,258,0.326,146,180,0.811,33,181,214,245,66,30,102,105,948,455,174,34,-192,-270,112,114.75,-350,-235.25,0.44103194103194104,0.32558139534883723,0.8111111111111111
2020,Indiana Pacers,Michigan,Caris LeVert,198.12,92.98636,SG,47,1485,359,814,0.441,84,258,0.326,146,180,0.811,33,181,214,245,66,30,102,105,948,455,174,34,-192,-270,112,114.75,-350,-235.25,0.44103194103194104,0.32558139534883723,0.8111111111111111
2020,Indiana Pacers,Michigan,Caris LeVert,198.12,92.98636,SG,47,1485,359,814,0.441,84,258,0.326,146,180,0.811,33,181,214,245,66,30,102,105,948,455,174,34,-192,-270,112,114.75,-350,-235.25,0.44103194103194104,0.32558139534883723,0.8111111111111111
2020,Houston Rockets,Gonzaga,Kelly Olynyk,210.82,108.86208,C,70,1997,337,697,0.484,126,368,0.342,145,175,0.829,87,402,489,203,79,42,126,207,945,360,242,30,-46,-348,115,181.9,-279,-97.1,0.4835007173601148,0.3423913043478261,0.8285714285714286
2020,Houston Rockets,Gonzaga,Kelly Olynyk,210.82,108.86208,C,70,1997,337,697,0.484,126,368,0.342,145,175,0.829,87,402,489,203,79,42,126,207,945,360,242,30,-46,-348,115,181.9,-279,-97.1,0.4835007173601148,0.3423913043478261,0.8285714285714286
2020,Houston Rockets,Gonzaga,Kelly Olynyk,210.82,108.86208,C,70,1997,337,697,0.484,126,368,0.342,145,175,0.829,87,402,489,203,79,42,126,207,945,360,242,30,-46,-348,115,181.9,-279,-97.1,0.4835007173601148,0.3423913043478261,0.8285714285714286
2020,Houston Rockets,Gonzaga,Kelly Olynyk,210.82,108.86208,C,70,1997,337,697,0.484,126,368,0.342,145,175,0.829,87,402,489,203,79,42,126,207,945,360,242,30,-46,-348,115,181.9,-279,-97.1,0.4835007173601148,0.3423913043478261,0.8285714285714286
2020,Houston Rockets,Gonzaga,Kelly Olynyk,210.82,108.86208,C,70,1997,337,697,0.484,126,368,0.342,145,175,0.829,87,402,489,203,79,42,126,207,945,360,242,30,-46,-348,115,181.9,-279,-97.1,0.4835007173601148,0.3423913043478261,0.8285714285714286
2020,Houston Rockets,Gonzaga,Kelly Olynyk,210.82,108.86208,C,70,1997,337,697,0.484,126,368,0.342,145,175,0.829,87,402,489,203,79,42,126,207,945,360,242,30,-46,-348,115,181.9,-279,-97.1,0.4835007173601148,0.3423913043478261,0.8285714285714286
2020,Houston Rockets,Gonzaga,Kelly Olynyk,210.82,108.86208,PF,70,1997,337,697,0.484,126,368,0.342,145,175,0.829,87,402,489,203,79,42,126,207,945,360,242,30,-46,-348,115,181.9,-279,-97.1,0.4835007173601148,0.3423913043478261,0.8285714285714286
2020,Houston Rockets,Gonzaga,Kelly Olynyk,210.82,108.86208,PF,70,1997,337,697,0.484,126,368,0.342,145,175,0.829,87,402,489,203,79,42,126,207,945,360,242,30,-46,-348,115,181.9,-279,-97.1,0.4835007173601148,0.3423913043478261,0.8285714285714286
2020,Houston Rockets,Gonzaga,Kelly Olynyk,210.82,108.86208,PF,70,1997,337,697,0.484,126,368,0.342,145,175,0.829,87,402,489,203,79,42,126,207,945,360,242,30,-46,-348,115,181.9,-279,-97.1,0.4835007173601148,0.3423913043478261,0.8285714285714286
2020,Brooklyn Nets,Texas-Austin,Kevin Durant,208.28,108.86208,PF,35,1157,324,603,0.537,85,189,0.45,210,238,0.882,13,234,247,195,25,45,120,70,943,279,104,28,90,-57,182,85.25,215,300.25,0.5373134328358209,0.4497354497354497,0.8823529411764706
2020,Miami Heat,Michigan,Duncan Robinson,200.66,97.52228,SF,72,2262,315,717,0.439,250,613,0.408,62,75,0.827,7,243,250,127,43,20,81,181,942,402,363,13,-174,-339,49,77.95,-464,-386.05,0.4393305439330544,0.4078303425774878,0.8266666666666667
2020,Cleveland Cavaliers,Vanderbilt,Darius Garland,185.42,87.089664,PG,54,1790,362,802,0.451,105,266,0.395,112,132,0.848,23,106,129,329,66,6,164,110,941,440,161,20,-156,-168,92,68.75,-232,-163.25,0.4513715710723192,0.39473684210526316,0.8484848484848485
2020,Sacramento Kings,North Carolina,Harrison Barnes,203.2,102.0582,PF,58,2102,319,642,0.497,100,256,0.391,195,235,0.83,64,321,385,201,43,11,93,75,933,323,156,40,-8,-168,155,139.25,-21,118.25,0.4968847352024922,0.390625,0.8297872340425532
2020,Los Angeles Lakers,Louisville,Montrezl Harrell,200.66,108.86208,C,69,1580,375,603,0.622,0,10,0.0,181,256,0.707,158,270,428,73,46,49,74,128,931,228,10,75,294,-30,106,168.85,370,538.85,0.6218905472636815,0.0,0.70703125
2020,Portland Trail Blazers,Syracuse,Carmelo Anthony,200.66,107.954896,PF,69,1690,327,777,0.421,133,325,0.409,137,154,0.89,32,182,214,104,46,38,61,144,924,450,192,17,-246,-177,120,91.8,-303,-211.2,0.42084942084942084,0.40923076923076923,0.8896103896103896
2020,Indiana Pacers,Creighton,Doug McDermott,200.66,102.0582,PF,66,1619,354,665,0.532,111,286,0.388,80,98,0.816,60,161,221,85,20,6,53,117,899,311,175,18,86,-192,62,72.15,-44,28.150000000000006,0.5323308270676692,0.3881118881118881,0.8163265306122449
2020,Toronto Raptors,Duke,Gary Trent Jr.,195.58,94.800728,SG,58,1802,320,785,0.408,165,429,0.385,83,106,0.783,27,125,152,80,56,10,43,92,888,465,264,23,-290,-297,60,71.65,-527,-455.35,0.40764331210191085,0.38461538461538464,0.7830188679245284
2020,Toronto Raptors,Duke,Gary Trent Jr.,195.58,94.800728,SG,58,1802,320,785,0.408,165,429,0.385,83,106,0.783,27,125,152,80,56,10,43,92,888,465,264,23,-290,-297,60,71.65,-527,-455.35,0.40764331210191085,0.38461538461538464,0.7830188679245284
2020,Toronto Raptors,Duke,Gary Trent Jr.,195.58,94.800728,SG,58,1802,320,785,0.408,165,429,0.385,83,106,0.783,27,125,152,80,56,10,43,92,888,465,264,23,-290,-297,60,71.65,-527,-455.35,0.40764331210191085,0.38461538461538464,0.7830188679245284
2020,Toronto Raptors,Duke,Gary Trent Jr.,195.58,94.800728,SG,58,1802,320,785,0.408,165,429,0.385,83,106,0.783,27,125,152,80,56,10,43,92,888,465,264,23,-290,-297,60,71.65,-527,-455.35,0.40764331210191085,0.38461538461538464,0.7830188679245284
2020,Toronto Raptors,Duke,Gary Trent Jr.,195.58,94.800728,SG,58,1802,320,785,0.408,165,429,0.385,83,106,0.783,27,125,152,80,56,10,43,92,888,465,264,23,-290,-297,60,71.65,-527,-455.35,0.40764331210191085,0.38461538461538464,0.7830188679245284
2020,Toronto Raptors,Duke,Gary Trent Jr.,195.58,94.800728,SG,58,1802,320,785,0.408,165,429,0.385,83,106,0.783,27,125,152,80,56,10,43,92,888,465,264,23,-290,-297,60,71.65,-527,-455.35,0.40764331210191085,0.38461538461538464,0.7830188679245284
2020,Toronto Raptors,Duke,Gary Trent Jr.,195.58,94.800728,SG,58,1802,320,785,0.408,165,429,0.385,83,106,0.783,27,125,152,80,56,10,43,92,888,465,264,23,-290,-297,60,71.65,-527,-455.35,0.40764331210191085,0.38461538461538464,0.7830188679245284
2020,Toronto Raptors,Duke,Gary Trent Jr.,195.58,94.800728,SG,58,1802,320,785,0.408,165,429,0.385,83,106,0.783,27,125,152,80,56,10,43,92,888,465,264,23,-290,-297,60,71.65,-527,-455.35,0.40764331210191085,0.38461538461538464,0.7830188679245284
2020,Toronto Raptors,Duke,Gary Trent Jr.,195.58,94.800728,SG,58,1802,320,785,0.408,165,429,0.385,83,106,0.783,27,125,152,80,56,10,43,92,888,465,264,23,-290,-297,60,71.65,-527,-455.35,0.40764331210191085,0.38461538461538464,0.7830188679245284
2020,San Antonio Spurs,Kentucky,Keldon Johnson,195.58,99.79024,SF,69,1968,338,705,0.479,60,181,0.331,145,196,0.74,93,319,412,121,40,24,78,142,881,367,121,51,-58,-183,94,142.4,-147,-4.599999999999994,0.4794326241134752,0.3314917127071823,0.7397959183673469
2020,Los Angeles Lakers,Utah,Kyle Kuzma,208.28,100.243832,SF,68,1954,335,757,0.443,137,380,0.361,67,97,0.691,108,309,417,127,35,41,113,121,874,422,243,30,-174,-318,37,138.45,-455,-316.55,0.4425363276089828,0.3605263157894737,0.6907216494845361
2020,New Orleans Pelicans,Kentucky,Eric Bledsoe,185.42,97.068688,SG,71,2112,307,730,0.421,121,355,0.341,134,195,0.687,29,215,244,268,55,24,114,112,869,423,234,61,-232,-339,73,112.15,-498,-385.85,0.42054794520547945,0.3408450704225352,0.6871794871794872
2020,Sacramento Kings,Bowling Green,Richaun Holmes,208.28,106.59412,C,61,1781,366,575,0.637,2,11,0.182,135,170,0.794,144,360,504,101,39,96,75,213,869,209,9,35,314,-21,100,206.6,393,599.6,0.6365217391304347,0.18181818181818182,0.7941176470588235
2020,Charlotte Hornets,Butler,Gordon Hayward,200.66,102.0582,SF,44,1496,311,658,0.473,85,205,0.415,156,185,0.843,37,221,258,181,52,14,91,74,863,347,120,29,-72,-105,127,102.8,-50,52.8,0.4726443768996961,0.4146341463414634,0.8432432432432433
2020,Houston Rockets,UNLV,Christian Wood,208.28,97.068688,C,41,1326,329,640,0.514,77,206,0.374,125,198,0.631,76,319,395,71,34,48,80,88,860,311,129,73,36,-156,52,132.1,-68,64.1,0.5140625,0.3737864077669903,0.6313131313131313
2020,Milwaukee Bucks,Stanford,Brook Lopez,213.36,127.912944,C,70,1902,322,640,0.503,95,281,0.338,120,142,0.845,104,243,347,50,40,103,64,149,859,318,186,22,8,-273,98,157.3,-167,-9.699999999999989,0.503125,0.33807829181494664,0.8450704225352113
2020,Dallas Mavericks,Villanova,Jalen Brunson,185.42,86.18248,PG,68,1697,328,627,0.523,81,200,0.405,120,151,0.795,27,204,231,239,35,1,80,109,857,299,119,31,58,-114,89,96.8,33,129.8,0.5231259968102073,0.405,0.7947019867549668
2020,Detroit Pistons,Villanova,Saddiq Bey,200.66,97.52228,SF,70,1909,279,691,0.404,175,460,0.38,124,147,0.844,43,275,318,95,52,14,60,110,857,412,285,23,-266,-330,101,111.5,-495,-383.5,0.4037626628075253,0.3804347826086957,0.8435374149659864
2020,Memphis Grizzlies,UCLA,Kyle Anderson,205.74,104.32616,PF,69,1887,308,658,0.468,94,261,0.36,144,184,0.783,52,344,396,250,84,57,86,120,854,350,167,40,-84,-219,104,196.0,-199,-3.0,0.46808510638297873,0.36015325670498083,0.782608695652174
2020,Golden State Warriors,Kansas,Kelly Oubre Jr.,200.66,92.079176,SF,55,1688,318,724,0.439,90,285,0.316,123,177,0.695,82,247,329,73,57,42,70,121,849,406,195,54,-176,-315,69,129.45,-422,-292.55,0.43922651933701656,0.3157894736842105,0.6949152542372882
2020,Charlotte Hornets,Michigan State,Miles Bridges,198.12,102.0582,PF,66,1932,313,622,0.503,116,290,0.4,98,113,0.867,81,316,397,147,44,52,106,143,840,309,174,15,8,-174,83,144.1,-83,61.099999999999994,0.5032154340836013,0.4,0.8672566371681416
2020,Oklahoma City Thunder,Kentucky,Shai Gilgeous-Alexander,198.12,81.64656,SG,35,1180,287,565,0.508,71,170,0.418,185,229,0.808,19,147,166,207,27,23,106,70,830,278,99,44,18,-84,141,66.5,75,141.5,0.5079646017699115,0.4176470588235294,0.8078602620087336
2020,Philadelphia 76ers,Louisiana State,Ben Simmons,210.82,108.86208,PG,58,1877,325,583,0.557,3,10,0.3,176,287,0.613,93,324,417,401,93,35,173,171,829,258,7,111,134,-12,65,196.7,187,383.7,0.5574614065180102,0.3,0.6132404181184669
2020,Oklahoma City Thunder,Connecticut,Kemba Walker,182.88,83.46092800000001,PG,43,1369,284,676,0.42,127,353,0.36,134,149,0.899,16,154,170,212,48,12,88,61,829,392,226,15,-216,-297,119,82.45,-394,-311.55,0.42011834319526625,0.3597733711048159,0.8993288590604027
2020,Detroit Pistons,Kansas,Josh Jackson,203.2,93.893544,SG,62,1560,296,707,0.419,77,257,0.3,159,218,0.729,57,197,254,143,53,47,142,178,828,411,180,59,-230,-309,100,83.6,-439,-355.4,0.4186704384724187,0.29961089494163423,0.7293577981651376
2020,Utah Jazz,Ohio State,Mike Conley,185.42,79.3786,PG,51,1498,284,640,0.444,138,335,0.412,121,142,0.852,36,141,177,305,70,9,99,98,827,356,197,21,-144,-177,100,114.6,-221,-106.4,0.44375,0.41194029850746267,0.852112676056338
2020,Charlotte Hornets,Kentucky,P.J. Washington,200.66,104.32616,PF,64,1954,302,686,0.44,112,290,0.386,108,145,0.745,93,325,418,161,69,79,128,171,824,384,178,37,-164,-198,71,169.45,-291,-121.55000000000001,0.4402332361516035,0.38620689655172413,0.7448275862068966
2020,Houston Rockets,Kentucky,John Wall,190.5,95.25432,PG,40,1288,293,726,0.404,79,249,0.317,158,211,0.749,17,112,129,275,42,31,141,46,823,433,170,53,-280,-273,105,68.95,-448,-379.05,0.4035812672176309,0.3172690763052209,0.7488151658767772
2020,Chicago Bulls,Georgia Tech,Thaddeus Young,203.2,106.59412,PF,68,1652,370,662,0.559,12,45,0.267,71,113,0.628,168,255,423,291,74,40,137,152,823,292,33,42,156,-63,29,201.4,122,323.4,0.5589123867069486,0.26666666666666666,0.6283185840707964
2020,Atlanta Hawks,Maryland,Kevin Huerter,200.66,86.18248,SG,69,2126,316,731,0.432,140,386,0.363,50,64,0.781,38,193,231,241,82,18,79,165,822,415,246,14,-198,-318,36,129.75,-480,-350.25,0.4322845417236662,0.3626943005181347,0.78125
2020,Toronto Raptors,Oregon,Chris Boucher,205.74,90.7184,C,60,1453,288,560,0.514,90,235,0.383,152,193,0.788,117,287,404,63,35,111,46,166,818,272,145,41,32,-165,111,187.7,-22,165.7,0.5142857142857142,0.3829787234042553,0.7875647668393783
2020,Philadelphia 76ers,Southern Methodist,Shake Milton,195.58,92.98636,SG,63,1461,300,667,0.45,71,203,0.35,146,176,0.83,33,115,148,193,39,18,103,130,817,367,132,30,-134,-183,116,64.0,-201,-137.0,0.4497751124437781,0.3497536945812808,0.8295454545454546
2020,Charlotte Hornets,Kansas,Devonte' Graham,185.42,88.45044,PG,55,1659,252,669,0.377,179,477,0.375,133,158,0.842,22,126,148,295,48,6,84,77,816,417,298,25,-330,-357,108,97.4,-579,-481.6,0.37668161434977576,0.3752620545073375,0.8417721518987342
2020,Miami Heat,Oakland,Kendrick Nunn,187.96,86.18248,PG,56,1650,319,658,0.485,122,320,0.381,56,60,0.933,21,158,179,148,52,14,80,108,816,339,198,4,-40,-228,52,74.6,-216,-141.4,0.4848024316109423,0.38125,0.9333333333333333
2020,Miami Heat,Kentucky,Tyler Herro,195.58,88.45044,SG,54,1635,307,699,0.439,107,297,0.36,94,117,0.803,25,243,268,184,35,17,101,71,815,392,190,23,-170,-249,71,91.2,-348,-256.8,0.43919885550786836,0.3602693602693603,0.8034188034188035
2020,Utah Jazz,,Joe Ingles,203.2,99.79024,SF,67,1867,275,562,0.489,183,406,0.451,76,90,0.844,27,217,244,318,45,12,117,120,809,287,223,14,-24,-120,62,111.25,-82,29.25,0.4893238434163701,0.45073891625615764,0.8444444444444444
2020,Cleveland Cavaliers,Texas-Austin,Jarrett Allen,210.82,110.222856,C,63,1864,298,482,0.618,6,19,0.316,204,290,0.703,196,435,631,106,32,90,100,96,806,184,13,86,228,-21,118,239.45,325,564.45,0.6182572614107884,0.3157894736842105,0.7034482758620689
2020,Cleveland Cavaliers,Texas-Austin,Jarrett Allen,210.82,110.222856,C,63,1864,298,482,0.618,6,19,0.316,204,290,0.703,196,435,631,106,32,90,100,96,806,184,13,86,228,-21,118,239.45,325,564.45,0.6182572614107884,0.3157894736842105,0.7034482758620689
2020,Cleveland Cavaliers,Texas-Austin,Jarrett Allen,210.82,110.222856,C,63,1864,298,482,0.618,6,19,0.316,204,290,0.703,196,435,631,106,32,90,100,96,806,184,13,86,228,-21,118,239.45,325,564.45,0.6182572614107884,0.3157894736842105,0.7034482758620689
2020,Cleveland Cavaliers,Texas-Austin,Jarrett Allen,210.82,110.222856,C,63,1864,298,482,0.618,6,19,0.316,204,290,0.703,196,435,631,106,32,90,100,96,806,184,13,86,228,-21,118,239.45,325,564.45,0.6182572614107884,0.3157894736842105,0.7034482758620689
2020,Cleveland Cavaliers,Texas-Austin,Jarrett Allen,210.82,110.222856,C,63,1864,298,482,0.618,6,19,0.316,204,290,0.703,196,435,631,106,32,90,100,96,806,184,13,86,228,-21,118,239.45,325,564.45,0.6182572614107884,0.3157894736842105,0.7034482758620689
2020,Cleveland Cavaliers,Texas-Austin,Jarrett Allen,210.82,110.222856,C,63,1864,298,482,0.618,6,19,0.316,204,290,0.703,196,435,631,106,32,90,100,96,806,184,13,86,228,-21,118,239.45,325,564.45,0.6182572614107884,0.3157894736842105,0.7034482758620689
2020,Cleveland Cavaliers,Texas-Austin,Jarrett Allen,210.82,110.222856,C,63,1864,298,482,0.618,6,19,0.316,204,290,0.703,196,435,631,106,32,90,100,96,806,184,13,86,228,-21,118,239.45,325,564.45,0.6182572614107884,0.3157894736842105,0.7034482758620689
2020,Cleveland Cavaliers,Texas-Austin,Jarrett Allen,210.82,110.222856,C,63,1864,298,482,0.618,6,19,0.316,204,290,0.703,196,435,631,106,32,90,100,96,806,184,13,86,228,-21,118,239.45,325,564.45,0.6182572614107884,0.3157894736842105,0.7034482758620689
2020,Cleveland Cavaliers,Texas-Austin,Jarrett Allen,210.82,110.222856,C,63,1864,298,482,0.618,6,19,0.316,204,290,0.703,196,435,631,106,32,90,100,96,806,184,13,86,228,-21,118,239.45,325,564.45,0.6182572614107884,0.3157894736842105,0.7034482758620689
2020,Charlotte Hornets,,LaMelo Ball,198.12,81.64656,PG,51,1469,293,672,0.436,92,261,0.352,125,165,0.758,63,239,302,313,81,18,145,136,803,379,169,40,-172,-231,85,139.7,-318,-178.3,0.43601190476190477,0.3524904214559387,0.7575757575757576
2020,New Orleans Pelicans,UCLA,Lonzo Ball,198.12,86.18248,PG,55,1747,290,700,0.414,172,455,0.378,50,64,0.781,33,230,263,316,82,31,123,103,802,410,283,14,-240,-333,36,142.85,-537,-394.15,0.4142857142857143,0.378021978021978,0.78125
2020,Minnesota Timberwolves,Ohio State,D'Angelo Russell,193.04,87.543256,PG,42,1196,281,652,0.431,120,310,0.387,114,149,0.765,16,95,111,244,45,18,112,68,796,371,190,35,-180,-210,79,64.85,-311,-246.15,0.43098159509202455,0.3870967741935484,0.7651006711409396
2020,Houston Rockets,Ohio State,Jae'Sean Tate,193.04,104.32616,SF,70,2043,316,625,0.506,60,195,0.308,102,147,0.694,132,242,374,178,85,36,98,222,794,309,135,45,14,-225,57,171.4,-154,17.400000000000006,0.5056,0.3076923076923077,0.6938775510204082
2020,Toronto Raptors,Villanova,Kyle Lowry,182.88,88.904032,PG,46,1602,260,596,0.436,131,331,0.396,140,160,0.875,35,212,247,338,45,14,126,143,791,336,200,20,-152,-207,120,114.35,-239,-124.65,0.436241610738255,0.3957703927492447,0.875
2020,Washington Wizards,Gonzaga,Rui Hachimura,203.2,104.32616,PF,57,1797,310,648,0.478,45,137,0.328,124,161,0.77,49,263,312,82,44,7,68,120,789,338,92,37,-56,-141,87,96.25,-110,-13.75,0.4783950617283951,0.3284671532846715,0.7701863354037267
2020,Orlando Magic,Florida State,Dwayne Bacon,198.12,100.243832,SG,72,1853,292,726,0.402,59,207,0.285,145,176,0.824,31,193,224,93,45,5,46,103,788,434,148,31,-284,-267,114,83.85,-437,-353.15,0.4022038567493113,0.28502415458937197,0.8238636363636364
2020,Los Angeles Lakers,Kentucky,Anthony Davis,208.28,114.758776,PF,36,1162,301,613,0.491,26,100,0.26,158,214,0.738,62,224,286,110,45,59,74,60,786,312,74,56,-22,-144,102,126.5,-64,62.5,0.4910277324632953,0.26,0.7383177570093458
2020,Minnesota Timberwolves,Louisiana State,Naz Reid,205.74,119.748288,C,70,1347,304,581,0.523,61,174,0.351,115,166,0.693,82,240,322,72,34,76,69,179,784,277,113,51,54,-156,64,130.55,-38,92.55000000000001,0.5232358003442341,0.3505747126436782,0.6927710843373494
2020,Indiana Pacers,Washington,Justin Holiday,198.12,81.64656,SG,72,2183,258,625,0.413,173,453,0.382,67,85,0.788,32,224,256,119,74,41,54,135,756,367,280,18,-218,-321,49,125.5,-490,-364.5,0.4128,0.3818984547461369,0.788235294117647
2020,Milwaukee Bucks,Arkansas,Bobby Portis,208.28,113.398,C,66,1372,313,598,0.523,74,157,0.471,54,73,0.74,124,342,466,71,52,26,56,115,754,285,83,19,56,-27,35,170.5,64,234.5,0.5234113712374582,0.4713375796178344,0.7397260273972602
2020,Oklahoma City Thunder,,Darius Bazley,203.2,94.347136,PF,55,1714,273,690,0.396,83,286,0.29,125,178,0.702,51,345,396,99,29,25,122,60,754,417,203,53,-288,-360,72,99.5,-576,-476.5,0.39565217391304347,0.2902097902097902,0.702247191011236
2020,Sacramento Kings,Iowa State,Tyrese Haliburton,195.58,83.91452,PG,58,1746,292,619,0.472,121,296,0.409,48,56,0.857,39,134,173,309,77,28,92,83,753,327,175,8,-70,-162,40,132.6,-192,-59.400000000000006,0.4717285945072698,0.40878378378378377,0.8571428571428571
2020,Brooklyn Nets,Georgetown,Jeff Green,203.2,106.59412,PF,68,1835,261,530,0.492,103,250,0.412,125,161,0.776,34,229,263,108,36,27,54,122,750,269,147,36,-16,-132,89,99.65,-59,40.650000000000006,0.49245283018867925,0.412,0.7763975155279503
2020,Atlanta Hawks,,Lou Williams,185.42,79.3786,PG,66,1423,265,646,0.41,69,173,0.399,150,173,0.867,21,117,138,225,47,6,108,62,749,381,104,23,-232,-105,127,65.4,-210,-144.6,0.4102167182662539,0.3988439306358382,0.8670520231213873
2020,Atlanta Hawks,,Lou Williams,185.42,79.3786,PG,66,1423,265,646,0.41,69,173,0.399,150,173,0.867,21,117,138,225,47,6,108,62,749,381,104,23,-232,-105,127,65.4,-210,-144.6,0.4102167182662539,0.3988439306358382,0.8670520231213873
2020,Atlanta Hawks,,Lou Williams,185.42,79.3786,PG,66,1423,265,646,0.41,69,173,0.399,150,173,0.867,21,117,138,225,47,6,108,62,749,381,104,23,-232,-105,127,65.4,-210,-144.6,0.4102167182662539,0.3988439306358382,0.8670520231213873
2020,Atlanta Hawks,,Lou Williams,185.42,79.3786,PG,66,1423,265,646,0.41,69,173,0.399,150,173,0.867,21,117,138,225,47,6,108,62,749,381,104,23,-232,-105,127,65.4,-210,-144.6,0.4102167182662539,0.3988439306358382,0.8670520231213873
2020,Atlanta Hawks,,Lou Williams,185.42,79.3786,PG,66,1423,265,646,0.41,69,173,0.399,150,173,0.867,21,117,138,225,47,6,108,62,749,381,104,23,-232,-105,127,65.4,-210,-144.6,0.4102167182662539,0.3988439306358382,0.8670520231213873
2020,Atlanta Hawks,,Lou Williams,185.42,79.3786,PG,66,1423,265,646,0.41,69,173,0.399,150,173,0.867,21,117,138,225,47,6,108,62,749,381,104,23,-232,-105,127,65.4,-210,-144.6,0.4102167182662539,0.3988439306358382,0.8670520231213873
2020,Atlanta Hawks,,Lou Williams,185.42,79.3786,PG,66,1423,265,646,0.41,69,173,0.399,150,173,0.867,21,117,138,225,47,6,108,62,749,381,104,23,-232,-105,127,65.4,-210,-144.6,0.4102167182662539,0.3988439306358382,0.8670520231213873
2020,Atlanta Hawks,,Lou Williams,185.42,79.3786,PG,66,1423,265,646,0.41,69,173,0.399,150,173,0.867,21,117,138,225,47,6,108,62,749,381,104,23,-232,-105,127,65.4,-210,-144.6,0.4102167182662539,0.3988439306358382,0.8670520231213873
2020,Atlanta Hawks,,Lou Williams,185.42,79.3786,PG,66,1423,265,646,0.41,69,173,0.399,150,173,0.867,21,117,138,225,47,6,108,62,749,381,104,23,-232,-105,127,65.4,-210,-144.6,0.4102167182662539,0.3988439306358382,0.8670520231213873
2020,San Antonio Spurs,St.Mary's College of California,Patty Mills,185.42,81.64656,PG,68,1685,252,611,0.412,161,429,0.375,71,78,0.91,18,98,116,162,42,3,66,81,736,359,268,7,-214,-321,64,59.45,-471,-411.55,0.41243862520458263,0.3752913752913753,0.9102564102564102
2020,New York Knicks,Memphis,Derrick Rose,187.96,90.7184,PG,50,1279,287,611,0.47,50,129,0.388,110,127,0.866,20,110,130,209,49,19,78,56,734,324,79,17,-74,-87,93,81.95,-68,13.950000000000003,0.469721767594108,0.3875968992248062,0.8661417322834646
2020,New York Knicks,Memphis,Derrick Rose,187.96,90.7184,PG,50,1279,287,611,0.47,50,129,0.388,110,127,0.866,20,110,130,209,49,19,78,56,734,324,79,17,-74,-87,93,81.95,-68,13.950000000000003,0.469721767594108,0.3875968992248062,0.8661417322834646
2020,New York Knicks,Memphis,Derrick Rose,187.96,90.7184,PG,50,1279,287,611,0.47,50,129,0.388,110,127,0.866,20,110,130,209,49,19,78,56,734,324,79,17,-74,-87,93,81.95,-68,13.950000000000003,0.469721767594108,0.3875968992248062,0.8661417322834646
2020,New York Knicks,Memphis,Derrick Rose,187.96,90.7184,PG,50,1279,287,611,0.47,50,129,0.388,110,127,0.866,20,110,130,209,49,19,78,56,734,324,79,17,-74,-87,93,81.95,-68,13.950000000000003,0.469721767594108,0.3875968992248062,0.8661417322834646
2020,New York Knicks,Memphis,Derrick Rose,187.96,90.7184,PG,50,1279,287,611,0.47,50,129,0.388,110,127,0.866,20,110,130,209,49,19,78,56,734,324,79,17,-74,-87,93,81.95,-68,13.950000000000003,0.469721767594108,0.3875968992248062,0.8661417322834646
2020,New York Knicks,Memphis,Derrick Rose,187.96,90.7184,PG,50,1279,287,611,0.47,50,129,0.388,110,127,0.866,20,110,130,209,49,19,78,56,734,324,79,17,-74,-87,93,81.95,-68,13.950000000000003,0.469721767594108,0.3875968992248062,0.8661417322834646
2020,New York Knicks,Memphis,Derrick Rose,187.96,90.7184,PG,50,1279,287,611,0.47,50,129,0.388,110,127,0.866,20,110,130,209,49,19,78,56,734,324,79,17,-74,-87,93,81.95,-68,13.950000000000003,0.469721767594108,0.3875968992248062,0.8661417322834646
2020,New York Knicks,Memphis,Derrick Rose,187.96,90.7184,PG,50,1279,287,611,0.47,50,129,0.388,110,127,0.866,20,110,130,209,49,19,78,56,734,324,79,17,-74,-87,93,81.95,-68,13.950000000000003,0.469721767594108,0.3875968992248062,0.8661417322834646
2020,New York Knicks,Memphis,Derrick Rose,187.96,90.7184,PG,50,1279,287,611,0.47,50,129,0.388,110,127,0.866,20,110,130,209,49,19,78,56,734,324,79,17,-74,-87,93,81.95,-68,13.950000000000003,0.469721767594108,0.3875968992248062,0.8661417322834646
2020,New York Knicks,Kentucky,Immanuel Quickley,190.5,86.18248,PG,64,1244,229,580,0.395,118,303,0.389,155,174,0.891,25,112,137,127,30,12,58,114,731,351,185,19,-244,-201,136,58.55,-309,-250.45,0.39482758620689656,0.38943894389438943,0.8908045977011494
2020,Oklahoma City Thunder,Arizona State,Luguentz Dort,190.5,97.52228,SG,52,1543,247,639,0.387,113,329,0.343,122,164,0.744,38,151,189,88,45,19,79,134,729,392,216,42,-290,-309,80,64.55,-519,-454.45,0.3865414710485133,0.3434650455927052,0.7439024390243902
2020,Minnesota Timberwolves,Florida State,Malik Beasley,193.04,84.821704,SG,37,1214,264,600,0.44,128,321,0.399,68,80,0.85,28,134,162,88,30,7,60,62,724,336,193,12,-144,-195,56,54.9,-283,-228.1,0.44,0.3987538940809969,0.85
2020,Boston Celtics,,Evan Fournier,200.66,92.98636,SF,42,1259,247,541,0.457,117,283,0.413,108,137,0.788,10,118,128,144,47,19,73,96,719,294,166,29,-94,-147,79,62.2,-162,-99.8,0.4565619223659889,0.4134275618374558,0.7883211678832117
2020,Boston Celtics,,Evan Fournier,200.66,92.98636,SF,42,1259,247,541,0.457,117,283,0.413,108,137,0.788,10,118,128,144,47,19,73,96,719,294,166,29,-94,-147,79,62.2,-162,-99.8,0.4565619223659889,0.4134275618374558,0.7883211678832117
2020,Boston Celtics,,Evan Fournier,200.66,92.98636,SF,42,1259,247,541,0.457,117,283,0.413,108,137,0.788,10,118,128,144,47,19,73,96,719,294,166,29,-94,-147,79,62.2,-162,-99.8,0.4565619223659889,0.4134275618374558,0.7883211678832117
2020,Boston Celtics,,Evan Fournier,200.66,92.98636,SF,42,1259,247,541,0.457,117,283,0.413,108,137,0.788,10,118,128,144,47,19,73,96,719,294,166,29,-94,-147,79,62.2,-162,-99.8,0.4565619223659889,0.4134275618374558,0.7883211678832117
2020,Boston Celtics,,Evan Fournier,200.66,92.98636,SF,42,1259,247,541,0.457,117,283,0.413,108,137,0.788,10,118,128,144,47,19,73,96,719,294,166,29,-94,-147,79,62.2,-162,-99.8,0.4565619223659889,0.4134275618374558,0.7883211678832117
2020,Boston Celtics,,Evan Fournier,200.66,92.98636,SF,42,1259,247,541,0.457,117,283,0.413,108,137,0.788,10,118,128,144,47,19,73,96,719,294,166,29,-94,-147,79,62.2,-162,-99.8,0.4565619223659889,0.4134275618374558,0.7883211678832117
2020,Boston Celtics,,Evan Fournier,200.66,92.98636,SF,42,1259,247,541,0.457,117,283,0.413,108,137,0.788,10,118,128,144,47,19,73,96,719,294,166,29,-94,-147,79,62.2,-162,-99.8,0.4565619223659889,0.4134275618374558,0.7883211678832117
2020,Boston Celtics,,Evan Fournier,200.66,92.98636,SF,42,1259,247,541,0.457,117,283,0.413,108,137,0.788,10,118,128,144,47,19,73,96,719,294,166,29,-94,-147,79,62.2,-162,-99.8,0.4565619223659889,0.4134275618374558,0.7883211678832117
2020,Boston Celtics,,Evan Fournier,200.66,92.98636,SF,42,1259,247,541,0.457,117,283,0.413,108,137,0.788,10,118,128,144,47,19,73,96,719,294,166,29,-94,-147,79,62.2,-162,-99.8,0.4565619223659889,0.4134275618374558,0.7883211678832117
2020,Orlando Magic,Washington,Terrence Ross,198.12,93.439952,SG,46,1347,254,616,0.412,89,264,0.337,120,138,0.87,15,143,158,108,47,21,74,88,717,362,175,18,-216,-258,102,62.85,-372,-309.15,0.41233766233766234,0.3371212121212121,0.8695652173913043
2020,San Antonio Spurs,Connecticut,Rudy Gay,203.2,113.398,PF,63,1358,264,628,0.42,106,278,0.381,82,102,0.804,42,261,303,88,45,40,65,115,716,364,172,20,-200,-198,62,112.5,-336,-223.5,0.42038216560509556,0.381294964028777,0.803921568627451
2020,Dallas Mavericks,Tennessee,Josh Richardson,195.58,90.7184,SG,59,1790,264,618,0.427,88,267,0.33,99,108,0.917,51,144,195,153,61,24,79,130,715,354,179,9,-180,-273,90,96.25,-363,-266.75,0.42718446601941745,0.3295880149812734,0.9166666666666666
2020,Los Angeles Clippers,Boston College,Reggie Jackson,187.96,94.347136,SG,67,1544,263,585,0.45,122,282,0.433,67,82,0.817,24,168,192,205,41,7,74,127,715,322,160,15,-118,-114,52,85.9,-180,-94.1,0.4495726495726496,0.4326241134751773,0.8170731707317073
2020,Philadelphia 76ers,Duke,Seth Curry,187.96,83.91452,SG,57,1638,258,552,0.467,126,280,0.45,69,77,0.896,10,126,136,155,44,8,65,96,711,294,154,8,-72,-84,61,63.95,-95,-31.049999999999997,0.4673913043478261,0.45,0.8961038961038961
2020,Denver Nuggets,Memphis,Will Barton,198.12,82.10015200000001,SF,56,1736,259,608,0.426,98,257,0.381,95,121,0.785,39,187,226,181,50,23,96,95,711,349,159,26,-180,-183,69,95.25,-294,-198.75,0.42598684210526316,0.38132295719844356,0.7851239669421488
2020,Milwaukee Bucks,Michigan State,Bryn Forbes,187.96,92.98636,SG,70,1354,250,529,0.473,154,341,0.452,47,61,0.77,11,101,112,45,24,1,44,77,701,279,187,14,-58,-99,33,28.65,-124,-95.35,0.4725897920604915,0.45161290322580644,0.7704918032786885
2020,Chicago Bulls,Arizona,Lauri Markkanen,213.36,108.86208,PF,51,1317,250,521,0.48,119,296,0.402,76,92,0.826,35,233,268,45,26,15,52,75,695,271,177,16,-42,-174,60,77.75,-156,-78.25,0.4798464491362764,0.40202702702702703,0.8260869565217391
2020,Milwaukee Bucks,Villanova,Donte DiVincenzo,193.04,92.079176,SG,66,1815,253,603,0.42,131,346,0.379,51,71,0.718,81,299,380,203,72,15,91,112,688,350,215,20,-194,-252,31,158.4,-415,-256.6,0.41956882255389716,0.3786127167630058,0.7183098591549296
2020,Los Angeles Lakers,Connecticut,Andre Drummond,208.28,126.552168,C,46,1242,282,572,0.493,0,8,0.0,123,205,0.6,166,385,551,94,63,49,124,149,687,290,8,82,-16,-24,41,189.3,1,190.3,0.493006993006993,0.0,0.6
2020,Los Angeles Lakers,Connecticut,Andre Drummond,208.28,126.552168,C,46,1242,282,572,0.493,0,8,0.0,123,205,0.6,166,385,551,94,63,49,124,149,687,290,8,82,-16,-24,41,189.3,1,190.3,0.493006993006993,0.0,0.6
2020,Los Angeles Lakers,Connecticut,Andre Drummond,208.28,126.552168,C,46,1242,282,572,0.493,0,8,0.0,123,205,0.6,166,385,551,94,63,49,124,149,687,290,8,82,-16,-24,41,189.3,1,190.3,0.493006993006993,0.0,0.6
2020,Los Angeles Lakers,Connecticut,Andre Drummond,208.28,126.552168,C,46,1242,282,572,0.493,0,8,0.0,123,205,0.6,166,385,551,94,63,49,124,149,687,290,8,82,-16,-24,41,189.3,1,190.3,0.493006993006993,0.0,0.6
2020,Los Angeles Lakers,Connecticut,Andre Drummond,208.28,126.552168,C,46,1242,282,572,0.493,0,8,0.0,123,205,0.6,166,385,551,94,63,49,124,149,687,290,8,82,-16,-24,41,189.3,1,190.3,0.493006993006993,0.0,0.6
2020,Los Angeles Lakers,Connecticut,Andre Drummond,208.28,126.552168,C,46,1242,282,572,0.493,0,8,0.0,123,205,0.6,166,385,551,94,63,49,124,149,687,290,8,82,-16,-24,41,189.3,1,190.3,0.493006993006993,0.0,0.6
2020,Los Angeles Lakers,Connecticut,Andre Drummond,208.28,126.552168,C,46,1242,282,572,0.493,0,8,0.0,123,205,0.6,166,385,551,94,63,49,124,149,687,290,8,82,-16,-24,41,189.3,1,190.3,0.493006993006993,0.0,0.6
2020,Los Angeles Lakers,Connecticut,Andre Drummond,208.28,126.552168,C,46,1242,282,572,0.493,0,8,0.0,123,205,0.6,166,385,551,94,63,49,124,149,687,290,8,82,-16,-24,41,189.3,1,190.3,0.493006993006993,0.0,0.6
2020,Los Angeles Lakers,Connecticut,Andre Drummond,208.28,126.552168,C,46,1242,282,572,0.493,0,8,0.0,123,205,0.6,166,385,551,94,63,49,124,149,687,290,8,82,-16,-24,41,189.3,1,190.3,0.493006993006993,0.0,0.6
2020,Toronto Raptors,Indiana,OG Anunoby,200.66,105.233344,SF,43,1433,249,519,0.48,104,261,0.398,80,102,0.784,54,183,237,94,66,32,75,114,682,270,157,22,-42,-159,58,102.05,-143,-40.95,0.4797687861271676,0.39846743295019155,0.7843137254901961
2020,Atlanta Hawks,,Danilo Gallinari,208.28,105.68693600000002,PF,51,1222,206,475,0.434,103,254,0.406,161,174,0.925,17,194,211,76,30,10,43,105,676,269,151,13,-126,-144,148,69.25,-122,-52.75,0.4336842105263158,0.40551181102362205,0.9252873563218391
2020,San Antonio Spurs,Miami,Lonnie Walker IV,193.04,92.532768,SG,60,1522,256,609,0.42,100,282,0.355,57,70,0.814,14,141,155,101,29,15,65,101,669,353,182,13,-194,-246,44,51.95,-396,-344.05,0.42036124794745483,0.3546099290780142,0.8142857142857143
2020,Chicago Bulls,Florida State,Patrick Williams,200.66,97.52228,PF,71,1983,255,528,0.483,54,138,0.391,91,125,0.728,66,261,327,99,64,46,98,126,655,273,84,34,-36,-90,57,122.7,-69,53.7,0.48295454545454547,0.391304347826087,0.728
2020,Philadelphia 76ers,North Carolina,Danny Green,198.12,97.52228,SF,69,1934,224,544,0.412,175,432,0.405,31,40,0.775,55,205,260,118,92,56,67,125,654,320,257,9,-192,-246,22,142.5,-416,-273.5,0.4117647058823529,0.4050925925925926,0.775
2020,Los Angeles Lakers,Georgia,Kentavious Caldwell-Pope,195.58,92.532768,SG,67,1902,218,506,0.431,120,293,0.41,97,112,0.866,27,152,179,127,62,26,66,114,653,288,173,15,-140,-159,82,88.55,-217,-128.45,0.4308300395256917,0.40955631399317405,0.8660714285714286
2020,Miami Heat,Indiana,Victor Oladipo,193.04,96.615096,SG,33,1080,235,576,0.408,78,239,0.326,104,138,0.754,12,148,160,151,46,14,83,81,652,341,161,34,-212,-249,70,65.2,-391,-325.8,0.4079861111111111,0.3263598326359833,0.7536231884057971
2020,Miami Heat,Indiana,Victor Oladipo,193.04,96.615096,SG,33,1080,235,576,0.408,78,239,0.326,104,138,0.754,12,148,160,151,46,14,83,81,652,341,161,34,-212,-249,70,65.2,-391,-325.8,0.4079861111111111,0.3263598326359833,0.7536231884057971
2020,Miami Heat,Indiana,Victor Oladipo,193.04,96.615096,SG,33,1080,235,576,0.408,78,239,0.326,104,138,0.754,12,148,160,151,46,14,83,81,652,341,161,34,-212,-249,70,65.2,-391,-325.8,0.4079861111111111,0.3263598326359833,0.7536231884057971
2020,Miami Heat,Indiana,Victor Oladipo,193.04,96.615096,SG,33,1080,235,576,0.408,78,239,0.326,104,138,0.754,12,148,160,151,46,14,83,81,652,341,161,34,-212,-249,70,65.2,-391,-325.8,0.4079861111111111,0.3263598326359833,0.7536231884057971
2020,Miami Heat,Indiana,Victor Oladipo,193.04,96.615096,SG,33,1080,235,576,0.408,78,239,0.326,104,138,0.754,12,148,160,151,46,14,83,81,652,341,161,34,-212,-249,70,65.2,-391,-325.8,0.4079861111111111,0.3263598326359833,0.7536231884057971
2020,Miami Heat,Indiana,Victor Oladipo,193.04,96.615096,SG,33,1080,235,576,0.408,78,239,0.326,104,138,0.754,12,148,160,151,46,14,83,81,652,341,161,34,-212,-249,70,65.2,-391,-325.8,0.4079861111111111,0.3263598326359833,0.7536231884057971
2020,Miami Heat,Indiana,Victor Oladipo,193.04,96.615096,SG,33,1080,235,576,0.408,78,239,0.326,104,138,0.754,12,148,160,151,46,14,83,81,652,341,161,34,-212,-249,70,65.2,-391,-325.8,0.4079861111111111,0.3263598326359833,0.7536231884057971
2020,Miami Heat,Indiana,Victor Oladipo,193.04,96.615096,SG,33,1080,235,576,0.408,78,239,0.326,104,138,0.754,12,148,160,151,46,14,83,81,652,341,161,34,-212,-249,70,65.2,-391,-325.8,0.4079861111111111,0.3263598326359833,0.7536231884057971
2020,Miami Heat,Indiana,Victor Oladipo,193.04,96.615096,SG,33,1080,235,576,0.408,78,239,0.326,104,138,0.754,12,148,160,151,46,14,83,81,652,341,161,34,-212,-249,70,65.2,-391,-325.8,0.4079861111111111,0.3263598326359833,0.7536231884057971
2020,Miami Heat,Indiana,Victor Oladipo,193.04,96.615096,SG,33,1080,235,576,0.408,78,239,0.326,104,138,0.754,12,148,160,151,46,14,83,81,652,341,161,34,-212,-249,70,65.2,-391,-325.8,0.4079861111111111,0.3263598326359833,0.7536231884057971
2020,Miami Heat,Indiana,Victor Oladipo,193.04,96.615096,SG,33,1080,235,576,0.408,78,239,0.326,104,138,0.754,12,148,160,151,46,14,83,81,652,341,161,34,-212,-249,70,65.2,-391,-325.8,0.4079861111111111,0.3263598326359833,0.7536231884057971
2020,Miami Heat,Indiana,Victor Oladipo,193.04,96.615096,SG,33,1080,235,576,0.408,78,239,0.326,104,138,0.754,12,148,160,151,46,14,83,81,652,341,161,34,-212,-249,70,65.2,-391,-325.8,0.4079861111111111,0.3263598326359833,0.7536231884057971
2020,Miami Heat,Indiana,Victor Oladipo,193.04,96.615096,SG,33,1080,235,576,0.408,78,239,0.326,104,138,0.754,12,148,160,151,46,14,83,81,652,341,161,34,-212,-249,70,65.2,-391,-325.8,0.4079861111111111,0.3263598326359833,0.7536231884057971
2020,Miami Heat,Indiana,Victor Oladipo,193.04,96.615096,SG,33,1080,235,576,0.408,78,239,0.326,104,138,0.754,12,148,160,151,46,14,83,81,652,341,161,34,-212,-249,70,65.2,-391,-325.8,0.4079861111111111,0.3263598326359833,0.7536231884057971
2020,Miami Heat,Indiana,Victor Oladipo,193.04,96.615096,SG,33,1080,235,576,0.408,78,239,0.326,104,138,0.754,12,148,160,151,46,14,83,81,652,341,161,34,-212,-249,70,65.2,-391,-325.8,0.4079861111111111,0.3263598326359833,0.7536231884057971
2020,Miami Heat,Indiana,Victor Oladipo,193.04,96.615096,SG,33,1080,235,576,0.408,78,239,0.326,104,138,0.754,12,148,160,151,46,14,83,81,652,341,161,34,-212,-249,70,65.2,-391,-325.8,0.4079861111111111,0.3263598326359833,0.7536231884057971
2020,Los Angeles Clippers,,Ivica Zubac,213.36,108.86208,C,72,1609,257,394,0.652,1,4,0.25,135,171,0.789,189,330,519,90,24,62,81,187,650,137,3,36,240,-6,99,192.65,333,525.65,0.6522842639593909,0.25,0.7894736842105263
2020,Cleveland Cavaliers,Auburn,Isaac Okoro,195.58,102.0582,SG,67,2173,235,559,0.42,62,214,0.29,114,157,0.726,68,138,206,128,62,24,86,185,646,324,152,43,-178,-270,71,91.25,-377,-285.75,0.4203935599284436,0.2897196261682243,0.7261146496815286
2020,Sacramento Kings,Utah,Delon Wright,195.58,83.91452,PG,63,1748,240,518,0.463,64,172,0.372,101,126,0.802,65,204,269,278,101,30,83,75,645,278,108,25,-76,-132,76,173.25,-132,41.25,0.46332046332046334,0.37209302325581395,0.8015873015873016
2020,Sacramento Kings,Utah,Delon Wright,195.58,83.91452,PG,63,1748,240,518,0.463,64,172,0.372,101,126,0.802,65,204,269,278,101,30,83,75,645,278,108,25,-76,-132,76,173.25,-132,41.25,0.46332046332046334,0.37209302325581395,0.8015873015873016
2020,Sacramento Kings,Utah,Delon Wright,195.58,83.91452,PG,63,1748,240,518,0.463,64,172,0.372,101,126,0.802,65,204,269,278,101,30,83,75,645,278,108,25,-76,-132,76,173.25,-132,41.25,0.46332046332046334,0.37209302325581395,0.8015873015873016
2020,Sacramento Kings,Utah,Delon Wright,195.58,83.91452,PG,63,1748,240,518,0.463,64,172,0.372,101,126,0.802,65,204,269,278,101,30,83,75,645,278,108,25,-76,-132,76,173.25,-132,41.25,0.46332046332046334,0.37209302325581395,0.8015873015873016
2020,Sacramento Kings,Utah,Delon Wright,195.58,83.91452,PG,63,1748,240,518,0.463,64,172,0.372,101,126,0.802,65,204,269,278,101,30,83,75,645,278,108,25,-76,-132,76,173.25,-132,41.25,0.46332046332046334,0.37209302325581395,0.8015873015873016
2020,Sacramento Kings,Utah,Delon Wright,195.58,83.91452,PG,63,1748,240,518,0.463,64,172,0.372,101,126,0.802,65,204,269,278,101,30,83,75,645,278,108,25,-76,-132,76,173.25,-132,41.25,0.46332046332046334,0.37209302325581395,0.8015873015873016
2020,Sacramento Kings,Utah,Delon Wright,195.58,83.91452,PG,63,1748,240,518,0.463,64,172,0.372,101,126,0.802,65,204,269,278,101,30,83,75,645,278,108,25,-76,-132,76,173.25,-132,41.25,0.46332046332046334,0.37209302325581395,0.8015873015873016
2020,Sacramento Kings,Utah,Delon Wright,195.58,83.91452,PG,63,1748,240,518,0.463,64,172,0.372,101,126,0.802,65,204,269,278,101,30,83,75,645,278,108,25,-76,-132,76,173.25,-132,41.25,0.46332046332046334,0.37209302325581395,0.8015873015873016
2020,Sacramento Kings,Utah,Delon Wright,195.58,83.91452,PG,63,1748,240,518,0.463,64,172,0.372,101,126,0.802,65,204,269,278,101,30,83,75,645,278,108,25,-76,-132,76,173.25,-132,41.25,0.46332046332046334,0.37209302325581395,0.8015873015873016
2020,Washington Wizards,Stanford,Robin Lopez,213.36,127.459352,C,71,1354,269,425,0.633,5,18,0.278,99,137,0.723,141,131,272,55,15,44,75,109,642,156,13,38,226,-24,61,103.55,263,366.55,0.6329411764705882,0.2777777777777778,0.7226277372262774
2020,New York Knicks,Louisana-Lafayette,Elfrid Payton,190.5,88.45044,PG,63,1484,269,622,0.432,28,98,0.286,73,107,0.682,64,152,216,203,47,9,103,116,639,353,70,34,-168,-126,39,91.45,-255,-163.55,0.432475884244373,0.2857142857142857,0.6822429906542056
2020,Chicago Bulls,,Daniel Theis,203.2,111.13004,C,65,1601,252,466,0.541,49,152,0.322,74,110,0.673,93,263,356,108,41,57,66,167,627,214,103,36,76,-162,38,146.9,-48,98.9,0.5407725321888412,0.3223684210526316,0.6727272727272727
2020,Chicago Bulls,,Daniel Theis,203.2,111.13004,C,65,1601,252,466,0.541,49,152,0.322,74,110,0.673,93,263,356,108,41,57,66,167,627,214,103,36,76,-162,38,146.9,-48,98.9,0.5407725321888412,0.3223684210526316,0.6727272727272727
2020,Chicago Bulls,,Daniel Theis,203.2,111.13004,C,65,1601,252,466,0.541,49,152,0.322,74,110,0.673,93,263,356,108,41,57,66,167,627,214,103,36,76,-162,38,146.9,-48,98.9,0.5407725321888412,0.3223684210526316,0.6727272727272727
2020,Chicago Bulls,,Daniel Theis,203.2,111.13004,C,65,1601,252,466,0.541,49,152,0.322,74,110,0.673,93,263,356,108,41,57,66,167,627,214,103,36,76,-162,38,146.9,-48,98.9,0.5407725321888412,0.3223684210526316,0.6727272727272727
2020,Chicago Bulls,,Daniel Theis,203.2,111.13004,C,65,1601,252,466,0.541,49,152,0.322,74,110,0.673,93,263,356,108,41,57,66,167,627,214,103,36,76,-162,38,146.9,-48,98.9,0.5407725321888412,0.3223684210526316,0.6727272727272727
2020,Chicago Bulls,,Daniel Theis,203.2,111.13004,C,65,1601,252,466,0.541,49,152,0.322,74,110,0.673,93,263,356,108,41,57,66,167,627,214,103,36,76,-162,38,146.9,-48,98.9,0.5407725321888412,0.3223684210526316,0.6727272727272727
2020,Chicago Bulls,,Daniel Theis,203.2,111.13004,C,65,1601,252,466,0.541,49,152,0.322,74,110,0.673,93,263,356,108,41,57,66,167,627,214,103,36,76,-162,38,146.9,-48,98.9,0.5407725321888412,0.3223684210526316,0.6727272727272727
2020,Chicago Bulls,,Daniel Theis,203.2,111.13004,C,65,1601,252,466,0.541,49,152,0.322,74,110,0.673,93,263,356,108,41,57,66,167,627,214,103,36,76,-162,38,146.9,-48,98.9,0.5407725321888412,0.3223684210526316,0.6727272727272727
2020,Chicago Bulls,,Daniel Theis,203.2,111.13004,C,65,1601,252,466,0.541,49,152,0.322,74,110,0.673,93,263,356,108,41,57,66,167,627,214,103,36,76,-162,38,146.9,-48,98.9,0.5407725321888412,0.3223684210526316,0.6727272727272727
2020,Boston Celtics,Oklahoma State,Marcus Smart,190.5,99.79024,PG,48,1581,203,510,0.398,93,282,0.33,128,162,0.79,36,131,167,273,72,23,96,126,627,307,189,34,-208,-288,94,112.2,-402,-289.8,0.3980392156862745,0.32978723404255317,0.7901234567901234
2020,Memphis Grizzlies,TCU,Desmond Bane,195.58,97.52228,SG,68,1519,234,499,0.469,117,271,0.432,40,49,0.816,31,179,210,118,41,16,59,125,625,265,154,9,-62,-111,31,82.5,-142,-59.5,0.46893787575150303,0.4317343173431734,0.8163265306122449
2020,New York Knicks,Colorado,Alec Burks,198.12,97.068688,SG,49,1255,210,500,0.42,102,246,0.415,101,118,0.856,21,206,227,107,31,14,49,102,623,290,144,17,-160,-126,84,81.65,-202,-120.35,0.42,0.4146341463414634,0.8559322033898306
2020,Denver Nuggets,Arizona,Aaron Gordon,203.2,106.59412,PF,50,1384,231,499,0.463,59,176,0.335,97,149,0.651,77,207,284,161,33,34,97,89,618,268,117,52,-74,-174,45,111.05,-203,-91.95,0.46292585170340683,0.3352272727272727,0.6510067114093959
2020,Denver Nuggets,Arizona,Aaron Gordon,203.2,106.59412,PF,50,1384,231,499,0.463,59,176,0.335,97,149,0.651,77,207,284,161,33,34,97,89,618,268,117,52,-74,-174,45,111.05,-203,-91.95,0.46292585170340683,0.3352272727272727,0.6510067114093959
2020,Denver Nuggets,Arizona,Aaron Gordon,203.2,106.59412,PF,50,1384,231,499,0.463,59,176,0.335,97,149,0.651,77,207,284,161,33,34,97,89,618,268,117,52,-74,-174,45,111.05,-203,-91.95,0.46292585170340683,0.3352272727272727,0.6510067114093959
2020,Denver Nuggets,Arizona,Aaron Gordon,203.2,106.59412,PF,50,1384,231,499,0.463,59,176,0.335,97,149,0.651,77,207,284,161,33,34,97,89,618,268,117,52,-74,-174,45,111.05,-203,-91.95,0.46292585170340683,0.3352272727272727,0.6510067114093959
2020,Denver Nuggets,Arizona,Aaron Gordon,203.2,106.59412,PF,50,1384,231,499,0.463,59,176,0.335,97,149,0.651,77,207,284,161,33,34,97,89,618,268,117,52,-74,-174,45,111.05,-203,-91.95,0.46292585170340683,0.3352272727272727,0.6510067114093959
2020,Denver Nuggets,Arizona,Aaron Gordon,203.2,106.59412,PF,50,1384,231,499,0.463,59,176,0.335,97,149,0.651,77,207,284,161,33,34,97,89,618,268,117,52,-74,-174,45,111.05,-203,-91.95,0.46292585170340683,0.3352272727272727,0.6510067114093959
2020,Denver Nuggets,Arizona,Aaron Gordon,203.2,106.59412,PF,50,1384,231,499,0.463,59,176,0.335,97,149,0.651,77,207,284,161,33,34,97,89,618,268,117,52,-74,-174,45,111.05,-203,-91.95,0.46292585170340683,0.3352272727272727,0.6510067114093959
2020,Denver Nuggets,Arizona,Aaron Gordon,203.2,106.59412,PF,50,1384,231,499,0.463,59,176,0.335,97,149,0.651,77,207,284,161,33,34,97,89,618,268,117,52,-74,-174,45,111.05,-203,-91.95,0.46292585170340683,0.3352272727272727,0.6510067114093959
2020,Denver Nuggets,Arizona,Aaron Gordon,203.2,106.59412,PF,50,1384,231,499,0.463,59,176,0.335,97,149,0.651,77,207,284,161,33,34,97,89,618,268,117,52,-74,-174,45,111.05,-203,-91.95,0.46292585170340683,0.3352272727272727,0.6510067114093959
2020,Cleveland Cavaliers,,Cedi Osman,200.66,104.32616,SF,59,1511,219,586,0.374,99,324,0.306,76,95,0.8,38,163,201,174,53,9,80,119,613,367,225,19,-296,-378,57,88.3,-617,-528.7,0.37372013651877134,0.3055555555555556,0.8
2020,Golden State Warriors,Michigan,Jordan Poole,193.04,87.996848,SG,51,988,205,474,0.432,97,276,0.351,105,119,0.882,15,77,92,99,26,9,51,86,612,269,179,14,-128,-246,91,39.2,-283,-243.8,0.43248945147679324,0.35144927536231885,0.8823529411764706
2020,Memphis Grizzlies,Gonzaga,Brandon Clarke,203.2,97.52228,PF,59,1415,256,495,0.517,20,77,0.26,78,113,0.69,97,231,328,95,60,51,33,84,610,239,57,35,34,-111,43,164.8,-34,130.8,0.5171717171717172,0.2597402597402597,0.6902654867256637
2020,Sacramento Kings,Duke,Marvin Bagley III,210.82,106.59412,PF,43,1112,247,490,0.504,37,108,0.343,77,134,0.575,106,212,318,43,21,21,59,100,608,243,71,57,8,-102,20,103.25,-74,29.25,0.5040816326530613,0.3425925925925926,0.5746268656716418
2020,Orlando Magic,Duke,Wendell Carter Jr.,208.28,122.46984,C,54,1375,230,457,0.503,15,51,0.294,131,179,0.732,132,311,443,104,35,42,78,146,606,227,36,48,6,-63,83,161.95,26,187.95,0.5032822757111597,0.29411764705882354,0.7318435754189944
2020,Orlando Magic,Duke,Wendell Carter Jr.,208.28,122.46984,C,54,1375,230,457,0.503,15,51,0.294,131,179,0.732,132,311,443,104,35,42,78,146,606,227,36,48,6,-63,83,161.95,26,187.95,0.5032822757111597,0.29411764705882354,0.7318435754189944
2020,Orlando Magic,Duke,Wendell Carter Jr.,208.28,122.46984,C,54,1375,230,457,0.503,15,51,0.294,131,179,0.732,132,311,443,104,35,42,78,146,606,227,36,48,6,-63,83,161.95,26,187.95,0.5032822757111597,0.29411764705882354,0.7318435754189944
2020,Orlando Magic,Duke,Wendell Carter Jr.,208.28,122.46984,C,54,1375,230,457,0.503,15,51,0.294,131,179,0.732,132,311,443,104,35,42,78,146,606,227,36,48,6,-63,83,161.95,26,187.95,0.5032822757111597,0.29411764705882354,0.7318435754189944
2020,Orlando Magic,Duke,Wendell Carter Jr.,208.28,122.46984,C,54,1375,230,457,0.503,15,51,0.294,131,179,0.732,132,311,443,104,35,42,78,146,606,227,36,48,6,-63,83,161.95,26,187.95,0.5032822757111597,0.29411764705882354,0.7318435754189944
2020,Orlando Magic,Duke,Wendell Carter Jr.,208.28,122.46984,C,54,1375,230,457,0.503,15,51,0.294,131,179,0.732,132,311,443,104,35,42,78,146,606,227,36,48,6,-63,83,161.95,26,187.95,0.5032822757111597,0.29411764705882354,0.7318435754189944
2020,Orlando Magic,Duke,Wendell Carter Jr.,208.28,122.46984,C,54,1375,230,457,0.503,15,51,0.294,131,179,0.732,132,311,443,104,35,42,78,146,606,227,36,48,6,-63,83,161.95,26,187.95,0.5032822757111597,0.29411764705882354,0.7318435754189944
2020,Orlando Magic,Duke,Wendell Carter Jr.,208.28,122.46984,C,54,1375,230,457,0.503,15,51,0.294,131,179,0.732,132,311,443,104,35,42,78,146,606,227,36,48,6,-63,83,161.95,26,187.95,0.5032822757111597,0.29411764705882354,0.7318435754189944
2020,Orlando Magic,Duke,Wendell Carter Jr.,208.28,122.46984,C,54,1375,230,457,0.503,15,51,0.294,131,179,0.732,132,311,443,104,35,42,78,146,606,227,36,48,6,-63,83,161.95,26,187.95,0.5032822757111597,0.29411764705882354,0.7318435754189944
2020,Orlando Magic,North Carolina,Cole Anthony,187.96,83.91452,PG,47,1273,219,552,0.397,58,172,0.337,109,131,0.832,38,183,221,192,30,18,106,98,605,333,114,22,-228,-168,87,78.85,-309,-230.15,0.3967391304347826,0.3372093023255814,0.8320610687022901
2020,Detroit Pistons,Kentucky,Hamidou Diallo,195.58,91.625584,SG,52,1226,224,470,0.477,28,82,0.341,128,200,0.64,59,213,272,101,41,24,76,134,604,246,54,72,-44,-78,56,95.8,-66,29.799999999999997,0.4765957446808511,0.34146341463414637,0.64
2020,Detroit Pistons,Kentucky,Hamidou Diallo,195.58,91.625584,SG,52,1226,224,470,0.477,28,82,0.341,128,200,0.64,59,213,272,101,41,24,76,134,604,246,54,72,-44,-78,56,95.8,-66,29.799999999999997,0.4765957446808511,0.34146341463414637,0.64
2020,Detroit Pistons,Kentucky,Hamidou Diallo,195.58,91.625584,SG,52,1226,224,470,0.477,28,82,0.341,128,200,0.64,59,213,272,101,41,24,76,134,604,246,54,72,-44,-78,56,95.8,-66,29.799999999999997,0.4765957446808511,0.34146341463414637,0.64
2020,Detroit Pistons,Kentucky,Hamidou Diallo,195.58,91.625584,SG,52,1226,224,470,0.477,28,82,0.341,128,200,0.64,59,213,272,101,41,24,76,134,604,246,54,72,-44,-78,56,95.8,-66,29.799999999999997,0.4765957446808511,0.34146341463414637,0.64
2020,Detroit Pistons,Kentucky,Hamidou Diallo,195.58,91.625584,SG,52,1226,224,470,0.477,28,82,0.341,128,200,0.64,59,213,272,101,41,24,76,134,604,246,54,72,-44,-78,56,95.8,-66,29.799999999999997,0.4765957446808511,0.34146341463414637,0.64
2020,Detroit Pistons,Kentucky,Hamidou Diallo,195.58,91.625584,SG,52,1226,224,470,0.477,28,82,0.341,128,200,0.64,59,213,272,101,41,24,76,134,604,246,54,72,-44,-78,56,95.8,-66,29.799999999999997,0.4765957446808511,0.34146341463414637,0.64
2020,Detroit Pistons,Kentucky,Hamidou Diallo,195.58,91.625584,SF,52,1226,224,470,0.477,28,82,0.341,128,200,0.64,59,213,272,101,41,24,76,134,604,246,54,72,-44,-78,56,95.8,-66,29.799999999999997,0.4765957446808511,0.34146341463414637,0.64
2020,Detroit Pistons,Kentucky,Hamidou Diallo,195.58,91.625584,SF,52,1226,224,470,0.477,28,82,0.341,128,200,0.64,59,213,272,101,41,24,76,134,604,246,54,72,-44,-78,56,95.8,-66,29.799999999999997,0.4765957446808511,0.34146341463414637,0.64
2020,Detroit Pistons,Kentucky,Hamidou Diallo,195.58,91.625584,SF,52,1226,224,470,0.477,28,82,0.341,128,200,0.64,59,213,272,101,41,24,76,134,604,246,54,72,-44,-78,56,95.8,-66,29.799999999999997,0.4765957446808511,0.34146341463414637,0.64
2020,Phoenix Suns,Marquette,Jae Crowder,198.12,106.59412,PF,60,1648,199,492,0.404,148,380,0.389,57,75,0.76,32,250,282,127,48,27,55,125,603,293,232,18,-188,-252,39,114.0,-401,-287.0,0.40447154471544716,0.3894736842105263,0.76
2020,Indiana Pacers,Arizona,T.J. McConnell,185.42,86.18248,PG,69,1796,274,490,0.559,15,48,0.313,33,48,0.688,55,201,256,456,128,23,135,113,596,216,33,15,116,-54,18,194.1,80,274.1,0.5591836734693878,0.3125,0.6875
2020,San Antonio Spurs,Utah,Jakob Poeltl,215.9,111.13004,C,69,1845,265,430,0.616,0,0,0.0,63,124,0.508,219,328,547,134,47,123,83,172,593,165,0,61,200,0,2,259.9,202,461.9,0.6162790697674418,,0.5080645161290323
2020,Portland Trail Blazers,Tennessee State,Robert Covington,200.66,94.800728,PF,70,2243,204,509,0.401,135,356,0.379,50,62,0.806,61,405,466,117,101,84,64,195,593,305,221,12,-202,-258,38,211.75,-422,-210.25,0.40078585461689586,0.3792134831460674,0.8064516129032258
2020,Indiana Pacers,Texas-Austin,Myles Turner,210.82,113.398,C,47,1455,206,432,0.477,69,206,0.335,111,142,0.782,63,243,306,48,40,159,67,165,592,226,137,31,-40,-204,80,162.0,-164,-2.0,0.47685185185185186,0.33495145631067963,0.7816901408450704
2020,Dallas Mavericks,Florida,Dorian Finney-Smith,200.66,99.79024,PF,60,1921,220,466,0.472,119,302,0.394,31,41,0.756,98,228,326,102,52,25,48,138,590,246,183,10,-52,-192,21,139.1,-223,-83.9,0.4721030042918455,0.39403973509933776,0.7560975609756098
2020,Los Angeles Lakers,Iowa State,Talen Horton-Tucker,193.04,106.140528,SG,65,1304,224,489,0.458,37,131,0.282,100,129,0.775,25,144,169,181,63,21,105,127,585,265,94,29,-82,-171,71,76.9,-182,-105.1,0.45807770961145194,0.2824427480916031,0.7751937984496124
2020,Minnesota Timberwolves,,Ricky Rubio,190.5,86.18248,PG,68,1772,193,498,0.388,66,214,0.308,130,150,0.867,28,195,223,433,98,4,111,139,582,305,148,20,-224,-246,110,159.55,-360,-200.45,0.38755020080321284,0.308411214953271,0.8666666666666667
2020,Detroit Pistons,Duke,Mason Plumlee,210.82,115.212368,C,56,1499,234,381,0.614,0,7,0.0,113,169,0.669,145,374,519,202,43,50,105,186,581,147,7,56,174,-21,57,201.2,210,411.2,0.6141732283464567,0.0,0.6686390532544378
2020,Brooklyn Nets,Miami,Bruce Brown,193.04,91.625584,PG,65,1451,235,423,0.556,17,59,0.288,86,117,0.735,111,238,349,104,58,28,54,145,573,188,42,31,94,-75,55,149.75,74,223.75,0.5555555555555556,0.288135593220339,0.7350427350427351
2020,Phoenix Suns,North Carolina,Cameron Johnson,203.2,95.25432,PF,60,1437,203,483,0.42,117,335,0.349,50,59,0.847,33,166,199,86,37,16,40,85,573,280,218,9,-154,-303,41,81.75,-416,-334.25,0.42028985507246375,0.3492537313432836,0.847457627118644
2020,Brooklyn Nets,Wichita State,Landry Shamet,193.04,86.18248,SG,61,1403,186,456,0.408,129,333,0.387,66,78,0.846,11,101,112,99,31,10,48,93,567,270,204,12,-168,-225,54,47.35,-339,-291.65,0.40789473684210525,0.38738738738738737,0.8461538461538461
2020,Oklahoma City Thunder,Kansas,Svi Mykhailiuk,200.66,92.98636,SF,66,1324,208,506,0.411,105,314,0.334,38,50,0.76,24,139,163,110,51,12,88,63,559,298,209,12,-180,-312,26,58.6,-466,-407.4,0.41106719367588934,0.3343949044585987,0.76
2020,Oklahoma City Thunder,Kansas,Svi Mykhailiuk,200.66,92.98636,SF,66,1324,208,506,0.411,105,314,0.334,38,50,0.76,24,139,163,110,51,12,88,63,559,298,209,12,-180,-312,26,58.6,-466,-407.4,0.41106719367588934,0.3343949044585987,0.76
2020,Oklahoma City Thunder,Kansas,Svi Mykhailiuk,200.66,92.98636,SF,66,1324,208,506,0.411,105,314,0.334,38,50,0.76,24,139,163,110,51,12,88,63,559,298,209,12,-180,-312,26,58.6,-466,-407.4,0.41106719367588934,0.3343949044585987,0.76
2020,Oklahoma City Thunder,Kansas,Svi Mykhailiuk,200.66,92.98636,SF,66,1324,208,506,0.411,105,314,0.334,38,50,0.76,24,139,163,110,51,12,88,63,559,298,209,12,-180,-312,26,58.6,-466,-407.4,0.41106719367588934,0.3343949044585987,0.76
2020,Oklahoma City Thunder,Kansas,Svi Mykhailiuk,200.66,92.98636,SF,66,1324,208,506,0.411,105,314,0.334,38,50,0.76,24,139,163,110,51,12,88,63,559,298,209,12,-180,-312,26,58.6,-466,-407.4,0.41106719367588934,0.3343949044585987,0.76
2020,Oklahoma City Thunder,Kansas,Svi Mykhailiuk,200.66,92.98636,SF,66,1324,208,506,0.411,105,314,0.334,38,50,0.76,24,139,163,110,51,12,88,63,559,298,209,12,-180,-312,26,58.6,-466,-407.4,0.41106719367588934,0.3343949044585987,0.76
2020,Oklahoma City Thunder,Kansas,Svi Mykhailiuk,200.66,92.98636,SF,66,1324,208,506,0.411,105,314,0.334,38,50,0.76,24,139,163,110,51,12,88,63,559,298,209,12,-180,-312,26,58.6,-466,-407.4,0.41106719367588934,0.3343949044585987,0.76
2020,Oklahoma City Thunder,Kansas,Svi Mykhailiuk,200.66,92.98636,SF,66,1324,208,506,0.411,105,314,0.334,38,50,0.76,24,139,163,110,51,12,88,63,559,298,209,12,-180,-312,26,58.6,-466,-407.4,0.41106719367588934,0.3343949044585987,0.76
2020,Oklahoma City Thunder,Kansas,Svi Mykhailiuk,200.66,92.98636,SF,66,1324,208,506,0.411,105,314,0.334,38,50,0.76,24,139,163,110,51,12,88,63,559,298,209,12,-180,-312,26,58.6,-466,-407.4,0.41106719367588934,0.3343949044585987,0.76
2020,Washington Wizards,,Raul Neto,185.42,81.64656,PG,64,1403,209,447,0.468,64,164,0.39,75,85,0.882,28,128,156,146,73,6,53,109,557,238,100,10,-58,-108,65,90.05,-101,-10.950000000000003,0.46756152125279643,0.3902439024390244,0.8823529411764706
2020,San Antonio Spurs,Colorado,Derrick White,193.04,86.18248,SG,36,1064,186,453,0.411,84,243,0.346,97,114,0.851,13,94,107,127,26,36,45,91,553,267,159,17,-162,-225,80,65.7,-307,-241.3,0.4105960264900662,0.345679012345679,0.8508771929824561
2020,Los Angeles Clippers,,Nicolas Batum,203.2,104.32616,SF,67,1835,191,412,0.464,110,272,0.404,48,58,0.828,50,266,316,148,69,37,53,102,540,221,162,10,-60,-156,38,149.9,-178,-28.099999999999994,0.46359223300970875,0.40441176470588236,0.8275862068965517
2020,Detroit Pistons,Washington,Isaiah Stewart,203.2,113.398,C,68,1455,226,409,0.553,21,63,0.333,64,92,0.696,159,294,453,59,39,86,67,184,537,183,42,28,86,-63,36,187.55,59,246.55,0.5525672371638142,0.3333333333333333,0.6956521739130435
2020,Oklahoma City Thunder,Nebraska-Lincoln,Isaiah Roby,203.2,104.32616,PF,61,1425,207,429,0.483,32,109,0.294,87,117,0.744,89,252,341,107,52,37,113,162,533,222,77,30,-30,-135,57,114.15,-108,6.150000000000006,0.4825174825174825,0.29357798165137616,0.7435897435897436
2020,Sacramento Kings,Mississippi,Terence Davis,193.04,91.171992,SG,61,1074,195,456,0.428,98,267,0.367,45,55,0.818,20,134,154,83,44,14,63,97,533,261,169,10,-132,-213,35,56.9,-310,-253.1,0.4276315789473684,0.36704119850187267,0.8181818181818182
2020,Sacramento Kings,Mississippi,Terence Davis,193.04,91.171992,SG,61,1074,195,456,0.428,98,267,0.367,45,55,0.818,20,134,154,83,44,14,63,97,533,261,169,10,-132,-213,35,56.9,-310,-253.1,0.4276315789473684,0.36704119850187267,0.8181818181818182
2020,Sacramento Kings,Mississippi,Terence Davis,193.04,91.171992,SG,61,1074,195,456,0.428,98,267,0.367,45,55,0.818,20,134,154,83,44,14,63,97,533,261,169,10,-132,-213,35,56.9,-310,-253.1,0.4276315789473684,0.36704119850187267,0.8181818181818182
2020,Sacramento Kings,Mississippi,Terence Davis,193.04,91.171992,SG,61,1074,195,456,0.428,98,267,0.367,45,55,0.818,20,134,154,83,44,14,63,97,533,261,169,10,-132,-213,35,56.9,-310,-253.1,0.4276315789473684,0.36704119850187267,0.8181818181818182
2020,Sacramento Kings,Mississippi,Terence Davis,193.04,91.171992,SG,61,1074,195,456,0.428,98,267,0.367,45,55,0.818,20,134,154,83,44,14,63,97,533,261,169,10,-132,-213,35,56.9,-310,-253.1,0.4276315789473684,0.36704119850187267,0.8181818181818182
2020,Sacramento Kings,Mississippi,Terence Davis,193.04,91.171992,SG,61,1074,195,456,0.428,98,267,0.367,45,55,0.818,20,134,154,83,44,14,63,97,533,261,169,10,-132,-213,35,56.9,-310,-253.1,0.4276315789473684,0.36704119850187267,0.8181818181818182
2020,Sacramento Kings,Mississippi,Terence Davis,193.04,91.171992,SG,61,1074,195,456,0.428,98,267,0.367,45,55,0.818,20,134,154,83,44,14,63,97,533,261,169,10,-132,-213,35,56.9,-310,-253.1,0.4276315789473684,0.36704119850187267,0.8181818181818182
2020,Sacramento Kings,Mississippi,Terence Davis,193.04,91.171992,SG,61,1074,195,456,0.428,98,267,0.367,45,55,0.818,20,134,154,83,44,14,63,97,533,261,169,10,-132,-213,35,56.9,-310,-253.1,0.4276315789473684,0.36704119850187267,0.8181818181818182
2020,Sacramento Kings,Mississippi,Terence Davis,193.04,91.171992,SG,61,1074,195,456,0.428,98,267,0.367,45,55,0.818,20,134,154,83,44,14,63,97,533,261,169,10,-132,-213,35,56.9,-310,-253.1,0.4276315789473684,0.36704119850187267,0.8181818181818182
2020,Memphis Grizzlies,Duke,Grayson Allen,193.04,89.811216,SG,50,1260,173,414,0.418,107,274,0.391,79,91,0.868,19,141,160,108,46,8,48,71,532,241,167,12,-136,-180,67,71.2,-249,-177.8,0.4178743961352657,0.3905109489051095,0.8681318681318682
2020,Oklahoma City Thunder,TCU,Kenrich Williams,198.12,95.25432,PF,66,1426,219,411,0.533,52,117,0.444,36,63,0.571,84,189,273,152,55,17,76,143,526,192,65,27,54,-39,9,118.1,24,142.1,0.5328467153284672,0.4444444444444444,0.5714285714285714
2020,Los Angeles Clippers,Duke,Luke Kennard,195.58,93.439952,SG,63,1232,197,414,0.476,100,224,0.446,26,31,0.839,15,146,161,104,23,9,48,91,520,217,124,5,-40,-72,21,57.45,-91,-33.55,0.4758454106280193,0.44642857142857145,0.8387096774193549
2020,Detroit Pistons,University of Texas at Austin,Cory Joseph,190.5,90.7184,PG,63,1446,200,426,0.469,45,132,0.341,72,88,0.818,35,124,159,213,61,18,79,139,517,226,87,16,-52,-126,56,94.8,-122,-27.200000000000003,0.4694835680751174,0.3409090909090909,0.8181818181818182
2020,Detroit Pistons,University of Texas at Austin,Cory Joseph,190.5,90.7184,PG,63,1446,200,426,0.469,45,132,0.341,72,88,0.818,35,124,159,213,61,18,79,139,517,226,87,16,-52,-126,56,94.8,-122,-27.200000000000003,0.4694835680751174,0.3409090909090909,0.8181818181818182
2020,Detroit Pistons,University of Texas at Austin,Cory Joseph,190.5,90.7184,PG,63,1446,200,426,0.469,45,132,0.341,72,88,0.818,35,124,159,213,61,18,79,139,517,226,87,16,-52,-126,56,94.8,-122,-27.200000000000003,0.4694835680751174,0.3409090909090909,0.8181818181818182
2020,Detroit Pistons,University of Texas at Austin,Cory Joseph,190.5,90.7184,PG,63,1446,200,426,0.469,45,132,0.341,72,88,0.818,35,124,159,213,61,18,79,139,517,226,87,16,-52,-126,56,94.8,-122,-27.200000000000003,0.4694835680751174,0.3409090909090909,0.8181818181818182
2020,Detroit Pistons,University of Texas at Austin,Cory Joseph,190.5,90.7184,PG,63,1446,200,426,0.469,45,132,0.341,72,88,0.818,35,124,159,213,61,18,79,139,517,226,87,16,-52,-126,56,94.8,-122,-27.200000000000003,0.4694835680751174,0.3409090909090909,0.8181818181818182
2020,Detroit Pistons,University of Texas at Austin,Cory Joseph,190.5,90.7184,PG,63,1446,200,426,0.469,45,132,0.341,72,88,0.818,35,124,159,213,61,18,79,139,517,226,87,16,-52,-126,56,94.8,-122,-27.200000000000003,0.4694835680751174,0.3409090909090909,0.8181818181818182
2020,Detroit Pistons,University of Texas at Austin,Cory Joseph,190.5,90.7184,PG,63,1446,200,426,0.469,45,132,0.341,72,88,0.818,35,124,159,213,61,18,79,139,517,226,87,16,-52,-126,56,94.8,-122,-27.200000000000003,0.4694835680751174,0.3409090909090909,0.8181818181818182
2020,Detroit Pistons,University of Texas at Austin,Cory Joseph,190.5,90.7184,PG,63,1446,200,426,0.469,45,132,0.341,72,88,0.818,35,124,159,213,61,18,79,139,517,226,87,16,-52,-126,56,94.8,-122,-27.200000000000003,0.4694835680751174,0.3409090909090909,0.8181818181818182
2020,Detroit Pistons,University of Texas at Austin,Cory Joseph,190.5,90.7184,PG,63,1446,200,426,0.469,45,132,0.341,72,88,0.818,35,124,159,213,61,18,79,139,517,226,87,16,-52,-126,56,94.8,-122,-27.200000000000003,0.4694835680751174,0.3409090909090909,0.8181818181818182
2020,Boston Celtics,Oregon,Payton Pritchard,185.42,88.45044,SG,66,1268,184,418,0.44,102,248,0.411,40,45,0.889,33,125,158,120,37,9,53,104,510,234,146,5,-100,-132,35,69.05,-197,-127.95,0.44019138755980863,0.4112903225806452,0.8888888888888888
2020,New Orleans Pelicans,Virginia Tech,Nickeil Alexander-Walker,198.12,92.98636,SG,46,1007,192,458,0.419,76,219,0.347,48,66,0.727,13,131,144,102,47,22,69,88,508,266,143,18,-148,-201,30,60.35,-319,-258.65,0.4192139737991266,0.3470319634703196,0.7272727272727273
2020,Brooklyn Nets,Oklahoma,Blake Griffin,205.74,113.398,PF,46,1187,174,411,0.423,70,205,0.341,87,117,0.744,35,190,225,140,32,15,62,111,505,237,135,30,-126,-195,57,86.95,-264,-177.05,0.4233576642335766,0.34146341463414637,0.7435897435897436
2020,Brooklyn Nets,Oklahoma,Blake Griffin,205.74,113.398,PF,46,1187,174,411,0.423,70,205,0.341,87,117,0.744,35,190,225,140,32,15,62,111,505,237,135,30,-126,-195,57,86.95,-264,-177.05,0.4233576642335766,0.34146341463414637,0.7435897435897436
2020,Brooklyn Nets,Oklahoma,Blake Griffin,205.74,113.398,PF,46,1187,174,411,0.423,70,205,0.341,87,117,0.744,35,190,225,140,32,15,62,111,505,237,135,30,-126,-195,57,86.95,-264,-177.05,0.4233576642335766,0.34146341463414637,0.7435897435897436
2020,Brooklyn Nets,Oklahoma,Blake Griffin,205.74,113.398,PF,46,1187,174,411,0.423,70,205,0.341,87,117,0.744,35,190,225,140,32,15,62,111,505,237,135,30,-126,-195,57,86.95,-264,-177.05,0.4233576642335766,0.34146341463414637,0.7435897435897436
2020,Brooklyn Nets,Oklahoma,Blake Griffin,205.74,113.398,PF,46,1187,174,411,0.423,70,205,0.341,87,117,0.744,35,190,225,140,32,15,62,111,505,237,135,30,-126,-195,57,86.95,-264,-177.05,0.4233576642335766,0.34146341463414637,0.7435897435897436
2020,Brooklyn Nets,Oklahoma,Blake Griffin,205.74,113.398,PF,46,1187,174,411,0.423,70,205,0.341,87,117,0.744,35,190,225,140,32,15,62,111,505,237,135,30,-126,-195,57,86.95,-264,-177.05,0.4233576642335766,0.34146341463414637,0.7435897435897436
2020,Brooklyn Nets,Oklahoma,Blake Griffin,205.74,113.398,PF,46,1187,174,411,0.423,70,205,0.341,87,117,0.744,35,190,225,140,32,15,62,111,505,237,135,30,-126,-195,57,86.95,-264,-177.05,0.4233576642335766,0.34146341463414637,0.7435897435897436
2020,Brooklyn Nets,Oklahoma,Blake Griffin,205.74,113.398,PF,46,1187,174,411,0.423,70,205,0.341,87,117,0.744,35,190,225,140,32,15,62,111,505,237,135,30,-126,-195,57,86.95,-264,-177.05,0.4233576642335766,0.34146341463414637,0.7435897435897436
2020,Brooklyn Nets,Oklahoma,Blake Griffin,205.74,113.398,PF,46,1187,174,411,0.423,70,205,0.341,87,117,0.744,35,190,225,140,32,15,62,111,505,237,135,30,-126,-195,57,86.95,-264,-177.05,0.4233576642335766,0.34146341463414637,0.7435897435897436
2020,Phoenix Suns,Murray State,Cameron Payne,185.42,83.007336,PG,60,1079,191,395,0.484,73,166,0.44,50,56,0.893,16,128,144,217,36,16,60,97,505,204,93,6,-26,-60,44,85.4,-42,43.400000000000006,0.4835443037974684,0.4397590361445783,0.8928571428571429
2020,Portland Trail Blazers,,Anfernee Simons,190.5,82.10015200000001,SG,64,1104,168,401,0.419,120,282,0.426,46,57,0.807,14,126,140,89,18,8,43,96,502,233,162,11,-130,-126,35,47.45,-221,-173.55,0.41895261845386533,0.425531914893617,0.8070175438596491
2020,Denver Nuggets,Louisiana Tech,Paul Millsap,200.66,116.573144,PF,56,1162,191,401,0.476,49,143,0.343,71,98,0.724,76,186,262,98,51,36,51,111,502,210,94,27,-38,-135,44,121.45,-129,-7.549999999999997,0.4763092269326683,0.34265734265734266,0.7244897959183674
2020,Philadelphia 76ers,,Furkan Korkmaz,200.66,91.625584,SG,55,1062,170,424,0.401,101,269,0.375,60,82,0.732,17,96,113,82,49,9,46,64,501,254,168,22,-168,-201,38,55.8,-331,-275.2,0.4009433962264151,0.3754646840148699,0.7317073170731707
2020,Utah Jazz,Iowa State,Georges Niang,200.66,104.32616,PF,72,1154,177,405,0.437,124,292,0.425,22,23,0.957,28,148,176,59,25,8,51,116,500,228,168,1,-102,-132,21,50.95,-213,-162.05,0.43703703703703706,0.4246575342465753,0.9565217391304348
2020,Utah Jazz,Baylor,Royce O'Neale,193.04,102.511792,SF,71,2240,175,394,0.444,107,278,0.385,39,46,0.848,88,397,485,181,57,32,83,182,496,219,171,7,-88,-192,32,182.4,-248,-65.6,0.44416243654822335,0.38489208633093525,0.8478260869565217
2020,Charlotte Hornets,Kentucky,Malik Monk,190.5,90.7184,SG,42,878,173,399,0.434,85,212,0.401,59,72,0.819,14,87,101,87,19,4,55,47,490,226,127,13,-106,-126,46,32.15,-186,-153.85,0.43358395989974935,0.4009433962264151,0.8194444444444444
2020,Philadelphia 76ers,Kentucky,Tyrese Maxey,187.96,90.7184,SG,61,936,198,429,0.462,31,103,0.301,61,70,0.871,11,93,104,120,26,13,41,79,488,231,72,9,-66,-123,52,53.8,-137,-83.2,0.46153846153846156,0.30097087378640774,0.8714285714285714
2020,Philadelphia 76ers,,Dwight Howard,208.28,120.20188,C,69,1196,178,303,0.587,5,20,0.25,121,210,0.576,190,390,580,61,30,62,112,200,482,125,15,89,106,-30,32,187.75,108,295.75,0.5874587458745875,0.25,0.5761904761904761
2020,Toronto Raptors,UNLV,Khem Birch,205.74,105.68693600000002,C,67,1529,189,380,0.497,13,52,0.25,91,129,0.705,174,213,387,89,48,50,44,113,482,191,39,38,-4,-78,53,183.85,-29,154.85,0.49736842105263157,0.25,0.7054263565891473
2020,Toronto Raptors,UNLV,Khem Birch,205.74,105.68693600000002,C,67,1529,189,380,0.497,13,52,0.25,91,129,0.705,174,213,387,89,48,50,44,113,482,191,39,38,-4,-78,53,183.85,-29,154.85,0.49736842105263157,0.25,0.7054263565891473
2020,Toronto Raptors,UNLV,Khem Birch,205.74,105.68693600000002,C,67,1529,189,380,0.497,13,52,0.25,91,129,0.705,174,213,387,89,48,50,44,113,482,191,39,38,-4,-78,53,183.85,-29,154.85,0.49736842105263157,0.25,0.7054263565891473
2020,Toronto Raptors,UNLV,Khem Birch,205.74,105.68693600000002,C,67,1529,189,380,0.497,13,52,0.25,91,129,0.705,174,213,387,89,48,50,44,113,482,191,39,38,-4,-78,53,183.85,-29,154.85,0.49736842105263157,0.25,0.7054263565891473
2020,Toronto Raptors,UNLV,Khem Birch,205.74,105.68693600000002,C,67,1529,189,380,0.497,13,52,0.25,91,129,0.705,174,213,387,89,48,50,44,113,482,191,39,38,-4,-78,53,183.85,-29,154.85,0.49736842105263157,0.25,0.7054263565891473
2020,Toronto Raptors,UNLV,Khem Birch,205.74,105.68693600000002,C,67,1529,189,380,0.497,13,52,0.25,91,129,0.705,174,213,387,89,48,50,44,113,482,191,39,38,-4,-78,53,183.85,-29,154.85,0.49736842105263157,0.25,0.7054263565891473
2020,Toronto Raptors,UNLV,Khem Birch,205.74,105.68693600000002,C,67,1529,189,380,0.497,13,52,0.25,91,129,0.705,174,213,387,89,48,50,44,113,482,191,39,38,-4,-78,53,183.85,-29,154.85,0.49736842105263157,0.25,0.7054263565891473
2020,Toronto Raptors,UNLV,Khem Birch,205.74,105.68693600000002,C,67,1529,189,380,0.497,13,52,0.25,91,129,0.705,174,213,387,89,48,50,44,113,482,191,39,38,-4,-78,53,183.85,-29,154.85,0.49736842105263157,0.25,0.7054263565891473
2020,Toronto Raptors,UNLV,Khem Birch,205.74,105.68693600000002,C,67,1529,189,380,0.497,13,52,0.25,91,129,0.705,174,213,387,89,48,50,44,113,482,191,39,38,-4,-78,53,183.85,-29,154.85,0.49736842105263157,0.25,0.7054263565891473
2020,Houston Rockets,Indiana,Eric Gordon,190.5,97.52228,SG,27,789,159,367,0.433,69,210,0.329,94,114,0.825,8,50,58,71,14,13,51,44,481,208,141,20,-98,-216,74,20.05,-240,-219.95,0.4332425068119891,0.32857142857142857,0.8245614035087719
2020,Golden State Warriors,Old Dominion,Kent Bazemore,193.04,88.45044,SF,67,1334,176,392,0.449,75,184,0.408,54,78,0.692,26,203,229,108,69,33,82,158,481,216,109,24,-80,-102,30,92.85,-152,-59.150000000000006,0.4489795918367347,0.4076086956521739,0.6923076923076923
2020,Denver Nuggets,Iowa State,Monte Morris,187.96,83.007336,PG,47,1196,186,387,0.481,51,134,0.381,58,73,0.795,11,85,96,150,34,13,34,48,481,201,83,15,-30,-96,43,68.35,-83,-14.650000000000006,0.4806201550387597,0.3805970149253731,0.7945205479452054
2020,Indiana Pacers,UCLA,Aaron Holiday,182.88,83.91452,PG,66,1176,170,436,0.39,67,182,0.368,68,83,0.819,15,74,89,123,46,13,66,94,475,266,115,15,-192,-144,53,48.55,-283,-234.45,0.38990825688073394,0.36813186813186816,0.8192771084337349
2020,Memphis Grizzlies,Southern California,De'Anthony Melton,187.96,90.7184,PG,52,1045,172,393,0.438,87,211,0.412,41,51,0.804,30,131,161,132,60,31,66,85,472,221,124,10,-98,-111,31,89.0,-178,-89.0,0.43765903307888043,0.41232227488151657,0.803921568627451
2020,Los Angeles Clippers,Florida State,Terance Mann,195.58,97.52228,SG,67,1263,178,350,0.509,38,91,0.418,78,94,0.83,56,186,242,104,29,13,40,126,472,172,53,16,12,-45,62,95.2,29,124.2,0.5085714285714286,0.4175824175824176,0.8297872340425532
2020,Denver Nuggets,Alabama,JaMychal Green,203.2,102.965384,PF,58,1120,173,374,0.463,79,198,0.399,46,57,0.807,85,192,277,53,26,22,53,144,471,201,119,11,-56,-120,35,94.05,-141,-46.95,0.4625668449197861,0.398989898989899,0.8070175438596491
2020,Milwaukee Bucks,Notre Dame,Pat Connaughton,195.58,94.800728,SG,69,1575,168,387,0.434,101,272,0.371,31,40,0.775,63,269,332,81,49,23,33,99,468,219,171,9,-102,-210,22,133.55,-290,-156.45,0.43410852713178294,0.3713235294117647,0.775
2020,Los Angeles Clippers,,Serge Ibaka,208.28,106.59412,C,41,955,186,365,0.51,39,115,0.339,43,53,0.811,73,202,275,74,9,47,44,76,454,179,76,10,14,-111,33,107.7,-64,43.7,0.5095890410958904,0.3391304347826087,0.8113207547169812
2020,Charlotte Hornets,Indiana,Cody Zeller,210.82,108.86208,C,48,1005,181,324,0.559,4,28,0.143,85,119,0.714,119,209,328,86,27,17,51,121,451,143,24,34,76,-60,51,123.7,67,190.7,0.558641975308642,0.14285714285714285,0.7142857142857143
2020,New Orleans Pelicans,Texas-Austin,Jaxson Hayes,210.82,99.79024,C,60,964,175,280,0.625,6,14,0.429,93,120,0.775,92,165,257,35,25,38,39,101,449,105,8,27,140,-6,66,102.95,200,302.95,0.625,0.42857142857142855,0.775
2020,Golden State Warriors,Memphis,James Wiseman,213.36,108.86208,C,39,836,191,368,0.519,12,38,0.316,54,86,0.628,55,171,226,26,11,36,60,121,448,177,26,32,28,-42,22,64.2,8,72.2,0.5190217391304348,0.3157894736842105,0.627906976744186
2020,Golden State Warriors,Michigan State,Draymond Green,198.12,104.32616,PF,63,1982,170,380,0.447,34,126,0.27,70,88,0.795,55,393,448,558,105,52,188,194,444,210,92,18,-80,-174,52,240.05,-202,38.05000000000001,0.4473684210526316,0.2698412698412698,0.7954545454545454
2020,Memphis Grizzlies,Duke,Tyus Jones,182.88,88.904032,PG,70,1223,178,413,0.431,45,140,0.321,41,45,0.911,21,119,140,259,64,6,48,31,442,235,95,4,-114,-150,37,114.45,-227,-112.55,0.43099273607748184,0.32142857142857145,0.9111111111111111
2020,Detroit Pistons,North Carolina,Wayne Ellington,193.04,93.893544,SG,46,1012,149,338,0.441,116,275,0.422,28,35,0.8,12,73,85,67,18,9,33,59,442,189,159,7,-80,-129,21,35.05,-188,-152.95,0.4408284023668639,0.4218181818181818,0.8
2020,Houston Rockets,Texas-Austin,D.J. Augustin,180.34,83.007336,PG,57,1129,135,343,0.394,83,217,0.382,85,94,0.904,20,74,94,188,28,1,65,56,438,208,134,9,-146,-153,76,54.7,-223,-168.3,0.3935860058309038,0.3824884792626728,0.9042553191489362
2020,Houston Rockets,Texas-Austin,D.J. Augustin,180.34,83.007336,PG,57,1129,135,343,0.394,83,217,0.382,85,94,0.904,20,74,94,188,28,1,65,56,438,208,134,9,-146,-153,76,54.7,-223,-168.3,0.3935860058309038,0.3824884792626728,0.9042553191489362
2020,Houston Rockets,Texas-Austin,D.J. Augustin,180.34,83.007336,PG,57,1129,135,343,0.394,83,217,0.382,85,94,0.904,20,74,94,188,28,1,65,56,438,208,134,9,-146,-153,76,54.7,-223,-168.3,0.3935860058309038,0.3824884792626728,0.9042553191489362
2020,Houston Rockets,Texas-Austin,D.J. Augustin,180.34,83.007336,PG,57,1129,135,343,0.394,83,217,0.382,85,94,0.904,20,74,94,188,28,1,65,56,438,208,134,9,-146,-153,76,54.7,-223,-168.3,0.3935860058309038,0.3824884792626728,0.9042553191489362
2020,Houston Rockets,Texas-Austin,D.J. Augustin,180.34,83.007336,PG,57,1129,135,343,0.394,83,217,0.382,85,94,0.904,20,74,94,188,28,1,65,56,438,208,134,9,-146,-153,76,54.7,-223,-168.3,0.3935860058309038,0.3824884792626728,0.9042553191489362
2020,Houston Rockets,Texas-Austin,D.J. Augustin,180.34,83.007336,PG,57,1129,135,343,0.394,83,217,0.382,85,94,0.904,20,74,94,188,28,1,65,56,438,208,134,9,-146,-153,76,54.7,-223,-168.3,0.3935860058309038,0.3824884792626728,0.9042553191489362
2020,Houston Rockets,Texas-Austin,D.J. Augustin,180.34,83.007336,PG,57,1129,135,343,0.394,83,217,0.382,85,94,0.904,20,74,94,188,28,1,65,56,438,208,134,9,-146,-153,76,54.7,-223,-168.3,0.3935860058309038,0.3824884792626728,0.9042553191489362
2020,Houston Rockets,Texas-Austin,D.J. Augustin,180.34,83.007336,PG,57,1129,135,343,0.394,83,217,0.382,85,94,0.904,20,74,94,188,28,1,65,56,438,208,134,9,-146,-153,76,54.7,-223,-168.3,0.3935860058309038,0.3824884792626728,0.9042553191489362
2020,Houston Rockets,Texas-Austin,D.J. Augustin,180.34,83.007336,PG,57,1129,135,343,0.394,83,217,0.382,85,94,0.904,20,74,94,188,28,1,65,56,438,208,134,9,-146,-153,76,54.7,-223,-168.3,0.3935860058309038,0.3824884792626728,0.9042553191489362
2020,New Orleans Pelicans,Pittsburgh,Steven Adams,210.82,120.20188,C,58,1605,189,308,0.614,0,3,0.0,60,135,0.444,213,301,514,111,54,38,78,113,438,119,3,75,140,-9,-15,210.85,116,326.85,0.6136363636363636,0.0,0.4444444444444444
2020,New Orleans Pelicans,Villanova,Josh Hart,195.58,97.52228,SF,47,1350,151,344,0.439,63,193,0.326,69,89,0.775,53,324,377,109,38,12,49,111,434,193,130,20,-84,-201,49,129.7,-236,-106.30000000000001,0.438953488372093,0.32642487046632124,0.7752808988764045
2020,Houston Rockets,Southern California,Kevin Porter Jr.,193.04,92.079176,SG,26,836,156,367,0.425,50,161,0.311,69,94,0.734,20,79,99,164,19,8,91,61,431,211,111,25,-110,-183,44,35.7,-249,-213.3,0.4250681198910082,0.3105590062111801,0.7340425531914894
2020,Minnesota Timberwolves,Washington,Jaden McDaniels,205.74,83.91452,PF,63,1511,164,367,0.447,72,198,0.364,27,45,0.6,52,180,232,71,35,60,47,172,427,203,126,18,-78,-162,9,104.15,-231,-126.85,0.44686648501362397,0.36363636363636365,0.6
2020,Brooklyn Nets,Texas A&M,DeAndre Jordan,210.82,120.20188,C,57,1246,190,249,0.763,0,1,0.0,46,92,0.5,117,310,427,93,17,65,85,116,426,59,1,46,262,-3,0,151.95,259,410.95,0.7630522088353414,0.0,0.5
2020,Washington Wizards,Maryland,Alex Len,213.36,113.398,C,64,979,171,278,0.615,8,25,0.32,73,116,0.629,78,182,260,49,20,64,55,127,423,107,17,43,128,-27,30,104.9,131,235.9,0.6151079136690647,0.32,0.6293103448275862
2020,Washington Wizards,Maryland,Alex Len,213.36,113.398,C,64,979,171,278,0.615,8,25,0.32,73,116,0.629,78,182,260,49,20,64,55,127,423,107,17,43,128,-27,30,104.9,131,235.9,0.6151079136690647,0.32,0.6293103448275862
2020,Washington Wizards,Maryland,Alex Len,213.36,113.398,C,64,979,171,278,0.615,8,25,0.32,73,116,0.629,78,182,260,49,20,64,55,127,423,107,17,43,128,-27,30,104.9,131,235.9,0.6151079136690647,0.32,0.6293103448275862
2020,Washington Wizards,Maryland,Alex Len,213.36,113.398,C,64,979,171,278,0.615,8,25,0.32,73,116,0.629,78,182,260,49,20,64,55,127,423,107,17,43,128,-27,30,104.9,131,235.9,0.6151079136690647,0.32,0.6293103448275862
2020,Washington Wizards,Maryland,Alex Len,213.36,113.398,C,64,979,171,278,0.615,8,25,0.32,73,116,0.629,78,182,260,49,20,64,55,127,423,107,17,43,128,-27,30,104.9,131,235.9,0.6151079136690647,0.32,0.6293103448275862
2020,Washington Wizards,Maryland,Alex Len,213.36,113.398,C,64,979,171,278,0.615,8,25,0.32,73,116,0.629,78,182,260,49,20,64,55,127,423,107,17,43,128,-27,30,104.9,131,235.9,0.6151079136690647,0.32,0.6293103448275862
2020,Washington Wizards,Maryland,Alex Len,213.36,113.398,C,64,979,171,278,0.615,8,25,0.32,73,116,0.629,78,182,260,49,20,64,55,127,423,107,17,43,128,-27,30,104.9,131,235.9,0.6151079136690647,0.32,0.6293103448275862
2020,Washington Wizards,Maryland,Alex Len,213.36,113.398,C,64,979,171,278,0.615,8,25,0.32,73,116,0.629,78,182,260,49,20,64,55,127,423,107,17,43,128,-27,30,104.9,131,235.9,0.6151079136690647,0.32,0.6293103448275862
2020,Washington Wizards,Maryland,Alex Len,213.36,113.398,C,64,979,171,278,0.615,8,25,0.32,73,116,0.629,78,182,260,49,20,64,55,127,423,107,17,43,128,-27,30,104.9,131,235.9,0.6151079136690647,0.32,0.6293103448275862
2020,Chicago Bulls,Louisiana State,Garrett Temple,195.58,88.45044,SG,56,1528,158,381,0.415,67,200,0.335,40,50,0.8,29,131,160,124,43,30,58,126,423,223,133,10,-130,-198,30,79.45,-298,-218.55,0.4146981627296588,0.335,0.8
2020,Houston Rockets,Southern Methodist,Sterling Brown,195.58,99.336648,SG,51,1229,150,335,0.448,91,215,0.423,25,31,0.806,38,186,224,72,38,12,41,97,416,185,124,6,-70,-99,19,83.15,-150,-66.85,0.44776119402985076,0.4232558139534884,0.8064516129032258
2020,Dallas Mavericks,Michigan,Trey Burke,182.88,83.91452,PG,62,911,151,353,0.428,58,164,0.354,51,57,0.895,10,44,54,81,36,7,33,64,411,202,106,6,-102,-144,45,38.05,-201,-162.95,0.42776203966005666,0.35365853658536583,0.8947368421052632
2020,Boston Celtics,Texas-Austin,Tristan Thompson,205.74,115.212368,PF,54,1287,169,326,0.518,0,3,0.0,71,120,0.592,169,270,439,67,24,33,62,119,409,157,3,49,24,-9,22,160.3,37,197.3,0.5184049079754601,0.0,0.5916666666666667
2020,Los Angeles Lakers,Kansas,Markieff Morris,205.74,111.13004,PF,61,1200,153,378,0.405,65,209,0.311,36,50,0.72,48,218,266,73,22,19,54,105,407,225,144,14,-144,-237,22,85.0,-359,-274.0,0.40476190476190477,0.31100478468899523,0.72
2020,Los Angeles Lakers,Kansas,Ben McLemore,190.5,88.45044,SG,53,905,135,365,0.37,97,280,0.346,39,53,0.736,15,85,100,39,23,9,42,88,406,230,183,14,-190,-258,25,29.1,-423,-393.9,0.3698630136986301,0.3464285714285714,0.7358490566037735
2020,Los Angeles Lakers,Kansas,Ben McLemore,190.5,88.45044,SG,53,905,135,365,0.37,97,280,0.346,39,53,0.736,15,85,100,39,23,9,42,88,406,230,183,14,-190,-258,25,29.1,-423,-393.9,0.3698630136986301,0.3464285714285714,0.7358490566037735
2020,Los Angeles Lakers,Kansas,Ben McLemore,190.5,88.45044,SG,53,905,135,365,0.37,97,280,0.346,39,53,0.736,15,85,100,39,23,9,42,88,406,230,183,14,-190,-258,25,29.1,-423,-393.9,0.3698630136986301,0.3464285714285714,0.7358490566037735
2020,Los Angeles Lakers,Kansas,Ben McLemore,190.5,88.45044,SG,53,905,135,365,0.37,97,280,0.346,39,53,0.736,15,85,100,39,23,9,42,88,406,230,183,14,-190,-258,25,29.1,-423,-393.9,0.3698630136986301,0.3464285714285714,0.7358490566037735
2020,Los Angeles Lakers,Kansas,Ben McLemore,190.5,88.45044,SG,53,905,135,365,0.37,97,280,0.346,39,53,0.736,15,85,100,39,23,9,42,88,406,230,183,14,-190,-258,25,29.1,-423,-393.9,0.3698630136986301,0.3464285714285714,0.7358490566037735
2020,Los Angeles Lakers,Kansas,Ben McLemore,190.5,88.45044,SG,53,905,135,365,0.37,97,280,0.346,39,53,0.736,15,85,100,39,23,9,42,88,406,230,183,14,-190,-258,25,29.1,-423,-393.9,0.3698630136986301,0.3464285714285714,0.7358490566037735
2020,Los Angeles Lakers,Kansas,Ben McLemore,190.5,88.45044,SG,53,905,135,365,0.37,97,280,0.346,39,53,0.736,15,85,100,39,23,9,42,88,406,230,183,14,-190,-258,25,29.1,-423,-393.9,0.3698630136986301,0.3464285714285714,0.7358490566037735
2020,Los Angeles Lakers,Kansas,Ben McLemore,190.5,88.45044,SG,53,905,135,365,0.37,97,280,0.346,39,53,0.736,15,85,100,39,23,9,42,88,406,230,183,14,-190,-258,25,29.1,-423,-393.9,0.3698630136986301,0.3464285714285714,0.7358490566037735
2020,Los Angeles Lakers,Kansas,Ben McLemore,190.5,88.45044,SG,53,905,135,365,0.37,97,280,0.346,39,53,0.736,15,85,100,39,23,9,42,88,406,230,183,14,-190,-258,25,29.1,-423,-393.9,0.3698630136986301,0.3464285714285714,0.7358490566037735
2020,Chicago Bulls,Michigan State,Denzel Valentine,193.04,99.79024,SG,62,1036,155,416,0.373,80,242,0.331,16,17,0.941,24,173,197,105,30,7,42,70,406,261,162,1,-212,-246,15,75.5,-443,-367.5,0.37259615384615385,0.3305785123966942,0.9411764705882353
2020,Indiana Pacers,Xavier,Edmond Sumner,193.04,88.904032,SG,53,861,148,282,0.525,35,88,0.398,68,83,0.819,18,76,94,49,33,10,51,88,399,134,53,15,28,-54,53,31.85,27,58.85,0.524822695035461,0.3977272727272727,0.8192771084337349
2020,Boston Celtics,Florida,Al Horford,205.74,108.86208,C,28,782,162,360,0.45,56,152,0.368,18,22,0.818,29,159,188,94,25,26,29,48,398,198,96,4,-72,-120,14,86.35,-178,-91.65,0.45,0.3684210526315789,0.8181818181818182
2020,Portland Trail Blazers,UNLV,Derrick Jones Jr.,195.58,95.25432,SF,58,1318,147,304,0.484,43,136,0.316,59,91,0.648,77,128,205,47,37,54,32,127,396,157,93,32,-20,-150,27,105.4,-143,-37.599999999999994,0.48355263157894735,0.3161764705882353,0.6483516483516484
2020,Denver Nuggets,,Facundo Campazzo,177.8,88.45044,PG,65,1425,120,315,0.381,76,216,0.352,80,91,0.879,22,112,134,232,79,14,73,132,396,195,140,11,-150,-192,69,100.4,-273,-172.6,0.38095238095238093,0.35185185185185186,0.8791208791208791
2020,Detroit Pistons,Duke,Frank Jackson,190.5,92.98636,PG,40,738,134,293,0.457,61,150,0.407,61,75,0.813,15,71,86,36,15,1,34,53,390,159,89,14,-50,-84,47,22.6,-87,-64.4,0.45733788395904434,0.4066666666666667,0.8133333333333334
2020,Cleveland Cavaliers,Baylor,Taurean Prince,200.66,98.883056,PF,41,905,131,327,0.401,62,155,0.4,65,76,0.855,19,123,142,76,28,23,47,75,389,196,93,11,-130,-93,54,57.5,-169,-111.5,0.40061162079510704,0.4,0.8552631578947368
2020,Cleveland Cavaliers,Baylor,Taurean Prince,200.66,98.883056,PF,41,905,131,327,0.401,62,155,0.4,65,76,0.855,19,123,142,76,28,23,47,75,389,196,93,11,-130,-93,54,57.5,-169,-111.5,0.40061162079510704,0.4,0.8552631578947368
2020,Cleveland Cavaliers,Baylor,Taurean Prince,200.66,98.883056,PF,41,905,131,327,0.401,62,155,0.4,65,76,0.855,19,123,142,76,28,23,47,75,389,196,93,11,-130,-93,54,57.5,-169,-111.5,0.40061162079510704,0.4,0.8552631578947368
2020,Cleveland Cavaliers,Baylor,Taurean Prince,200.66,98.883056,PF,41,905,131,327,0.401,62,155,0.4,65,76,0.855,19,123,142,76,28,23,47,75,389,196,93,11,-130,-93,54,57.5,-169,-111.5,0.40061162079510704,0.4,0.8552631578947368
2020,Cleveland Cavaliers,Baylor,Taurean Prince,200.66,98.883056,PF,41,905,131,327,0.401,62,155,0.4,65,76,0.855,19,123,142,76,28,23,47,75,389,196,93,11,-130,-93,54,57.5,-169,-111.5,0.40061162079510704,0.4,0.8552631578947368
2020,Cleveland Cavaliers,Baylor,Taurean Prince,200.66,98.883056,PF,41,905,131,327,0.401,62,155,0.4,65,76,0.855,19,123,142,76,28,23,47,75,389,196,93,11,-130,-93,54,57.5,-169,-111.5,0.40061162079510704,0.4,0.8552631578947368
2020,Cleveland Cavaliers,Baylor,Taurean Prince,200.66,98.883056,PF,41,905,131,327,0.401,62,155,0.4,65,76,0.855,19,123,142,76,28,23,47,75,389,196,93,11,-130,-93,54,57.5,-169,-111.5,0.40061162079510704,0.4,0.8552631578947368
2020,Cleveland Cavaliers,Baylor,Taurean Prince,200.66,98.883056,PF,41,905,131,327,0.401,62,155,0.4,65,76,0.855,19,123,142,76,28,23,47,75,389,196,93,11,-130,-93,54,57.5,-169,-111.5,0.40061162079510704,0.4,0.8552631578947368
2020,Cleveland Cavaliers,Baylor,Taurean Prince,200.66,98.883056,PF,41,905,131,327,0.401,62,155,0.4,65,76,0.855,19,123,142,76,28,23,47,75,389,196,93,11,-130,-93,54,57.5,-169,-111.5,0.40061162079510704,0.4,0.8552631578947368
2020,Orlando Magic,Michigan State,Gary Harris,193.04,95.25432,SG,39,1080,138,345,0.4,48,141,0.34,64,78,0.821,21,58,79,78,28,11,37,71,388,207,93,14,-138,-135,50,41.95,-223,-181.05,0.4,0.3404255319148936,0.8205128205128205
2020,Orlando Magic,Michigan State,Gary Harris,193.04,95.25432,SG,39,1080,138,345,0.4,48,141,0.34,64,78,0.821,21,58,79,78,28,11,37,71,388,207,93,14,-138,-135,50,41.95,-223,-181.05,0.4,0.3404255319148936,0.8205128205128205
2020,Orlando Magic,Michigan State,Gary Harris,193.04,95.25432,SG,39,1080,138,345,0.4,48,141,0.34,64,78,0.821,21,58,79,78,28,11,37,71,388,207,93,14,-138,-135,50,41.95,-223,-181.05,0.4,0.3404255319148936,0.8205128205128205
2020,Orlando Magic,Michigan State,Gary Harris,193.04,95.25432,SG,39,1080,138,345,0.4,48,141,0.34,64,78,0.821,21,58,79,78,28,11,37,71,388,207,93,14,-138,-135,50,41.95,-223,-181.05,0.4,0.3404255319148936,0.8205128205128205
2020,Orlando Magic,Michigan State,Gary Harris,193.04,95.25432,SG,39,1080,138,345,0.4,48,141,0.34,64,78,0.821,21,58,79,78,28,11,37,71,388,207,93,14,-138,-135,50,41.95,-223,-181.05,0.4,0.3404255319148936,0.8205128205128205
2020,Orlando Magic,Michigan State,Gary Harris,193.04,95.25432,SG,39,1080,138,345,0.4,48,141,0.34,64,78,0.821,21,58,79,78,28,11,37,71,388,207,93,14,-138,-135,50,41.95,-223,-181.05,0.4,0.3404255319148936,0.8205128205128205
2020,Orlando Magic,Michigan State,Gary Harris,193.04,95.25432,SG,39,1080,138,345,0.4,48,141,0.34,64,78,0.821,21,58,79,78,28,11,37,71,388,207,93,14,-138,-135,50,41.95,-223,-181.05,0.4,0.3404255319148936,0.8205128205128205
2020,Orlando Magic,Michigan State,Gary Harris,193.04,95.25432,SG,39,1080,138,345,0.4,48,141,0.34,64,78,0.821,21,58,79,78,28,11,37,71,388,207,93,14,-138,-135,50,41.95,-223,-181.05,0.4,0.3404255319148936,0.8205128205128205
2020,Orlando Magic,Michigan State,Gary Harris,193.04,95.25432,SG,39,1080,138,345,0.4,48,141,0.34,64,78,0.821,21,58,79,78,28,11,37,71,388,207,93,14,-138,-135,50,41.95,-223,-181.05,0.4,0.3404255319148936,0.8205128205128205
2020,Denver Nuggets,South Carolina,PJ Dozier,198.12,92.98636,SG,50,1088,148,355,0.417,47,149,0.315,42,66,0.636,35,147,182,92,31,22,46,86,385,207,102,24,-118,-165,18,76.45,-265,-188.55,0.4169014084507042,0.31543624161073824,0.6363636363636364
2020,Golden State Warriors,Villanova,Eric Paschall,198.12,115.66596,PF,40,695,148,298,0.497,18,54,0.333,67,94,0.713,28,100,128,51,12,7,43,68,381,150,36,27,-4,-54,40,36.35,-18,18.35,0.4966442953020134,0.3333333333333333,0.7127659574468085
2020,Washington Wizards,Arkansas,Daniel Gafford,208.28,106.140528,C,54,791,154,225,0.684,0,0,0.0,72,108,0.667,94,137,231,29,26,75,41,98,380,71,0,36,166,0,36,113.6,202,315.6,0.6844444444444444,,0.6666666666666666
2020,Washington Wizards,Arkansas,Daniel Gafford,208.28,106.140528,C,54,791,154,225,0.684,0,0,0.0,72,108,0.667,94,137,231,29,26,75,41,98,380,71,0,36,166,0,36,113.6,202,315.6,0.6844444444444444,,0.6666666666666666
2020,Washington Wizards,Arkansas,Daniel Gafford,208.28,106.140528,C,54,791,154,225,0.684,0,0,0.0,72,108,0.667,94,137,231,29,26,75,41,98,380,71,0,36,166,0,36,113.6,202,315.6,0.6844444444444444,,0.6666666666666666
2020,Washington Wizards,Arkansas,Daniel Gafford,208.28,106.140528,C,54,791,154,225,0.684,0,0,0.0,72,108,0.667,94,137,231,29,26,75,41,98,380,71,0,36,166,0,36,113.6,202,315.6,0.6844444444444444,,0.6666666666666666
2020,Washington Wizards,Arkansas,Daniel Gafford,208.28,106.140528,C,54,791,154,225,0.684,0,0,0.0,72,108,0.667,94,137,231,29,26,75,41,98,380,71,0,36,166,0,36,113.6,202,315.6,0.6844444444444444,,0.6666666666666666
2020,Washington Wizards,Arkansas,Daniel Gafford,208.28,106.140528,C,54,791,154,225,0.684,0,0,0.0,72,108,0.667,94,137,231,29,26,75,41,98,380,71,0,36,166,0,36,113.6,202,315.6,0.6844444444444444,,0.6666666666666666
2020,Washington Wizards,Arkansas,Daniel Gafford,208.28,106.140528,C,54,791,154,225,0.684,0,0,0.0,72,108,0.667,94,137,231,29,26,75,41,98,380,71,0,36,166,0,36,113.6,202,315.6,0.6844444444444444,,0.6666666666666666
2020,Washington Wizards,Arkansas,Daniel Gafford,208.28,106.140528,C,54,791,154,225,0.684,0,0,0.0,72,108,0.667,94,137,231,29,26,75,41,98,380,71,0,36,166,0,36,113.6,202,315.6,0.6844444444444444,,0.6666666666666666
2020,Washington Wizards,Arkansas,Daniel Gafford,208.28,106.140528,C,54,791,154,225,0.684,0,0,0.0,72,108,0.667,94,137,231,29,26,75,41,98,380,71,0,36,166,0,36,113.6,202,315.6,0.6844444444444444,,0.6666666666666666
2020,Minnesota Timberwolves,Washington,Jaylen Nowell,193.04,91.171992,SG,42,759,142,335,0.424,50,150,0.333,45,55,0.818,19,76,95,62,22,12,28,72,379,193,100,10,-102,-150,35,43.4,-217,-173.6,0.42388059701492536,0.3333333333333333,0.8181818181818182
2020,Cleveland Cavaliers,Kansas State,Dean Wade,205.74,103.418976,PF,63,1212,134,311,0.431,78,213,0.366,30,39,0.769,38,177,215,74,35,21,30,78,376,177,135,9,-86,-171,21,90.85,-236,-145.15,0.43086816720257237,0.36619718309859156,0.7692307692307693
2020,Golden State Warriors,Drexel,Damion Lee,195.58,95.25432,SG,57,1079,128,274,0.467,77,194,0.397,40,44,0.909,22,158,180,73,38,8,30,89,373,146,117,4,-36,-120,36,72.3,-120,-47.7,0.46715328467153283,0.39690721649484534,0.9090909090909091
2020,Milwaukee Bucks,Wake Forest,Jeff Teague,190.5,88.45044,PG,55,950,123,284,0.433,36,82,0.439,89,105,0.848,15,73,88,132,34,12,64,56,371,161,46,16,-76,-30,73,46.95,-33,13.950000000000003,0.43309859154929575,0.43902439024390244,0.8476190476190476
2020,Milwaukee Bucks,Wake Forest,Jeff Teague,190.5,88.45044,PG,55,950,123,284,0.433,36,82,0.439,89,105,0.848,15,73,88,132,34,12,64,56,371,161,46,16,-76,-30,73,46.95,-33,13.950000000000003,0.43309859154929575,0.43902439024390244,0.8476190476190476
2020,Milwaukee Bucks,Wake Forest,Jeff Teague,190.5,88.45044,PG,55,950,123,284,0.433,36,82,0.439,89,105,0.848,15,73,88,132,34,12,64,56,371,161,46,16,-76,-30,73,46.95,-33,13.950000000000003,0.43309859154929575,0.43902439024390244,0.8476190476190476
2020,Milwaukee Bucks,Wake Forest,Jeff Teague,190.5,88.45044,PG,55,950,123,284,0.433,36,82,0.439,89,105,0.848,15,73,88,132,34,12,64,56,371,161,46,16,-76,-30,73,46.95,-33,13.950000000000003,0.43309859154929575,0.43902439024390244,0.8476190476190476
2020,Milwaukee Bucks,Wake Forest,Jeff Teague,190.5,88.45044,PG,55,950,123,284,0.433,36,82,0.439,89,105,0.848,15,73,88,132,34,12,64,56,371,161,46,16,-76,-30,73,46.95,-33,13.950000000000003,0.43309859154929575,0.43902439024390244,0.8476190476190476
2020,Milwaukee Bucks,Wake Forest,Jeff Teague,190.5,88.45044,PG,55,950,123,284,0.433,36,82,0.439,89,105,0.848,15,73,88,132,34,12,64,56,371,161,46,16,-76,-30,73,46.95,-33,13.950000000000003,0.43309859154929575,0.43902439024390244,0.8476190476190476
2020,Milwaukee Bucks,Wake Forest,Jeff Teague,190.5,88.45044,PG,55,950,123,284,0.433,36,82,0.439,89,105,0.848,15,73,88,132,34,12,64,56,371,161,46,16,-76,-30,73,46.95,-33,13.950000000000003,0.43309859154929575,0.43902439024390244,0.8476190476190476
2020,Milwaukee Bucks,Wake Forest,Jeff Teague,190.5,88.45044,PG,55,950,123,284,0.433,36,82,0.439,89,105,0.848,15,73,88,132,34,12,64,56,371,161,46,16,-76,-30,73,46.95,-33,13.950000000000003,0.43309859154929575,0.43902439024390244,0.8476190476190476
2020,Milwaukee Bucks,Wake Forest,Jeff Teague,190.5,88.45044,PG,55,950,123,284,0.433,36,82,0.439,89,105,0.848,15,73,88,132,34,12,64,56,371,161,46,16,-76,-30,73,46.95,-33,13.950000000000003,0.43309859154929575,0.43902439024390244,0.8476190476190476
2020,Los Angeles Lakers,Texas A&M,Alex Caruso,193.04,84.368112,PG,58,1216,133,305,0.436,55,137,0.401,49,76,0.645,31,139,170,160,64,15,76,108,370,172,82,27,-78,-81,22,86.35,-137,-50.650000000000006,0.4360655737704918,0.40145985401459855,0.6447368421052632
2020,Boston Celtics,UCLA,Moses Brown,218.44,111.13004,C,43,920,146,268,0.545,0,0,0.0,78,126,0.619,154,229,383,10,31,47,43,93,370,122,0,48,48,0,30,149.6,78,227.6,0.5447761194029851,,0.6190476190476191
2020,Utah Jazz,Georgia Tech,Derrick Favors,205.74,120.20188,C,68,1039,155,243,0.638,0,2,0.0,59,80,0.738,138,238,376,44,32,68,36,143,369,88,2,21,134,-6,38,164.35,166,330.35,0.6378600823045267,0.0,0.7375
2020,New Orleans Pelicans,Wake Forest,James Johnson,200.66,108.86208,PF,51,1043,146,327,0.446,31,120,0.258,45,76,0.592,32,145,177,98,42,42,55,120,368,181,89,31,-70,-174,14,85.25,-230,-144.75,0.44648318042813456,0.25833333333333336,0.5921052631578947
2020,New Orleans Pelicans,Wake Forest,James Johnson,200.66,108.86208,PF,51,1043,146,327,0.446,31,120,0.258,45,76,0.592,32,145,177,98,42,42,55,120,368,181,89,31,-70,-174,14,85.25,-230,-144.75,0.44648318042813456,0.25833333333333336,0.5921052631578947
2020,New Orleans Pelicans,Wake Forest,James Johnson,200.66,108.86208,PF,51,1043,146,327,0.446,31,120,0.258,45,76,0.592,32,145,177,98,42,42,55,120,368,181,89,31,-70,-174,14,85.25,-230,-144.75,0.44648318042813456,0.25833333333333336,0.5921052631578947
2020,New Orleans Pelicans,Wake Forest,James Johnson,200.66,108.86208,PF,51,1043,146,327,0.446,31,120,0.258,45,76,0.592,32,145,177,98,42,42,55,120,368,181,89,31,-70,-174,14,85.25,-230,-144.75,0.44648318042813456,0.25833333333333336,0.5921052631578947
2020,New Orleans Pelicans,Wake Forest,James Johnson,200.66,108.86208,PF,51,1043,146,327,0.446,31,120,0.258,45,76,0.592,32,145,177,98,42,42,55,120,368,181,89,31,-70,-174,14,85.25,-230,-144.75,0.44648318042813456,0.25833333333333336,0.5921052631578947
2020,New Orleans Pelicans,Wake Forest,James Johnson,200.66,108.86208,PF,51,1043,146,327,0.446,31,120,0.258,45,76,0.592,32,145,177,98,42,42,55,120,368,181,89,31,-70,-174,14,85.25,-230,-144.75,0.44648318042813456,0.25833333333333336,0.5921052631578947
2020,New Orleans Pelicans,Wake Forest,James Johnson,200.66,108.86208,PF,51,1043,146,327,0.446,31,120,0.258,45,76,0.592,32,145,177,98,42,42,55,120,368,181,89,31,-70,-174,14,85.25,-230,-144.75,0.44648318042813456,0.25833333333333336,0.5921052631578947
2020,New Orleans Pelicans,Wake Forest,James Johnson,200.66,108.86208,PF,51,1043,146,327,0.446,31,120,0.258,45,76,0.592,32,145,177,98,42,42,55,120,368,181,89,31,-70,-174,14,85.25,-230,-144.75,0.44648318042813456,0.25833333333333336,0.5921052631578947
2020,New Orleans Pelicans,Wake Forest,James Johnson,200.66,108.86208,PF,51,1043,146,327,0.446,31,120,0.258,45,76,0.592,32,145,177,98,42,42,55,120,368,181,89,31,-70,-174,14,85.25,-230,-144.75,0.44648318042813456,0.25833333333333336,0.5921052631578947
2020,Oklahoma City Thunder,,Aleksej Pokusevski,213.36,86.18248,PF,45,1090,139,408,0.341,58,207,0.28,31,42,0.738,30,182,212,97,20,42,99,58,367,269,149,11,-260,-273,20,63.35,-513,-449.65,0.34068627450980393,0.28019323671497587,0.7380952380952381
2020,Orlando Magic,Texas-Austin,Mo Bamba,213.36,104.779752,C,46,725,142,301,0.472,38,118,0.322,45,66,0.682,76,189,265,35,14,58,36,87,367,159,80,21,-34,-126,24,107.65,-136,-28.349999999999994,0.4717607973421927,0.3220338983050847,0.6818181818181818
2020,Los Angeles Clippers,Kentucky,DeMarcus Cousins,208.28,122.46984,C,41,713,130,305,0.426,47,135,0.348,59,81,0.728,53,210,263,76,34,24,64,107,366,175,88,22,-90,-123,37,89.65,-176,-86.35,0.4262295081967213,0.34814814814814815,0.7283950617283951
2020,Los Angeles Clippers,Kentucky,DeMarcus Cousins,208.28,122.46984,C,41,713,130,305,0.426,47,135,0.348,59,81,0.728,53,210,263,76,34,24,64,107,366,175,88,22,-90,-123,37,89.65,-176,-86.35,0.4262295081967213,0.34814814814814815,0.7283950617283951
2020,Los Angeles Clippers,Kentucky,DeMarcus Cousins,208.28,122.46984,C,41,713,130,305,0.426,47,135,0.348,59,81,0.728,53,210,263,76,34,24,64,107,366,175,88,22,-90,-123,37,89.65,-176,-86.35,0.4262295081967213,0.34814814814814815,0.7283950617283951
2020,Los Angeles Clippers,Kentucky,DeMarcus Cousins,208.28,122.46984,C,41,713,130,305,0.426,47,135,0.348,59,81,0.728,53,210,263,76,34,24,64,107,366,175,88,22,-90,-123,37,89.65,-176,-86.35,0.4262295081967213,0.34814814814814815,0.7283950617283951
2020,Los Angeles Clippers,Kentucky,DeMarcus Cousins,208.28,122.46984,C,41,713,130,305,0.426,47,135,0.348,59,81,0.728,53,210,263,76,34,24,64,107,366,175,88,22,-90,-123,37,89.65,-176,-86.35,0.4262295081967213,0.34814814814814815,0.7283950617283951
2020,Los Angeles Clippers,Kentucky,DeMarcus Cousins,208.28,122.46984,C,41,713,130,305,0.426,47,135,0.348,59,81,0.728,53,210,263,76,34,24,64,107,366,175,88,22,-90,-123,37,89.65,-176,-86.35,0.4262295081967213,0.34814814814814815,0.7283950617283951
2020,Los Angeles Clippers,Kentucky,DeMarcus Cousins,208.28,122.46984,C,41,713,130,305,0.426,47,135,0.348,59,81,0.728,53,210,263,76,34,24,64,107,366,175,88,22,-90,-123,37,89.65,-176,-86.35,0.4262295081967213,0.34814814814814815,0.7283950617283951
2020,Los Angeles Clippers,Kentucky,DeMarcus Cousins,208.28,122.46984,C,41,713,130,305,0.426,47,135,0.348,59,81,0.728,53,210,263,76,34,24,64,107,366,175,88,22,-90,-123,37,89.65,-176,-86.35,0.4262295081967213,0.34814814814814815,0.7283950617283951
2020,Los Angeles Clippers,Kentucky,DeMarcus Cousins,208.28,122.46984,C,41,713,130,305,0.426,47,135,0.348,59,81,0.728,53,210,263,76,34,24,64,107,366,175,88,22,-90,-123,37,89.65,-176,-86.35,0.4262295081967213,0.34814814814814815,0.7283950617283951
2020,Indiana Pacers,Connecticut,Jeremy Lamb,195.58,81.64656,SG,36,765,120,276,0.435,52,128,0.406,71,75,0.947,25,106,131,53,34,23,22,72,363,156,76,4,-72,-72,67,66.15,-77,-10.849999999999994,0.43478260869565216,0.40625,0.9466666666666667
2020,Washington Wizards,Lipscomb,Garrison Mathews,195.58,97.52228,SG,64,1038,97,237,0.409,76,198,0.384,84,95,0.884,16,71,87,26,29,7,10,106,354,140,122,11,-86,-138,73,39.95,-151,-111.05,0.4092827004219409,0.3838383838383838,0.8842105263157894
2020,Orlando Magic,,R.J. Hampton,193.04,79.3786,SG,51,888,136,313,0.435,27,87,0.31,55,82,0.671,29,150,179,87,21,10,53,61,354,177,60,27,-82,-99,28,59.7,-153,-93.3,0.43450479233226835,0.3103448275862069,0.6707317073170732
2020,Orlando Magic,,R.J. Hampton,193.04,79.3786,SG,51,888,136,313,0.435,27,87,0.31,55,82,0.671,29,150,179,87,21,10,53,61,354,177,60,27,-82,-99,28,59.7,-153,-93.3,0.43450479233226835,0.3103448275862069,0.6707317073170732
2020,Orlando Magic,,R.J. Hampton,193.04,79.3786,SG,51,888,136,313,0.435,27,87,0.31,55,82,0.671,29,150,179,87,21,10,53,61,354,177,60,27,-82,-99,28,59.7,-153,-93.3,0.43450479233226835,0.3103448275862069,0.6707317073170732
2020,Orlando Magic,,R.J. Hampton,193.04,79.3786,SG,51,888,136,313,0.435,27,87,0.31,55,82,0.671,29,150,179,87,21,10,53,61,354,177,60,27,-82,-99,28,59.7,-153,-93.3,0.43450479233226835,0.3103448275862069,0.6707317073170732
2020,Orlando Magic,,R.J. Hampton,193.04,79.3786,SG,51,888,136,313,0.435,27,87,0.31,55,82,0.671,29,150,179,87,21,10,53,61,354,177,60,27,-82,-99,28,59.7,-153,-93.3,0.43450479233226835,0.3103448275862069,0.6707317073170732
2020,Orlando Magic,,R.J. Hampton,193.04,79.3786,SG,51,888,136,313,0.435,27,87,0.31,55,82,0.671,29,150,179,87,21,10,53,61,354,177,60,27,-82,-99,28,59.7,-153,-93.3,0.43450479233226835,0.3103448275862069,0.6707317073170732
2020,Orlando Magic,,R.J. Hampton,193.04,79.3786,SG,51,888,136,313,0.435,27,87,0.31,55,82,0.671,29,150,179,87,21,10,53,61,354,177,60,27,-82,-99,28,59.7,-153,-93.3,0.43450479233226835,0.3103448275862069,0.6707317073170732
2020,Orlando Magic,,R.J. Hampton,193.04,79.3786,SG,51,888,136,313,0.435,27,87,0.31,55,82,0.671,29,150,179,87,21,10,53,61,354,177,60,27,-82,-99,28,59.7,-153,-93.3,0.43450479233226835,0.3103448275862069,0.6707317073170732
2020,Orlando Magic,,R.J. Hampton,193.04,79.3786,SG,51,888,136,313,0.435,27,87,0.31,55,82,0.671,29,150,179,87,21,10,53,61,354,177,60,27,-82,-99,28,59.7,-153,-93.3,0.43450479233226835,0.3103448275862069,0.6707317073170732
2020,Toronto Raptors,San Diego State,Malachi Flynn,185.42,79.3786,PG,47,928,127,340,0.374,54,168,0.321,45,56,0.804,10,106,116,137,38,7,43,68,353,213,114,11,-172,-180,34,63.35,-318,-254.65,0.3735294117647059,0.32142857142857145,0.8035714285714286
2020,Dallas Mavericks,,Maxi Kleber,208.28,108.86208,PF,50,1341,116,275,0.422,87,212,0.41,34,37,0.919,47,213,260,68,24,35,30,105,353,159,125,3,-86,-114,31,103.0,-169,-66.0,0.4218181818181818,0.41037735849056606,0.918918918918919
2020,Oklahoma City Thunder,Virginia,Ty Jerome,195.58,88.45044,SG,33,788,128,287,0.446,71,168,0.423,26,34,0.765,10,81,91,120,20,6,47,61,353,159,97,8,-62,-78,18,41.7,-122,-80.3,0.445993031358885,0.4226190476190476,0.7647058823529411
2020,Brooklyn Nets,University of Texas at Austin,LaMarcus Aldridge,210.82,113.398,C,26,674,140,296,0.473,31,80,0.388,41,47,0.872,19,99,118,49,11,29,27,47,352,156,49,6,-32,-54,35,50.65,-51,-0.3500000000000014,0.47297297297297297,0.3875,0.8723404255319149
2020,Brooklyn Nets,University of Texas at Austin,LaMarcus Aldridge,210.82,113.398,C,26,674,140,296,0.473,31,80,0.388,41,47,0.872,19,99,118,49,11,29,27,47,352,156,49,6,-32,-54,35,50.65,-51,-0.3500000000000014,0.47297297297297297,0.3875,0.8723404255319149
2020,Brooklyn Nets,University of Texas at Austin,LaMarcus Aldridge,210.82,113.398,C,26,674,140,296,0.473,31,80,0.388,41,47,0.872,19,99,118,49,11,29,27,47,352,156,49,6,-32,-54,35,50.65,-51,-0.3500000000000014,0.47297297297297297,0.3875,0.8723404255319149
2020,Brooklyn Nets,University of Texas at Austin,LaMarcus Aldridge,210.82,113.398,C,26,674,140,296,0.473,31,80,0.388,41,47,0.872,19,99,118,49,11,29,27,47,352,156,49,6,-32,-54,35,50.65,-51,-0.3500000000000014,0.47297297297297297,0.3875,0.8723404255319149
2020,Brooklyn Nets,University of Texas at Austin,LaMarcus Aldridge,210.82,113.398,C,26,674,140,296,0.473,31,80,0.388,41,47,0.872,19,99,118,49,11,29,27,47,352,156,49,6,-32,-54,35,50.65,-51,-0.3500000000000014,0.47297297297297297,0.3875,0.8723404255319149
2020,Brooklyn Nets,University of Texas at Austin,LaMarcus Aldridge,210.82,113.398,C,26,674,140,296,0.473,31,80,0.388,41,47,0.872,19,99,118,49,11,29,27,47,352,156,49,6,-32,-54,35,50.65,-51,-0.3500000000000014,0.47297297297297297,0.3875,0.8723404255319149
2020,Brooklyn Nets,University of Texas at Austin,LaMarcus Aldridge,210.82,113.398,C,26,674,140,296,0.473,31,80,0.388,41,47,0.872,19,99,118,49,11,29,27,47,352,156,49,6,-32,-54,35,50.65,-51,-0.3500000000000014,0.47297297297297297,0.3875,0.8723404255319149
2020,Brooklyn Nets,University of Texas at Austin,LaMarcus Aldridge,210.82,113.398,C,26,674,140,296,0.473,31,80,0.388,41,47,0.872,19,99,118,49,11,29,27,47,352,156,49,6,-32,-54,35,50.65,-51,-0.3500000000000014,0.47297297297297297,0.3875,0.8723404255319149
2020,Brooklyn Nets,University of Texas at Austin,LaMarcus Aldridge,210.82,113.398,C,26,674,140,296,0.473,31,80,0.388,41,47,0.872,19,99,118,49,11,29,27,47,352,156,49,6,-32,-54,35,50.65,-51,-0.3500000000000014,0.47297297297297297,0.3875,0.8723404255319149
2020,Orlando Magic,Auburn,Chuma Okeke,198.12,103.872568,PF,45,1133,135,324,0.417,49,141,0.348,30,40,0.75,42,139,181,101,48,22,38,48,349,189,92,10,-108,-129,20,94.6,-217,-122.4,0.4166666666666667,0.3475177304964539,0.75
2020,Charlotte Hornets,San Diego State,Jalen McDaniels,205.74,92.98636,SF,47,904,133,284,0.468,35,105,0.333,45,64,0.703,45,124,169,53,28,19,45,95,346,151,70,19,-36,-105,26,63.0,-115,-52.0,0.46830985915492956,0.3333333333333333,0.703125
2020,Orlando Magic,California State-Long Beach,James Ennis III,198.12,97.52228,SF,41,986,115,243,0.473,45,104,0.433,70,87,0.805,43,123,166,62,32,7,36,84,345,128,59,17,-26,-42,53,65.05,-15,50.05,0.4732510288065844,0.4326923076923077,0.8045977011494253
2020,Atlanta Hawks,Virginia,De'Andre Hunter,203.2,102.0582,SF,23,678,120,248,0.484,31,95,0.326,73,85,0.859,17,93,110,44,19,12,29,59,344,128,64,12,-16,-99,61,40.8,-54,-13.200000000000003,0.4838709677419355,0.3263157894736842,0.8588235294117647
2020,Minnesota Timberwolves,Kentucky,Jarred Vanderbilt,205.74,97.068688,PF,64,1139,143,236,0.606,1,5,0.2,57,102,0.559,118,250,368,76,64,46,53,123,344,93,4,45,100,-9,12,162.85,103,265.85,0.6059322033898306,0.2,0.5588235294117647
2020,New Orleans Pelicans,Alabama,Kira Lewis Jr.,185.42,77.11064,PG,54,904,130,337,0.386,40,120,0.333,43,51,0.843,12,59,71,124,38,10,34,88,343,207,80,8,-154,-120,35,54.35,-239,-184.65,0.3857566765578635,0.3333333333333333,0.8431372549019608
2020,Washington Wizards,,Deni Avdija,205.74,95.25432,SF,54,1257,130,312,0.417,53,168,0.315,29,45,0.644,22,240,262,63,32,15,33,140,342,182,115,16,-104,-186,13,86.75,-277,-190.25,0.4166666666666667,0.31547619047619047,0.6444444444444445
2020,Dallas Mavericks,Stanford,Dwight Powell,208.28,108.86208,C,58,966,120,194,0.619,5,21,0.238,97,124,0.782,80,154,234,63,36,30,40,135,342,74,16,27,92,-33,70,100.5,129,229.5,0.6185567010309279,0.23809523809523808,0.782258064516129
2020,San Antonio Spurs,Florida State,Devin Vassell,195.58,90.7184,SF,62,1056,123,303,0.406,52,150,0.347,43,51,0.843,24,150,174,56,43,18,22,88,341,180,98,8,-114,-138,35,78.6,-217,-138.4,0.40594059405940597,0.3466666666666667,0.8431372549019608
2020,Oklahoma City Thunder,Bucknell,Mike Muscala,208.28,108.86208,C,35,645,119,267,0.446,68,184,0.37,33,36,0.917,19,113,132,28,8,11,21,54,339,148,116,3,-58,-144,30,41.05,-172,-130.95,0.44569288389513106,0.3695652173913043,0.9166666666666666
2020,Denver Nuggets,Nevada-Reno,JaVale McGee,213.36,122.46984,C,46,678,144,282,0.511,5,24,0.208,44,67,0.657,77,162,239,39,19,54,60,121,337,138,19,23,12,-42,21,89.2,-9,80.2,0.5106382978723404,0.20833333333333334,0.6567164179104478
2020,Denver Nuggets,Nevada-Reno,JaVale McGee,213.36,122.46984,C,46,678,144,282,0.511,5,24,0.208,44,67,0.657,77,162,239,39,19,54,60,121,337,138,19,23,12,-42,21,89.2,-9,80.2,0.5106382978723404,0.20833333333333334,0.6567164179104478
2020,Denver Nuggets,Nevada-Reno,JaVale McGee,213.36,122.46984,C,46,678,144,282,0.511,5,24,0.208,44,67,0.657,77,162,239,39,19,54,60,121,337,138,19,23,12,-42,21,89.2,-9,80.2,0.5106382978723404,0.20833333333333334,0.6567164179104478
2020,Denver Nuggets,Nevada-Reno,JaVale McGee,213.36,122.46984,C,46,678,144,282,0.511,5,24,0.208,44,67,0.657,77,162,239,39,19,54,60,121,337,138,19,23,12,-42,21,89.2,-9,80.2,0.5106382978723404,0.20833333333333334,0.6567164179104478
2020,Denver Nuggets,Nevada-Reno,JaVale McGee,213.36,122.46984,C,46,678,144,282,0.511,5,24,0.208,44,67,0.657,77,162,239,39,19,54,60,121,337,138,19,23,12,-42,21,89.2,-9,80.2,0.5106382978723404,0.20833333333333334,0.6567164179104478
2020,Denver Nuggets,Nevada-Reno,JaVale McGee,213.36,122.46984,C,46,678,144,282,0.511,5,24,0.208,44,67,0.657,77,162,239,39,19,54,60,121,337,138,19,23,12,-42,21,89.2,-9,80.2,0.5106382978723404,0.20833333333333334,0.6567164179104478
2020,Denver Nuggets,Nevada-Reno,JaVale McGee,213.36,122.46984,C,46,678,144,282,0.511,5,24,0.208,44,67,0.657,77,162,239,39,19,54,60,121,337,138,19,23,12,-42,21,89.2,-9,80.2,0.5106382978723404,0.20833333333333334,0.6567164179104478
2020,Denver Nuggets,Nevada-Reno,JaVale McGee,213.36,122.46984,C,46,678,144,282,0.511,5,24,0.208,44,67,0.657,77,162,239,39,19,54,60,121,337,138,19,23,12,-42,21,89.2,-9,80.2,0.5106382978723404,0.20833333333333334,0.6567164179104478
2020,Denver Nuggets,Nevada-Reno,JaVale McGee,213.36,122.46984,C,46,678,144,282,0.511,5,24,0.208,44,67,0.657,77,162,239,39,19,54,60,121,337,138,19,23,12,-42,21,89.2,-9,80.2,0.5106382978723404,0.20833333333333334,0.6567164179104478
2020,Golden State Warriors,Kentucky,Mychal Mulder,190.5,83.46092800000001,PG,60,766,119,265,0.449,85,214,0.397,14,22,0.636,8,52,60,26,12,12,16,56,337,146,129,8,-54,-132,6,24.7,-180,-155.3,0.4490566037735849,0.397196261682243,0.6363636363636364
2020,Charlotte Hornets,Pittsburgh,Brad Wanamaker,190.5,95.25432,PG,61,1053,115,299,0.385,16,85,0.188,90,101,0.891,18,87,105,174,43,11,71,94,336,184,69,11,-138,-159,79,61.05,-218,-156.95,0.38461538461538464,0.18823529411764706,0.8910891089108911
2020,Charlotte Hornets,Pittsburgh,Brad Wanamaker,190.5,95.25432,PG,61,1053,115,299,0.385,16,85,0.188,90,101,0.891,18,87,105,174,43,11,71,94,336,184,69,11,-138,-159,79,61.05,-218,-156.95,0.38461538461538464,0.18823529411764706,0.8910891089108911
2020,Charlotte Hornets,Pittsburgh,Brad Wanamaker,190.5,95.25432,PG,61,1053,115,299,0.385,16,85,0.188,90,101,0.891,18,87,105,174,43,11,71,94,336,184,69,11,-138,-159,79,61.05,-218,-156.95,0.38461538461538464,0.18823529411764706,0.8910891089108911
2020,Charlotte Hornets,Pittsburgh,Brad Wanamaker,190.5,95.25432,PG,61,1053,115,299,0.385,16,85,0.188,90,101,0.891,18,87,105,174,43,11,71,94,336,184,69,11,-138,-159,79,61.05,-218,-156.95,0.38461538461538464,0.18823529411764706,0.8910891089108911
2020,Charlotte Hornets,Pittsburgh,Brad Wanamaker,190.5,95.25432,PG,61,1053,115,299,0.385,16,85,0.188,90,101,0.891,18,87,105,174,43,11,71,94,336,184,69,11,-138,-159,79,61.05,-218,-156.95,0.38461538461538464,0.18823529411764706,0.8910891089108911
2020,Charlotte Hornets,Pittsburgh,Brad Wanamaker,190.5,95.25432,PG,61,1053,115,299,0.385,16,85,0.188,90,101,0.891,18,87,105,174,43,11,71,94,336,184,69,11,-138,-159,79,61.05,-218,-156.95,0.38461538461538464,0.18823529411764706,0.8910891089108911
2020,Charlotte Hornets,Pittsburgh,Brad Wanamaker,190.5,95.25432,PG,61,1053,115,299,0.385,16,85,0.188,90,101,0.891,18,87,105,174,43,11,71,94,336,184,69,11,-138,-159,79,61.05,-218,-156.95,0.38461538461538464,0.18823529411764706,0.8910891089108911
2020,Charlotte Hornets,Pittsburgh,Brad Wanamaker,190.5,95.25432,PG,61,1053,115,299,0.385,16,85,0.188,90,101,0.891,18,87,105,174,43,11,71,94,336,184,69,11,-138,-159,79,61.05,-218,-156.95,0.38461538461538464,0.18823529411764706,0.8910891089108911
2020,Charlotte Hornets,Pittsburgh,Brad Wanamaker,190.5,95.25432,PG,61,1053,115,299,0.385,16,85,0.188,90,101,0.891,18,87,105,174,43,11,71,94,336,184,69,11,-138,-159,79,61.05,-218,-156.95,0.38461538461538464,0.18823529411764706,0.8910891089108911
2020,Charlotte Hornets,,Bismack Biyombo,203.2,115.66596,C,66,1349,142,242,0.587,0,1,0.0,47,105,0.448,137,210,347,81,17,74,71,141,331,100,1,58,84,-3,-11,144.2,70,214.2,0.5867768595041323,0.0,0.44761904761904764
2020,Dallas Mavericks,Duke,JJ Redick,190.5,90.7184,SG,44,723,106,267,0.397,66,178,0.371,49,52,0.942,4,60,64,51,11,3,36,50,327,161,112,3,-110,-138,46,16.25,-202,-185.75,0.3970037453183521,0.3707865168539326,0.9423076923076923
2020,Dallas Mavericks,Duke,JJ Redick,190.5,90.7184,SG,44,723,106,267,0.397,66,178,0.371,49,52,0.942,4,60,64,51,11,3,36,50,327,161,112,3,-110,-138,46,16.25,-202,-185.75,0.3970037453183521,0.3707865168539326,0.9423076923076923
2020,Dallas Mavericks,Duke,JJ Redick,190.5,90.7184,SG,44,723,106,267,0.397,66,178,0.371,49,52,0.942,4,60,64,51,11,3,36,50,327,161,112,3,-110,-138,46,16.25,-202,-185.75,0.3970037453183521,0.3707865168539326,0.9423076923076923
2020,Dallas Mavericks,Duke,JJ Redick,190.5,90.7184,SG,44,723,106,267,0.397,66,178,0.371,49,52,0.942,4,60,64,51,11,3,36,50,327,161,112,3,-110,-138,46,16.25,-202,-185.75,0.3970037453183521,0.3707865168539326,0.9423076923076923
2020,Dallas Mavericks,Duke,JJ Redick,190.5,90.7184,SG,44,723,106,267,0.397,66,178,0.371,49,52,0.942,4,60,64,51,11,3,36,50,327,161,112,3,-110,-138,46,16.25,-202,-185.75,0.3970037453183521,0.3707865168539326,0.9423076923076923
2020,Dallas Mavericks,Duke,JJ Redick,190.5,90.7184,SG,44,723,106,267,0.397,66,178,0.371,49,52,0.942,4,60,64,51,11,3,36,50,327,161,112,3,-110,-138,46,16.25,-202,-185.75,0.3970037453183521,0.3707865168539326,0.9423076923076923
2020,Dallas Mavericks,Duke,JJ Redick,190.5,90.7184,SG,44,723,106,267,0.397,66,178,0.371,49,52,0.942,4,60,64,51,11,3,36,50,327,161,112,3,-110,-138,46,16.25,-202,-185.75,0.3970037453183521,0.3707865168539326,0.9423076923076923
2020,Dallas Mavericks,Duke,JJ Redick,190.5,90.7184,SG,44,723,106,267,0.397,66,178,0.371,49,52,0.942,4,60,64,51,11,3,36,50,327,161,112,3,-110,-138,46,16.25,-202,-185.75,0.3970037453183521,0.3707865168539326,0.9423076923076923
2020,Dallas Mavericks,Duke,JJ Redick,190.5,90.7184,SG,44,723,106,267,0.397,66,178,0.371,49,52,0.942,4,60,64,51,11,3,36,50,327,161,112,3,-110,-138,46,16.25,-202,-185.75,0.3970037453183521,0.3707865168539326,0.9423076923076923
2020,Cleveland Cavaliers,Wyoming,Larry Nance Jr.,200.66,111.13004,PF,35,1091,128,272,0.471,41,114,0.36,30,49,0.612,54,181,235,107,61,17,55,72,327,144,73,19,-32,-96,11,106.9,-117,-10.099999999999994,0.47058823529411764,0.35964912280701755,0.6122448979591837
2020,Toronto Raptors,Washington State,Aron Baynes,208.28,117.93392,C,53,980,134,304,0.441,27,103,0.262,29,41,0.707,87,186,273,47,17,22,46,119,324,170,76,12,-72,-147,17,92.3,-202,-109.7,0.4407894736842105,0.2621359223300971,0.7073170731707317
2020,New York Knicks,Kentucky,Nerlens Noel,210.82,99.79024,C,64,1547,137,223,0.614,0,3,0.0,50,70,0.714,142,265,407,46,70,141,65,176,324,86,3,20,102,-9,30,212.95,123,335.95,0.6143497757847534,0.0,0.7142857142857143
2020,Atlanta Hawks,Arizona,Solomon Hill,198.12,102.511792,PF,71,1514,107,298,0.359,68,212,0.321,35,46,0.761,42,172,214,75,50,11,42,116,317,191,144,11,-168,-228,24,86.45,-372,-285.55,0.35906040268456374,0.32075471698113206,0.7608695652173914
2020,Minnesota Timberwolves,Georgia Tech,Josh Okogie,193.04,96.615096,SG,59,1197,102,254,0.402,29,108,0.269,83,108,0.769,63,93,156,63,54,28,43,123,316,152,79,25,-100,-150,58,83.85,-192,-108.15,0.4015748031496063,0.26851851851851855,0.7685185185185185
2020,Houston Rockets,Texas A&M,Danuel House Jr.,198.12,99.79024,SF,36,932,110,272,0.404,54,156,0.346,41,63,0.651,18,114,132,69,20,16,36,67,315,162,102,22,-104,-144,19,51.4,-229,-177.6,0.40441176470588236,0.34615384615384615,0.6507936507936508
2020,San Antonio Spurs,Oregon State,Drew Eubanks,205.74,111.13004,C,54,755,116,205,0.566,2,2,1.0,77,106,0.726,74,167,241,42,18,49,45,88,311,89,0,29,54,6,48,95.85,108,203.85,0.5658536585365853,1.0,0.7264150943396226
2020,Phoenix Suns,Wisconsin,Frank Kaminsky,213.36,108.86208,C,47,715,121,257,0.471,31,85,0.365,37,60,0.617,36,152,188,79,14,17,22,70,310,136,54,23,-30,-69,14,76.75,-85,-8.25,0.4708171206225681,0.36470588235294116,0.6166666666666667
2020,Orlando Magic,Michigan,Moritz Wagner,210.82,111.13004,C,45,722,104,229,0.454,31,91,0.341,71,87,0.816,27,119,146,50,26,18,43,108,310,125,60,16,-42,-87,55,50.85,-74,-23.15,0.45414847161572053,0.34065934065934067,0.8160919540229885
2020,Orlando Magic,Michigan,Moritz Wagner,210.82,111.13004,C,45,722,104,229,0.454,31,91,0.341,71,87,0.816,27,119,146,50,26,18,43,108,310,125,60,16,-42,-87,55,50.85,-74,-23.15,0.45414847161572053,0.34065934065934067,0.8160919540229885
2020,Orlando Magic,Michigan,Moritz Wagner,210.82,111.13004,C,45,722,104,229,0.454,31,91,0.341,71,87,0.816,27,119,146,50,26,18,43,108,310,125,60,16,-42,-87,55,50.85,-74,-23.15,0.45414847161572053,0.34065934065934067,0.8160919540229885
2020,Orlando Magic,Michigan,Moritz Wagner,210.82,111.13004,C,45,722,104,229,0.454,31,91,0.341,71,87,0.816,27,119,146,50,26,18,43,108,310,125,60,16,-42,-87,55,50.85,-74,-23.15,0.45414847161572053,0.34065934065934067,0.8160919540229885
2020,Orlando Magic,Michigan,Moritz Wagner,210.82,111.13004,C,45,722,104,229,0.454,31,91,0.341,71,87,0.816,27,119,146,50,26,18,43,108,310,125,60,16,-42,-87,55,50.85,-74,-23.15,0.45414847161572053,0.34065934065934067,0.8160919540229885
2020,Orlando Magic,Michigan,Moritz Wagner,210.82,111.13004,C,45,722,104,229,0.454,31,91,0.341,71,87,0.816,27,119,146,50,26,18,43,108,310,125,60,16,-42,-87,55,50.85,-74,-23.15,0.45414847161572053,0.34065934065934067,0.8160919540229885
2020,Orlando Magic,Michigan,Moritz Wagner,210.82,111.13004,C,45,722,104,229,0.454,31,91,0.341,71,87,0.816,27,119,146,50,26,18,43,108,310,125,60,16,-42,-87,55,50.85,-74,-23.15,0.45414847161572053,0.34065934065934067,0.8160919540229885
2020,Orlando Magic,Michigan,Moritz Wagner,210.82,111.13004,C,45,722,104,229,0.454,31,91,0.341,71,87,0.816,27,119,146,50,26,18,43,108,310,125,60,16,-42,-87,55,50.85,-74,-23.15,0.45414847161572053,0.34065934065934067,0.8160919540229885
2020,Orlando Magic,Michigan,Moritz Wagner,210.82,111.13004,C,45,722,104,229,0.454,31,91,0.341,71,87,0.816,27,119,146,50,26,18,43,108,310,125,60,16,-42,-87,55,50.85,-74,-23.15,0.45414847161572053,0.34065934065934067,0.8160919540229885
2020,Orlando Magic,Michigan,Moritz Wagner,210.82,111.13004,C,45,722,104,229,0.454,31,91,0.341,71,87,0.816,27,119,146,50,26,18,43,108,310,125,60,16,-42,-87,55,50.85,-74,-23.15,0.45414847161572053,0.34065934065934067,0.8160919540229885
2020,Orlando Magic,Michigan,Moritz Wagner,210.82,111.13004,C,45,722,104,229,0.454,31,91,0.341,71,87,0.816,27,119,146,50,26,18,43,108,310,125,60,16,-42,-87,55,50.85,-74,-23.15,0.45414847161572053,0.34065934065934067,0.8160919540229885
2020,Orlando Magic,Michigan,Moritz Wagner,210.82,111.13004,C,45,722,104,229,0.454,31,91,0.341,71,87,0.816,27,119,146,50,26,18,43,108,310,125,60,16,-42,-87,55,50.85,-74,-23.15,0.45414847161572053,0.34065934065934067,0.8160919540229885
2020,Orlando Magic,Michigan,Moritz Wagner,210.82,111.13004,C,45,722,104,229,0.454,31,91,0.341,71,87,0.816,27,119,146,50,26,18,43,108,310,125,60,16,-42,-87,55,50.85,-74,-23.15,0.45414847161572053,0.34065934065934067,0.8160919540229885
2020,Orlando Magic,Michigan,Moritz Wagner,210.82,111.13004,C,45,722,104,229,0.454,31,91,0.341,71,87,0.816,27,119,146,50,26,18,43,108,310,125,60,16,-42,-87,55,50.85,-74,-23.15,0.45414847161572053,0.34065934065934067,0.8160919540229885
2020,Orlando Magic,Michigan,Moritz Wagner,210.82,111.13004,C,45,722,104,229,0.454,31,91,0.341,71,87,0.816,27,119,146,50,26,18,43,108,310,125,60,16,-42,-87,55,50.85,-74,-23.15,0.45414847161572053,0.34065934065934067,0.8160919540229885
2020,Orlando Magic,Michigan,Moritz Wagner,210.82,111.13004,C,45,722,104,229,0.454,31,91,0.341,71,87,0.816,27,119,146,50,26,18,43,108,310,125,60,16,-42,-87,55,50.85,-74,-23.15,0.45414847161572053,0.34065934065934067,0.8160919540229885
2020,Cleveland Cavaliers,Houston,Damyean Dotson,195.58,95.25432,SG,46,907,119,293,0.406,46,159,0.289,24,36,0.667,5,88,93,91,16,4,42,42,308,174,113,12,-110,-201,12,34.15,-299,-264.85,0.4061433447098976,0.2893081761006289,0.6666666666666666
2020,Cleveland Cavaliers,UCLA,Kevin Love,203.2,113.851592,PF,25,622,103,252,0.409,57,156,0.365,42,51,0.824,17,169,186,63,16,2,38,26,305,149,99,9,-92,-126,33,55.2,-185,-129.8,0.4087301587301587,0.36538461538461536,0.8235294117647058
2020,Miami Heat,Memphis,Precious Achiuwa,203.2,102.0582,PF,61,737,124,228,0.544,0,1,0.0,56,110,0.509,73,135,208,29,20,28,43,91,304,104,1,54,40,-3,2,75.45,39,114.45,0.543859649122807,0.0,0.509090909090909
2020,Golden State Warriors,Marquette,Juan Toscano-Anderson,198.12,94.800728,SG,53,1108,121,209,0.579,37,92,0.402,22,31,0.71,29,206,235,150,41,26,61,111,301,88,55,9,66,-54,13,100.95,25,125.95,0.5789473684210527,0.40217391304347827,0.7096774193548387
2020,Oklahoma City Thunder,North Carolina,Tony Bradley,208.28,112.490816,C,42,684,131,197,0.665,0,3,0.0,38,55,0.691,85,154,239,37,15,30,33,61,300,66,3,17,130,-9,21,93.2,142,235.2,0.6649746192893401,0.0,0.6909090909090909
2020,Oklahoma City Thunder,North Carolina,Tony Bradley,208.28,112.490816,C,42,684,131,197,0.665,0,3,0.0,38,55,0.691,85,154,239,37,15,30,33,61,300,66,3,17,130,-9,21,93.2,142,235.2,0.6649746192893401,0.0,0.6909090909090909
2020,Oklahoma City Thunder,North Carolina,Tony Bradley,208.28,112.490816,C,42,684,131,197,0.665,0,3,0.0,38,55,0.691,85,154,239,37,15,30,33,61,300,66,3,17,130,-9,21,93.2,142,235.2,0.6649746192893401,0.0,0.6909090909090909
2020,Oklahoma City Thunder,North Carolina,Tony Bradley,208.28,112.490816,C,42,684,131,197,0.665,0,3,0.0,38,55,0.691,85,154,239,37,15,30,33,61,300,66,3,17,130,-9,21,93.2,142,235.2,0.6649746192893401,0.0,0.6909090909090909
2020,Oklahoma City Thunder,North Carolina,Tony Bradley,208.28,112.490816,C,42,684,131,197,0.665,0,3,0.0,38,55,0.691,85,154,239,37,15,30,33,61,300,66,3,17,130,-9,21,93.2,142,235.2,0.6649746192893401,0.0,0.6909090909090909
2020,Oklahoma City Thunder,North Carolina,Tony Bradley,208.28,112.490816,C,42,684,131,197,0.665,0,3,0.0,38,55,0.691,85,154,239,37,15,30,33,61,300,66,3,17,130,-9,21,93.2,142,235.2,0.6649746192893401,0.0,0.6909090909090909
2020,Oklahoma City Thunder,North Carolina,Tony Bradley,208.28,112.490816,C,42,684,131,197,0.665,0,3,0.0,38,55,0.691,85,154,239,37,15,30,33,61,300,66,3,17,130,-9,21,93.2,142,235.2,0.6649746192893401,0.0,0.6909090909090909
2020,Oklahoma City Thunder,North Carolina,Tony Bradley,208.28,112.490816,C,42,684,131,197,0.665,0,3,0.0,38,55,0.691,85,154,239,37,15,30,33,61,300,66,3,17,130,-9,21,93.2,142,235.2,0.6649746192893401,0.0,0.6909090909090909
2020,Oklahoma City Thunder,North Carolina,Tony Bradley,208.28,112.490816,C,42,684,131,197,0.665,0,3,0.0,38,55,0.691,85,154,239,37,15,30,33,61,300,66,3,17,130,-9,21,93.2,142,235.2,0.6649746192893401,0.0,0.6909090909090909
2020,Washington Wizards,Wake Forest,Ish Smith,182.88,79.3786,PG,44,924,129,297,0.434,18,49,0.367,19,33,0.576,22,128,150,172,32,13,41,62,295,168,31,14,-78,-39,5,84.9,-112,-27.099999999999994,0.43434343434343436,0.3673469387755102,0.5757575757575758
2020,Boston Celtics,Tennessee,Grant Williams,198.12,107.047712,PF,63,1138,108,247,0.437,48,129,0.372,30,51,0.588,48,130,178,64,32,24,56,161,294,139,81,21,-62,-99,9,64.45,-152,-87.55,0.43724696356275305,0.37209302325581395,0.5882352941176471
2020,Toronto Raptors,St. Joseph's (PA),DeAndre' Bembry,195.58,95.25432,SF,51,972,117,228,0.513,14,53,0.264,45,66,0.682,33,113,146,107,53,18,71,87,293,111,39,21,12,-75,24,67.15,-39,28.150000000000006,0.5131578947368421,0.2641509433962264,0.6818181818181818
2020,Sacramento Kings,Marshall,Hassan Whiteside,213.36,120.20188,C,36,546,126,224,0.563,0,1,0.0,41,79,0.519,61,154,215,20,9,46,40,73,293,98,1,38,56,-3,3,77.85,56,133.85,0.5625,0.0,0.5189873417721519
2020,Atlanta Hawks,Duke,Cam Reddish,203.2,98.883056,SF,26,750,96,263,0.365,33,126,0.262,67,82,0.817,22,82,104,35,33,9,34,68,292,167,93,15,-142,-180,52,40.85,-270,-229.15,0.3650190114068441,0.2619047619047619,0.8170731707317073
2020,Denver Nuggets,Duke,Austin Rivers,193.04,90.7184,SG,36,845,104,245,0.424,55,149,0.369,22,31,0.71,8,74,82,81,30,2,36,64,285,141,94,9,-74,-117,13,37.55,-178,-140.45,0.42448979591836733,0.3691275167785235,0.7096774193548387
2020,Denver Nuggets,Duke,Austin Rivers,193.04,90.7184,SG,36,845,104,245,0.424,55,149,0.369,22,31,0.71,8,74,82,81,30,2,36,64,285,141,94,9,-74,-117,13,37.55,-178,-140.45,0.42448979591836733,0.3691275167785235,0.7096774193548387
2020,Denver Nuggets,Duke,Austin Rivers,193.04,90.7184,SG,36,845,104,245,0.424,55,149,0.369,22,31,0.71,8,74,82,81,30,2,36,64,285,141,94,9,-74,-117,13,37.55,-178,-140.45,0.42448979591836733,0.3691275167785235,0.7096774193548387
2020,Denver Nuggets,Duke,Austin Rivers,193.04,90.7184,SG,36,845,104,245,0.424,55,149,0.369,22,31,0.71,8,74,82,81,30,2,36,64,285,141,94,9,-74,-117,13,37.55,-178,-140.45,0.42448979591836733,0.3691275167785235,0.7096774193548387
2020,Denver Nuggets,Duke,Austin Rivers,193.04,90.7184,SG,36,845,104,245,0.424,55,149,0.369,22,31,0.71,8,74,82,81,30,2,36,64,285,141,94,9,-74,-117,13,37.55,-178,-140.45,0.42448979591836733,0.3691275167785235,0.7096774193548387
2020,Denver Nuggets,Duke,Austin Rivers,193.04,90.7184,SG,36,845,104,245,0.424,55,149,0.369,22,31,0.71,8,74,82,81,30,2,36,64,285,141,94,9,-74,-117,13,37.55,-178,-140.45,0.42448979591836733,0.3691275167785235,0.7096774193548387
2020,Denver Nuggets,Duke,Austin Rivers,193.04,90.7184,SG,36,845,104,245,0.424,55,149,0.369,22,31,0.71,8,74,82,81,30,2,36,64,285,141,94,9,-74,-117,13,37.55,-178,-140.45,0.42448979591836733,0.3691275167785235,0.7096774193548387
2020,Denver Nuggets,Duke,Austin Rivers,193.04,90.7184,SG,36,845,104,245,0.424,55,149,0.369,22,31,0.71,8,74,82,81,30,2,36,64,285,141,94,9,-74,-117,13,37.55,-178,-140.45,0.42448979591836733,0.3691275167785235,0.7096774193548387
2020,Denver Nuggets,Duke,Austin Rivers,193.04,90.7184,SG,36,845,104,245,0.424,55,149,0.369,22,31,0.71,8,74,82,81,30,2,36,64,285,141,94,9,-74,-117,13,37.55,-178,-140.45,0.42448979591836733,0.3691275167785235,0.7096774193548387
2020,Detroit Pistons,,Sekou Doumbouya,203.2,104.32616,PF,56,869,107,282,0.379,26,115,0.226,45,64,0.703,39,104,143,47,24,9,44,94,285,175,89,19,-136,-189,26,47.05,-299,-251.95,0.37943262411347517,0.22608695652173913,0.703125
2020,Miami Heat,UCLA,Trevor Ariza,203.2,97.52228,SF,30,841,99,241,0.411,50,143,0.35,34,44,0.773,27,117,144,55,31,18,21,55,282,142,93,10,-86,-129,24,67.75,-191,-123.25,0.4107883817427386,0.34965034965034963,0.7727272727272727
2020,Dallas Mavericks,Kentucky,Willie Cauley-Stein,213.36,108.86208,C,53,906,115,182,0.632,1,11,0.091,49,78,0.628,66,170,236,35,21,43,29,129,280,67,10,29,96,-27,20,95.3,89,184.3,0.6318681318681318,0.09090909090909091,0.6282051282051282
2020,Los Angeles Lakers,Marquette,Wesley Matthews,193.04,99.79024,SG,58,1130,89,252,0.353,66,197,0.335,35,41,0.854,20,73,93,54,38,17,26,80,279,163,131,6,-148,-195,29,52.25,-314,-261.75,0.3531746031746032,0.3350253807106599,0.8536585365853658
2020,Los Angeles Clippers,Arkansas,Patrick Beverley,185.42,81.64656,PG,37,833,93,220,0.423,56,141,0.397,36,45,0.8,29,90,119,76,29,28,34,108,278,127,85,9,-68,-87,27,62.1,-128,-65.9,0.42272727272727273,0.3971631205673759,0.8
2020,Houston Rockets,Cal Poly,David Nwaba,195.58,99.336648,SF,30,679,106,218,0.486,17,63,0.27,47,68,0.691,40,78,118,31,30,21,17,60,276,112,46,21,-12,-87,26,61.25,-73,-11.75,0.48623853211009177,0.2698412698412698,0.6911764705882353
2020,Miami Heat,Arizona,Andre Iguodala,198.12,97.52228,SF,63,1339,95,248,0.383,60,182,0.33,25,38,0.658,38,183,221,142,57,35,67,90,275,153,122,13,-116,-186,12,108.25,-290,-181.75,0.38306451612903225,0.32967032967032966,0.6578947368421053
2020,Orlando Magic,Syracuse,Michael Carter-Williams,195.58,86.18248,SG,31,800,105,270,0.389,15,61,0.246,49,80,0.613,39,100,139,129,25,17,69,81,274,165,46,31,-120,-93,18,59.2,-195,-135.8,0.3888888888888889,0.2459016393442623,0.6125
2020,Phoenix Suns,South Carolina Upstate,Torrey Craig,200.66,100.243832,SF,50,803,109,227,0.48,39,106,0.368,17,22,0.773,57,140,197,49,28,27,25,83,274,118,67,5,-18,-84,12,86.6,-90,-3.4000000000000057,0.4801762114537445,0.36792452830188677,0.7727272727272727
2020,Phoenix Suns,South Carolina Upstate,Torrey Craig,200.66,100.243832,SF,50,803,109,227,0.48,39,106,0.368,17,22,0.773,57,140,197,49,28,27,25,83,274,118,67,5,-18,-84,12,86.6,-90,-3.4000000000000057,0.4801762114537445,0.36792452830188677,0.7727272727272727
2020,Phoenix Suns,South Carolina Upstate,Torrey Craig,200.66,100.243832,SF,50,803,109,227,0.48,39,106,0.368,17,22,0.773,57,140,197,49,28,27,25,83,274,118,67,5,-18,-84,12,86.6,-90,-3.4000000000000057,0.4801762114537445,0.36792452830188677,0.7727272727272727
2020,Phoenix Suns,South Carolina Upstate,Torrey Craig,200.66,100.243832,SF,50,803,109,227,0.48,39,106,0.368,17,22,0.773,57,140,197,49,28,27,25,83,274,118,67,5,-18,-84,12,86.6,-90,-3.4000000000000057,0.4801762114537445,0.36792452830188677,0.7727272727272727
2020,Phoenix Suns,South Carolina Upstate,Torrey Craig,200.66,100.243832,SF,50,803,109,227,0.48,39,106,0.368,17,22,0.773,57,140,197,49,28,27,25,83,274,118,67,5,-18,-84,12,86.6,-90,-3.4000000000000057,0.4801762114537445,0.36792452830188677,0.7727272727272727
2020,Phoenix Suns,South Carolina Upstate,Torrey Craig,200.66,100.243832,SF,50,803,109,227,0.48,39,106,0.368,17,22,0.773,57,140,197,49,28,27,25,83,274,118,67,5,-18,-84,12,86.6,-90,-3.4000000000000057,0.4801762114537445,0.36792452830188677,0.7727272727272727
2020,Phoenix Suns,South Carolina Upstate,Torrey Craig,200.66,100.243832,SF,50,803,109,227,0.48,39,106,0.368,17,22,0.773,57,140,197,49,28,27,25,83,274,118,67,5,-18,-84,12,86.6,-90,-3.4000000000000057,0.4801762114537445,0.36792452830188677,0.7727272727272727
2020,Phoenix Suns,South Carolina Upstate,Torrey Craig,200.66,100.243832,SF,50,803,109,227,0.48,39,106,0.368,17,22,0.773,57,140,197,49,28,27,25,83,274,118,67,5,-18,-84,12,86.6,-90,-3.4000000000000057,0.4801762114537445,0.36792452830188677,0.7727272727272727
2020,Phoenix Suns,South Carolina Upstate,Torrey Craig,200.66,100.243832,SF,50,803,109,227,0.48,39,106,0.368,17,22,0.773,57,140,197,49,28,27,25,83,274,118,67,5,-18,-84,12,86.6,-90,-3.4000000000000057,0.4801762114537445,0.36792452830188677,0.7727272727272727
2020,Orlando Magic,Georgetown,Otto Porter Jr.,203.2,89.811216,SF,28,607,98,227,0.432,39,104,0.375,36,42,0.857,28,124,152,55,16,4,25,41,271,129,65,6,-62,-78,30,54.2,-110,-55.8,0.43171806167400884,0.375,0.8571428571428571
2020,Orlando Magic,Georgetown,Otto Porter Jr.,203.2,89.811216,SF,28,607,98,227,0.432,39,104,0.375,36,42,0.857,28,124,152,55,16,4,25,41,271,129,65,6,-62,-78,30,54.2,-110,-55.8,0.43171806167400884,0.375,0.8571428571428571
2020,Orlando Magic,Georgetown,Otto Porter Jr.,203.2,89.811216,SF,28,607,98,227,0.432,39,104,0.375,36,42,0.857,28,124,152,55,16,4,25,41,271,129,65,6,-62,-78,30,54.2,-110,-55.8,0.43171806167400884,0.375,0.8571428571428571
2020,Orlando Magic,Georgetown,Otto Porter Jr.,203.2,89.811216,SF,28,607,98,227,0.432,39,104,0.375,36,42,0.857,28,124,152,55,16,4,25,41,271,129,65,6,-62,-78,30,54.2,-110,-55.8,0.43171806167400884,0.375,0.8571428571428571
2020,Orlando Magic,Georgetown,Otto Porter Jr.,203.2,89.811216,SF,28,607,98,227,0.432,39,104,0.375,36,42,0.857,28,124,152,55,16,4,25,41,271,129,65,6,-62,-78,30,54.2,-110,-55.8,0.43171806167400884,0.375,0.8571428571428571
2020,Orlando Magic,Georgetown,Otto Porter Jr.,203.2,89.811216,SF,28,607,98,227,0.432,39,104,0.375,36,42,0.857,28,124,152,55,16,4,25,41,271,129,65,6,-62,-78,30,54.2,-110,-55.8,0.43171806167400884,0.375,0.8571428571428571
2020,Orlando Magic,Georgetown,Otto Porter Jr.,203.2,89.811216,PF,28,607,98,227,0.432,39,104,0.375,36,42,0.857,28,124,152,55,16,4,25,41,271,129,65,6,-62,-78,30,54.2,-110,-55.8,0.43171806167400884,0.375,0.8571428571428571
2020,Orlando Magic,Georgetown,Otto Porter Jr.,203.2,89.811216,PF,28,607,98,227,0.432,39,104,0.375,36,42,0.857,28,124,152,55,16,4,25,41,271,129,65,6,-62,-78,30,54.2,-110,-55.8,0.43171806167400884,0.375,0.8571428571428571
2020,Orlando Magic,Georgetown,Otto Porter Jr.,203.2,89.811216,PF,28,607,98,227,0.432,39,104,0.375,36,42,0.857,28,124,152,55,16,4,25,41,271,129,65,6,-62,-78,30,54.2,-110,-55.8,0.43171806167400884,0.375,0.8571428571428571
2020,Detroit Pistons,Vanderbilt,Saben Lee,187.96,83.007336,PG,48,781,99,210,0.471,8,23,0.348,61,89,0.685,20,77,97,174,32,13,55,76,267,111,15,28,-24,-21,33,63.95,-12,51.95,0.4714285714285714,0.34782608695652173,0.6853932584269663
2020,Toronto Raptors,Arizona,Stanley Johnson,198.12,109.769264,PF,61,1006,89,233,0.382,45,137,0.328,44,55,0.8,29,124,153,89,52,18,54,116,267,144,92,11,-110,-141,33,69.95,-218,-148.05,0.38197424892703863,0.3284671532846715,0.8
2020,Orlando Magic,Stanford,Chasson Randle,187.96,83.91452,PG,41,837,92,237,0.388,44,130,0.338,38,48,0.792,7,75,82,74,22,5,46,64,266,145,86,10,-106,-126,28,28.05,-204,-175.95,0.3881856540084388,0.3384615384615385,0.7916666666666666
2020,Charlotte Hornets,Nevada-Reno,Caleb Martin,195.58,92.98636,SF,53,818,96,256,0.375,31,125,0.248,41,64,0.641,31,110,141,67,37,12,33,62,264,160,94,23,-128,-189,18,64.65,-299,-234.35,0.375,0.248,0.640625
2020,Los Angeles Lakers,,Marc Gasol,210.82,115.66596,C,52,993,88,194,0.454,50,122,0.41,36,50,0.72,38,177,215,109,26,58,53,115,262,106,72,14,-36,-66,22,100.25,-80,20.25,0.4536082474226804,0.4098360655737705,0.72
2020,Philadelphia 76ers,Indiana-Purdue Indianapolis,George Hill,193.04,85.275296,PG,30,672,95,197,0.482,31,80,0.388,40,50,0.8,16,45,61,73,23,5,31,31,261,102,49,10,-14,-54,30,34.45,-38,-3.549999999999997,0.48223350253807107,0.3875,0.8
2020,Philadelphia 76ers,Indiana-Purdue Indianapolis,George Hill,193.04,85.275296,PG,30,672,95,197,0.482,31,80,0.388,40,50,0.8,16,45,61,73,23,5,31,31,261,102,49,10,-14,-54,30,34.45,-38,-3.549999999999997,0.48223350253807107,0.3875,0.8
2020,Philadelphia 76ers,Indiana-Purdue Indianapolis,George Hill,193.04,85.275296,PG,30,672,95,197,0.482,31,80,0.388,40,50,0.8,16,45,61,73,23,5,31,31,261,102,49,10,-14,-54,30,34.45,-38,-3.549999999999997,0.48223350253807107,0.3875,0.8
2020,Philadelphia 76ers,Indiana-Purdue Indianapolis,George Hill,193.04,85.275296,PG,30,672,95,197,0.482,31,80,0.388,40,50,0.8,16,45,61,73,23,5,31,31,261,102,49,10,-14,-54,30,34.45,-38,-3.549999999999997,0.48223350253807107,0.3875,0.8
2020,Philadelphia 76ers,Indiana-Purdue Indianapolis,George Hill,193.04,85.275296,PG,30,672,95,197,0.482,31,80,0.388,40,50,0.8,16,45,61,73,23,5,31,31,261,102,49,10,-14,-54,30,34.45,-38,-3.549999999999997,0.48223350253807107,0.3875,0.8
2020,Philadelphia 76ers,Indiana-Purdue Indianapolis,George Hill,193.04,85.275296,PG,30,672,95,197,0.482,31,80,0.388,40,50,0.8,16,45,61,73,23,5,31,31,261,102,49,10,-14,-54,30,34.45,-38,-3.549999999999997,0.48223350253807107,0.3875,0.8
2020,Philadelphia 76ers,Indiana-Purdue Indianapolis,George Hill,193.04,85.275296,PG,30,672,95,197,0.482,31,80,0.388,40,50,0.8,16,45,61,73,23,5,31,31,261,102,49,10,-14,-54,30,34.45,-38,-3.549999999999997,0.48223350253807107,0.3875,0.8
2020,Philadelphia 76ers,Indiana-Purdue Indianapolis,George Hill,193.04,85.275296,PG,30,672,95,197,0.482,31,80,0.388,40,50,0.8,16,45,61,73,23,5,31,31,261,102,49,10,-14,-54,30,34.45,-38,-3.549999999999997,0.48223350253807107,0.3875,0.8
2020,Philadelphia 76ers,Indiana-Purdue Indianapolis,George Hill,193.04,85.275296,PG,30,672,95,197,0.482,31,80,0.388,40,50,0.8,16,45,61,73,23,5,31,31,261,102,49,10,-14,-54,30,34.45,-38,-3.549999999999997,0.48223350253807107,0.3875,0.8
2020,Boston Celtics,Southern Methodist,Semi Ojeleye,198.12,108.86208,PF,56,950,89,221,0.403,58,158,0.367,24,32,0.75,31,116,147,37,17,0,21,56,260,132,100,8,-86,-126,16,48.95,-196,-147.05,0.40271493212669685,0.3670886075949367,0.75
2020,San Antonio Spurs,Louisville,Gorgui Dieng,208.28,114.305184,C,38,553,85,163,0.521,30,70,0.429,58,67,0.866,40,100,140,48,26,16,32,56,258,78,40,9,14,-30,49,59.2,33,92.2,0.5214723926380368,0.42857142857142855,0.8656716417910447
2020,San Antonio Spurs,Louisville,Gorgui Dieng,208.28,114.305184,C,38,553,85,163,0.521,30,70,0.429,58,67,0.866,40,100,140,48,26,16,32,56,258,78,40,9,14,-30,49,59.2,33,92.2,0.5214723926380368,0.42857142857142855,0.8656716417910447
2020,San Antonio Spurs,Louisville,Gorgui Dieng,208.28,114.305184,C,38,553,85,163,0.521,30,70,0.429,58,67,0.866,40,100,140,48,26,16,32,56,258,78,40,9,14,-30,49,59.2,33,92.2,0.5214723926380368,0.42857142857142855,0.8656716417910447
2020,San Antonio Spurs,Louisville,Gorgui Dieng,208.28,114.305184,C,38,553,85,163,0.521,30,70,0.429,58,67,0.866,40,100,140,48,26,16,32,56,258,78,40,9,14,-30,49,59.2,33,92.2,0.5214723926380368,0.42857142857142855,0.8656716417910447
2020,San Antonio Spurs,Louisville,Gorgui Dieng,208.28,114.305184,C,38,553,85,163,0.521,30,70,0.429,58,67,0.866,40,100,140,48,26,16,32,56,258,78,40,9,14,-30,49,59.2,33,92.2,0.5214723926380368,0.42857142857142855,0.8656716417910447
2020,San Antonio Spurs,Louisville,Gorgui Dieng,208.28,114.305184,C,38,553,85,163,0.521,30,70,0.429,58,67,0.866,40,100,140,48,26,16,32,56,258,78,40,9,14,-30,49,59.2,33,92.2,0.5214723926380368,0.42857142857142855,0.8656716417910447
2020,San Antonio Spurs,Louisville,Gorgui Dieng,208.28,114.305184,C,38,553,85,163,0.521,30,70,0.429,58,67,0.866,40,100,140,48,26,16,32,56,258,78,40,9,14,-30,49,59.2,33,92.2,0.5214723926380368,0.42857142857142855,0.8656716417910447
2020,San Antonio Spurs,Louisville,Gorgui Dieng,208.28,114.305184,C,38,553,85,163,0.521,30,70,0.429,58,67,0.866,40,100,140,48,26,16,32,56,258,78,40,9,14,-30,49,59.2,33,92.2,0.5214723926380368,0.42857142857142855,0.8656716417910447
2020,San Antonio Spurs,Louisville,Gorgui Dieng,208.28,114.305184,C,38,553,85,163,0.521,30,70,0.429,58,67,0.866,40,100,140,48,26,16,32,56,258,78,40,9,14,-30,49,59.2,33,92.2,0.5214723926380368,0.42857142857142855,0.8656716417910447
2020,Minnesota Timberwolves,Southern California,Jordan McLaughlin,180.34,83.91452,PG,51,938,100,242,0.413,33,92,0.359,23,30,0.767,21,87,108,193,51,6,51,44,256,142,59,7,-84,-78,16,81.3,-146,-64.7,0.4132231404958678,0.358695652173913,0.7666666666666667
2020,New York Knicks,Western Kentucky,Mitchell Robinson,213.36,108.86208,C,31,853,115,176,0.653,0,0,0.0,26,53,0.491,113,139,252,17,35,45,26,86,256,61,0,27,108,0,-1,118.2,107,225.2,0.6534090909090909,,0.49056603773584906
2020,Philadelphia 76ers,Washington,Matisse Thybulle,195.58,91.171992,SG,65,1298,102,243,0.42,43,143,0.301,8,18,0.444,30,94,124,63,105,71,32,127,255,141,100,10,-78,-171,-2,119.9,-251,-131.1,0.41975308641975306,0.3006993006993007,0.4444444444444444
2020,New York Knicks,Dayton,Obi Toppin,205.74,99.79024,PF,62,683,104,209,0.498,26,85,0.306,19,26,0.731,26,112,138,29,17,15,23,55,253,105,59,7,-2,-99,12,50.0,-89,-39.0,0.49760765550239233,0.3058823529411765,0.7307692307692307
2020,Golden State Warriors,UCLA,Kevon Looney,205.74,100.697424,C,61,1161,108,197,0.548,4,17,0.235,31,48,0.646,117,205,322,119,21,22,37,136,251,89,13,17,38,-27,14,135.7,25,160.7,0.5482233502538071,0.23529411764705882,0.6458333333333334
2020,Atlanta Hawks,New Mexico,Tony Snell,198.12,96.615096,SG,47,992,88,171,0.515,62,109,0.569,11,11,1.0,18,94,112,59,13,11,21,75,249,83,47,0,10,45,11,45.0,66,111.0,0.5146198830409356,0.5688073394495413,1.0
2020,Phoenix Suns,West Virginia,Jevon Carter,185.42,90.7184,PG,60,717,94,223,0.422,56,151,0.371,4,7,0.571,16,76,92,71,29,9,16,56,248,129,95,3,-70,-117,1,52.95,-186,-133.05,0.42152466367713004,0.3708609271523179,0.5714285714285714
2020,New Orleans Pelicans,Xavier,Naji Marshall,200.66,99.79024,SF,32,700,82,209,0.392,29,83,0.349,53,75,0.707,15,133,148,88,26,10,38,58,246,127,54,22,-90,-75,31,58.85,-134,-75.15,0.3923444976076555,0.3493975903614458,0.7066666666666667
2020,Toronto Raptors,Duke,Rodney Hood,203.2,94.347136,SF,55,943,94,260,0.362,34,113,0.301,24,28,0.857,23,80,103,53,24,7,36,74,246,166,79,4,-144,-135,20,38.55,-259,-220.45,0.36153846153846153,0.3008849557522124,0.8571428571428571
2020,Toronto Raptors,Duke,Rodney Hood,203.2,94.347136,SF,55,943,94,260,0.362,34,113,0.301,24,28,0.857,23,80,103,53,24,7,36,74,246,166,79,4,-144,-135,20,38.55,-259,-220.45,0.36153846153846153,0.3008849557522124,0.8571428571428571
2020,Toronto Raptors,Duke,Rodney Hood,203.2,94.347136,SF,55,943,94,260,0.362,34,113,0.301,24,28,0.857,23,80,103,53,24,7,36,74,246,166,79,4,-144,-135,20,38.55,-259,-220.45,0.36153846153846153,0.3008849557522124,0.8571428571428571
2020,Toronto Raptors,Duke,Rodney Hood,203.2,94.347136,SF,55,943,94,260,0.362,34,113,0.301,24,28,0.857,23,80,103,53,24,7,36,74,246,166,79,4,-144,-135,20,38.55,-259,-220.45,0.36153846153846153,0.3008849557522124,0.8571428571428571
2020,Toronto Raptors,Duke,Rodney Hood,203.2,94.347136,SF,55,943,94,260,0.362,34,113,0.301,24,28,0.857,23,80,103,53,24,7,36,74,246,166,79,4,-144,-135,20,38.55,-259,-220.45,0.36153846153846153,0.3008849557522124,0.8571428571428571
2020,Toronto Raptors,Duke,Rodney Hood,203.2,94.347136,SF,55,943,94,260,0.362,34,113,0.301,24,28,0.857,23,80,103,53,24,7,36,74,246,166,79,4,-144,-135,20,38.55,-259,-220.45,0.36153846153846153,0.3008849557522124,0.8571428571428571
2020,Toronto Raptors,Duke,Rodney Hood,203.2,94.347136,SF,55,943,94,260,0.362,34,113,0.301,24,28,0.857,23,80,103,53,24,7,36,74,246,166,79,4,-144,-135,20,38.55,-259,-220.45,0.36153846153846153,0.3008849557522124,0.8571428571428571
2020,Toronto Raptors,Duke,Rodney Hood,203.2,94.347136,SF,55,943,94,260,0.362,34,113,0.301,24,28,0.857,23,80,103,53,24,7,36,74,246,166,79,4,-144,-135,20,38.55,-259,-220.45,0.36153846153846153,0.3008849557522124,0.8571428571428571
2020,Toronto Raptors,Duke,Rodney Hood,203.2,94.347136,SF,55,943,94,260,0.362,34,113,0.301,24,28,0.857,23,80,103,53,24,7,36,74,246,166,79,4,-144,-135,20,38.55,-259,-220.45,0.36153846153846153,0.3008849557522124,0.8571428571428571
2020,Milwaukee Bucks,North Carolina,Justin Jackson,203.2,99.79024,SF,34,577,89,221,0.403,36,117,0.308,31,37,0.838,16,61,77,52,15,2,32,32,245,132,81,6,-86,-135,25,27.15,-196,-168.85,0.40271493212669685,0.3076923076923077,0.8378378378378378
2020,Milwaukee Bucks,North Carolina,Justin Jackson,203.2,99.79024,SF,34,577,89,221,0.403,36,117,0.308,31,37,0.838,16,61,77,52,15,2,32,32,245,132,81,6,-86,-135,25,27.15,-196,-168.85,0.40271493212669685,0.3076923076923077,0.8378378378378378
2020,Milwaukee Bucks,North Carolina,Justin Jackson,203.2,99.79024,SF,34,577,89,221,0.403,36,117,0.308,31,37,0.838,16,61,77,52,15,2,32,32,245,132,81,6,-86,-135,25,27.15,-196,-168.85,0.40271493212669685,0.3076923076923077,0.8378378378378378
2020,Milwaukee Bucks,North Carolina,Justin Jackson,203.2,99.79024,SF,34,577,89,221,0.403,36,117,0.308,31,37,0.838,16,61,77,52,15,2,32,32,245,132,81,6,-86,-135,25,27.15,-196,-168.85,0.40271493212669685,0.3076923076923077,0.8378378378378378
2020,Milwaukee Bucks,North Carolina,Justin Jackson,203.2,99.79024,SF,34,577,89,221,0.403,36,117,0.308,31,37,0.838,16,61,77,52,15,2,32,32,245,132,81,6,-86,-135,25,27.15,-196,-168.85,0.40271493212669685,0.3076923076923077,0.8378378378378378
2020,Milwaukee Bucks,North Carolina,Justin Jackson,203.2,99.79024,SF,34,577,89,221,0.403,36,117,0.308,31,37,0.838,16,61,77,52,15,2,32,32,245,132,81,6,-86,-135,25,27.15,-196,-168.85,0.40271493212669685,0.3076923076923077,0.8378378378378378
2020,Milwaukee Bucks,North Carolina,Justin Jackson,203.2,99.79024,SF,34,577,89,221,0.403,36,117,0.308,31,37,0.838,16,61,77,52,15,2,32,32,245,132,81,6,-86,-135,25,27.15,-196,-168.85,0.40271493212669685,0.3076923076923077,0.8378378378378378
2020,Milwaukee Bucks,North Carolina,Justin Jackson,203.2,99.79024,SF,34,577,89,221,0.403,36,117,0.308,31,37,0.838,16,61,77,52,15,2,32,32,245,132,81,6,-86,-135,25,27.15,-196,-168.85,0.40271493212669685,0.3076923076923077,0.8378378378378378
2020,Milwaukee Bucks,North Carolina,Justin Jackson,203.2,99.79024,SF,34,577,89,221,0.403,36,117,0.308,31,37,0.838,16,61,77,52,15,2,32,32,245,132,81,6,-86,-135,25,27.15,-196,-168.85,0.40271493212669685,0.3076923076923077,0.8378378378378378
2020,Miami Heat,California-Santa Barbara,Gabe Vincent,190.5,90.7184,PG,50,655,88,233,0.378,46,149,0.309,20,23,0.87,10,46,56,67,21,2,34,79,242,145,103,3,-114,-171,17,23.8,-268,-244.2,0.3776824034334764,0.3087248322147651,0.8695652173913043
2020,Miami Heat,,Nemanja Bjelica,208.28,106.140528,PF,37,595,89,196,0.454,27,85,0.318,37,51,0.725,29,98,127,69,15,5,33,68,242,107,58,14,-36,-93,23,46.35,-106,-59.65,0.45408163265306123,0.3176470588235294,0.7254901960784313
2020,Miami Heat,,Nemanja Bjelica,208.28,106.140528,PF,37,595,89,196,0.454,27,85,0.318,37,51,0.725,29,98,127,69,15,5,33,68,242,107,58,14,-36,-93,23,46.35,-106,-59.65,0.45408163265306123,0.3176470588235294,0.7254901960784313
2020,Miami Heat,,Nemanja Bjelica,208.28,106.140528,PF,37,595,89,196,0.454,27,85,0.318,37,51,0.725,29,98,127,69,15,5,33,68,242,107,58,14,-36,-93,23,46.35,-106,-59.65,0.45408163265306123,0.3176470588235294,0.7254901960784313
2020,Miami Heat,,Nemanja Bjelica,208.28,106.140528,PF,37,595,89,196,0.454,27,85,0.318,37,51,0.725,29,98,127,69,15,5,33,68,242,107,58,14,-36,-93,23,46.35,-106,-59.65,0.45408163265306123,0.3176470588235294,0.7254901960784313
2020,Miami Heat,,Nemanja Bjelica,208.28,106.140528,PF,37,595,89,196,0.454,27,85,0.318,37,51,0.725,29,98,127,69,15,5,33,68,242,107,58,14,-36,-93,23,46.35,-106,-59.65,0.45408163265306123,0.3176470588235294,0.7254901960784313
2020,Miami Heat,,Nemanja Bjelica,208.28,106.140528,PF,37,595,89,196,0.454,27,85,0.318,37,51,0.725,29,98,127,69,15,5,33,68,242,107,58,14,-36,-93,23,46.35,-106,-59.65,0.45408163265306123,0.3176470588235294,0.7254901960784313
2020,Miami Heat,,Nemanja Bjelica,208.28,106.140528,PF,37,595,89,196,0.454,27,85,0.318,37,51,0.725,29,98,127,69,15,5,33,68,242,107,58,14,-36,-93,23,46.35,-106,-59.65,0.45408163265306123,0.3176470588235294,0.7254901960784313
2020,Miami Heat,,Nemanja Bjelica,208.28,106.140528,PF,37,595,89,196,0.454,27,85,0.318,37,51,0.725,29,98,127,69,15,5,33,68,242,107,58,14,-36,-93,23,46.35,-106,-59.65,0.45408163265306123,0.3176470588235294,0.7254901960784313
2020,Miami Heat,,Nemanja Bjelica,208.28,106.140528,PF,37,595,89,196,0.454,27,85,0.318,37,51,0.725,29,98,127,69,15,5,33,68,242,107,58,14,-36,-93,23,46.35,-106,-59.65,0.45408163265306123,0.3176470588235294,0.7254901960784313
2020,Los Angeles Clippers,Kentucky,Rajon Rondo,185.42,81.64656,PG,45,769,95,215,0.442,36,89,0.404,16,17,0.941,18,92,110,199,37,4,79,53,242,120,53,1,-50,-51,15,60.1,-86,-25.9,0.4418604651162791,0.4044943820224719,0.9411764705882353
2020,Los Angeles Clippers,Kentucky,Rajon Rondo,185.42,81.64656,PG,45,769,95,215,0.442,36,89,0.404,16,17,0.941,18,92,110,199,37,4,79,53,242,120,53,1,-50,-51,15,60.1,-86,-25.9,0.4418604651162791,0.4044943820224719,0.9411764705882353
2020,Los Angeles Clippers,Kentucky,Rajon Rondo,185.42,81.64656,PG,45,769,95,215,0.442,36,89,0.404,16,17,0.941,18,92,110,199,37,4,79,53,242,120,53,1,-50,-51,15,60.1,-86,-25.9,0.4418604651162791,0.4044943820224719,0.9411764705882353
2020,Los Angeles Clippers,Kentucky,Rajon Rondo,185.42,81.64656,PG,45,769,95,215,0.442,36,89,0.404,16,17,0.941,18,92,110,199,37,4,79,53,242,120,53,1,-50,-51,15,60.1,-86,-25.9,0.4418604651162791,0.4044943820224719,0.9411764705882353
2020,Los Angeles Clippers,Kentucky,Rajon Rondo,185.42,81.64656,PG,45,769,95,215,0.442,36,89,0.404,16,17,0.941,18,92,110,199,37,4,79,53,242,120,53,1,-50,-51,15,60.1,-86,-25.9,0.4418604651162791,0.4044943820224719,0.9411764705882353
2020,Los Angeles Clippers,Kentucky,Rajon Rondo,185.42,81.64656,PG,45,769,95,215,0.442,36,89,0.404,16,17,0.941,18,92,110,199,37,4,79,53,242,120,53,1,-50,-51,15,60.1,-86,-25.9,0.4418604651162791,0.4044943820224719,0.9411764705882353
2020,Los Angeles Clippers,Kentucky,Rajon Rondo,185.42,81.64656,PG,45,769,95,215,0.442,36,89,0.404,16,17,0.941,18,92,110,199,37,4,79,53,242,120,53,1,-50,-51,15,60.1,-86,-25.9,0.4418604651162791,0.4044943820224719,0.9411764705882353
2020,Los Angeles Clippers,Kentucky,Rajon Rondo,185.42,81.64656,PG,45,769,95,215,0.442,36,89,0.404,16,17,0.941,18,92,110,199,37,4,79,53,242,120,53,1,-50,-51,15,60.1,-86,-25.9,0.4418604651162791,0.4044943820224719,0.9411764705882353
2020,Los Angeles Clippers,Kentucky,Rajon Rondo,185.42,81.64656,PG,45,769,95,215,0.442,36,89,0.404,16,17,0.941,18,92,110,199,37,4,79,53,242,120,53,1,-50,-51,15,60.1,-86,-25.9,0.4418604651162791,0.4044943820224719,0.9411764705882353
2020,New York Knicks,Southern California,Taj Gibson,205.74,105.233344,C,45,936,99,158,0.627,3,15,0.2,40,55,0.727,99,151,250,36,31,49,22,99,241,59,12,15,80,-27,25,120.3,78,198.3,0.6265822784810127,0.2,0.7272727272727273
2020,Cleveland Cavaliers,,Isaiah Hartenstein,213.36,113.398,C,46,559,94,171,0.55,2,6,0.333,46,71,0.648,65,116,181,55,19,39,44,104,236,77,4,25,34,-6,21,77.05,49,126.05,0.5497076023391813,0.3333333333333333,0.647887323943662
2020,Cleveland Cavaliers,,Isaiah Hartenstein,213.36,113.398,C,46,559,94,171,0.55,2,6,0.333,46,71,0.648,65,116,181,55,19,39,44,104,236,77,4,25,34,-6,21,77.05,49,126.05,0.5497076023391813,0.3333333333333333,0.647887323943662
2020,Cleveland Cavaliers,,Isaiah Hartenstein,213.36,113.398,C,46,559,94,171,0.55,2,6,0.333,46,71,0.648,65,116,181,55,19,39,44,104,236,77,4,25,34,-6,21,77.05,49,126.05,0.5497076023391813,0.3333333333333333,0.647887323943662
2020,Cleveland Cavaliers,,Isaiah Hartenstein,213.36,113.398,C,46,559,94,171,0.55,2,6,0.333,46,71,0.648,65,116,181,55,19,39,44,104,236,77,4,25,34,-6,21,77.05,49,126.05,0.5497076023391813,0.3333333333333333,0.647887323943662
2020,Cleveland Cavaliers,,Isaiah Hartenstein,213.36,113.398,C,46,559,94,171,0.55,2,6,0.333,46,71,0.648,65,116,181,55,19,39,44,104,236,77,4,25,34,-6,21,77.05,49,126.05,0.5497076023391813,0.3333333333333333,0.647887323943662
2020,Cleveland Cavaliers,,Isaiah Hartenstein,213.36,113.398,C,46,559,94,171,0.55,2,6,0.333,46,71,0.648,65,116,181,55,19,39,44,104,236,77,4,25,34,-6,21,77.05,49,126.05,0.5497076023391813,0.3333333333333333,0.647887323943662
2020,Cleveland Cavaliers,,Isaiah Hartenstein,213.36,113.398,C,46,559,94,171,0.55,2,6,0.333,46,71,0.648,65,116,181,55,19,39,44,104,236,77,4,25,34,-6,21,77.05,49,126.05,0.5497076023391813,0.3333333333333333,0.647887323943662
2020,Cleveland Cavaliers,,Isaiah Hartenstein,213.36,113.398,C,46,559,94,171,0.55,2,6,0.333,46,71,0.648,65,116,181,55,19,39,44,104,236,77,4,25,34,-6,21,77.05,49,126.05,0.5497076023391813,0.3333333333333333,0.647887323943662
2020,Cleveland Cavaliers,,Isaiah Hartenstein,213.36,113.398,C,46,559,94,171,0.55,2,6,0.333,46,71,0.648,65,116,181,55,19,39,44,104,236,77,4,25,34,-6,21,77.05,49,126.05,0.5497076023391813,0.3333333333333333,0.647887323943662
2020,Miami Heat,DePaul,Max Strus,195.58,97.52228,SF,39,507,85,187,0.455,50,148,0.338,16,24,0.667,5,36,41,24,11,2,8,43,236,102,98,8,-34,-144,8,17.85,-170,-152.15,0.45454545454545453,0.33783783783783783,0.6666666666666666
2020,Indiana Pacers,,Goga Bitadze,210.82,113.398,C,45,561,83,194,0.428,20,79,0.253,45,61,0.738,60,90,150,37,9,60,17,94,231,111,59,16,-56,-117,29,83.05,-144,-60.95,0.42783505154639173,0.25316455696202533,0.7377049180327869
2020,Minnesota Timberwolves,Maryland,Jake Layman,203.2,94.800728,SF,45,627,91,184,0.495,23,78,0.295,26,37,0.703,13,54,67,28,29,19,26,44,231,93,55,11,-4,-96,15,35.8,-85,-49.2,0.4945652173913043,0.2948717948717949,0.7027027027027027
2020,Indiana Pacers,Syracuse,Oshae Brissett,200.66,95.25432,SF,21,519,73,151,0.483,33,78,0.423,50,65,0.769,29,86,115,18,19,20,10,32,229,78,45,15,-10,-36,35,53.4,-11,42.4,0.48344370860927155,0.4230769230769231,0.7692307692307693
2020,Atlanta Hawks,Florida Gulf Coast,Brandon Goodwin,182.88,81.64656,PG,47,620,84,223,0.377,32,103,0.311,28,43,0.651,8,61,69,95,17,0,36,41,228,139,71,15,-110,-117,13,31.45,-214,-182.55,0.37668161434977576,0.3106796116504854,0.6511627906976745
2020,Atlanta Hawks,Southern California,Onyeka Okongwu,203.2,106.59412,C,50,601,96,149,0.644,0,3,0.0,36,57,0.632,62,101,163,18,23,33,29,100,228,53,3,21,86,-9,15,69.25,92,161.25,0.6442953020134228,0.0,0.631578947368421
2020,Sacramento Kings,Southern California,Chimezie Metu,205.74,102.0582,C,36,488,91,179,0.508,13,37,0.351,31,43,0.721,31,81,112,28,14,18,29,59,226,88,24,12,6,-33,19,41.3,-8,33.3,0.5083798882681564,0.35135135135135137,0.7209302325581395
2020,Houston Rockets,Houston,Armoni Brooks,190.5,88.45044,SG,20,520,78,192,0.406,60,157,0.382,7,12,0.583,10,58,68,30,12,5,22,34,223,114,97,5,-72,-111,2,22.8,-181,-158.2,0.40625,0.3821656050955414,0.5833333333333334
2020,Portland Trail Blazers,North Carolina,Nassir Little,195.58,99.79024,PF,48,640,78,167,0.467,28,80,0.35,36,45,0.8,32,96,128,23,5,13,18,51,220,89,52,9,-22,-72,27,43.2,-67,-23.799999999999997,0.46706586826347307,0.35,0.8
2020,Boston Celtics,Vanderbilt,Aaron Nesmith,195.58,97.52228,SF,46,669,78,178,0.438,40,108,0.37,22,28,0.786,28,99,127,23,15,9,23,87,218,100,68,6,-44,-84,16,40.65,-112,-71.35,0.43820224719101125,0.37037037037037035,0.7857142857142857
2020,Toronto Raptors,George Washington,Yuta Watanabe,205.74,97.52228,SF,50,723,79,180,0.439,36,90,0.4,24,29,0.828,36,123,159,40,26,19,19,57,218,101,54,5,-44,-54,19,68.9,-79,-10.099999999999994,0.4388888888888889,0.4,0.8275862068965517
2020,Philadelphia 76ers,Virginia,Mike Scott,200.66,107.501304,PF,51,852,76,211,0.36,53,155,0.342,8,12,0.667,11,109,120,40,24,14,19,72,213,135,102,4,-118,-147,4,48.65,-261,-212.35,0.36018957345971564,0.3419354838709677,0.6666666666666666
2020,Brooklyn Nets,Fresno State,Tyler Johnson,190.5,84.368112,SG,39,684,72,183,0.393,48,132,0.364,18,21,0.857,6,71,77,47,14,0,17,43,210,111,84,3,-78,-108,15,28.85,-171,-142.15,0.39344262295081966,0.36363636363636365,0.8571428571428571
2020,Charlotte Hornets,Nevada-Reno,Cody Martin,195.58,92.98636,SF,52,849,83,188,0.441,16,58,0.276,25,43,0.581,52,109,161,86,37,12,40,52,207,105,42,18,-44,-78,7,76.65,-115,-38.349999999999994,0.44148936170212766,0.27586206896551724,0.5813953488372093
2020,Los Angeles Clippers,Kentucky,Patrick Patterson,203.2,106.59412,PF,38,582,72,165,0.436,40,112,0.357,13,17,0.765,19,56,75,29,14,8,11,45,197,93,72,4,-42,-96,9,34.0,-129,-95.0,0.43636363636363634,0.35714285714285715,0.7647058823529411
2020,Sacramento Kings,St. John's,Maurice Harkless,200.66,99.79024,PF,37,772,69,165,0.418,23,84,0.274,33,43,0.767,13,76,89,44,30,20,22,86,194,96,61,10,-54,-114,23,46.2,-145,-98.8,0.41818181818181815,0.27380952380952384,0.7674418604651163
2020,Sacramento Kings,St. John's,Maurice Harkless,200.66,99.79024,PF,37,772,69,165,0.418,23,84,0.274,33,43,0.767,13,76,89,44,30,20,22,86,194,96,61,10,-54,-114,23,46.2,-145,-98.8,0.41818181818181815,0.27380952380952384,0.7674418604651163
2020,Sacramento Kings,St. John's,Maurice Harkless,200.66,99.79024,PF,37,772,69,165,0.418,23,84,0.274,33,43,0.767,13,76,89,44,30,20,22,86,194,96,61,10,-54,-114,23,46.2,-145,-98.8,0.41818181818181815,0.27380952380952384,0.7674418604651163
2020,Sacramento Kings,St. John's,Maurice Harkless,200.66,99.79024,SF,37,772,69,165,0.418,23,84,0.274,33,43,0.767,13,76,89,44,30,20,22,86,194,96,61,10,-54,-114,23,46.2,-145,-98.8,0.41818181818181815,0.27380952380952384,0.7674418604651163
2020,Sacramento Kings,St. John's,Maurice Harkless,200.66,99.79024,SF,37,772,69,165,0.418,23,84,0.274,33,43,0.767,13,76,89,44,30,20,22,86,194,96,61,10,-54,-114,23,46.2,-145,-98.8,0.41818181818181815,0.27380952380952384,0.7674418604651163
2020,Sacramento Kings,St. John's,Maurice Harkless,200.66,99.79024,SF,37,772,69,165,0.418,23,84,0.274,33,43,0.767,13,76,89,44,30,20,22,86,194,96,61,10,-54,-114,23,46.2,-145,-98.8,0.41818181818181815,0.27380952380952384,0.7674418604651163
2020,Sacramento Kings,St. John's,Maurice Harkless,200.66,99.79024,PF,37,772,69,165,0.418,23,84,0.274,33,43,0.767,13,76,89,44,30,20,22,86,194,96,61,10,-54,-114,23,46.2,-145,-98.8,0.41818181818181815,0.27380952380952384,0.7674418604651163
2020,Sacramento Kings,St. John's,Maurice Harkless,200.66,99.79024,PF,37,772,69,165,0.418,23,84,0.274,33,43,0.767,13,76,89,44,30,20,22,86,194,96,61,10,-54,-114,23,46.2,-145,-98.8,0.41818181818181815,0.27380952380952384,0.7674418604651163
2020,Sacramento Kings,St. John's,Maurice Harkless,200.66,99.79024,PF,37,772,69,165,0.418,23,84,0.274,33,43,0.767,13,76,89,44,30,20,22,86,194,96,61,10,-54,-114,23,46.2,-145,-98.8,0.41818181818181815,0.27380952380952384,0.7674418604651163
2020,Milwaukee Bucks,Texas-Austin,P.J. Tucker,195.58,111.13004,PF,52,1356,66,177,0.373,40,119,0.336,21,28,0.75,51,153,204,61,39,20,40,125,193,111,79,7,-90,-117,14,82.25,-193,-110.75,0.3728813559322034,0.33613445378151263,0.75
2020,Milwaukee Bucks,Texas-Austin,P.J. Tucker,195.58,111.13004,PF,52,1356,66,177,0.373,40,119,0.336,21,28,0.75,51,153,204,61,39,20,40,125,193,111,79,7,-90,-117,14,82.25,-193,-110.75,0.3728813559322034,0.33613445378151263,0.75
2020,Milwaukee Bucks,Texas-Austin,P.J. Tucker,195.58,111.13004,PF,52,1356,66,177,0.373,40,119,0.336,21,28,0.75,51,153,204,61,39,20,40,125,193,111,79,7,-90,-117,14,82.25,-193,-110.75,0.3728813559322034,0.33613445378151263,0.75
2020,Milwaukee Bucks,Texas-Austin,P.J. Tucker,195.58,111.13004,PF,52,1356,66,177,0.373,40,119,0.336,21,28,0.75,51,153,204,61,39,20,40,125,193,111,79,7,-90,-117,14,82.25,-193,-110.75,0.3728813559322034,0.33613445378151263,0.75
2020,Milwaukee Bucks,Texas-Austin,P.J. Tucker,195.58,111.13004,PF,52,1356,66,177,0.373,40,119,0.336,21,28,0.75,51,153,204,61,39,20,40,125,193,111,79,7,-90,-117,14,82.25,-193,-110.75,0.3728813559322034,0.33613445378151263,0.75
2020,Milwaukee Bucks,Texas-Austin,P.J. Tucker,195.58,111.13004,PF,52,1356,66,177,0.373,40,119,0.336,21,28,0.75,51,153,204,61,39,20,40,125,193,111,79,7,-90,-117,14,82.25,-193,-110.75,0.3728813559322034,0.33613445378151263,0.75
2020,Milwaukee Bucks,Texas-Austin,P.J. Tucker,195.58,111.13004,PF,52,1356,66,177,0.373,40,119,0.336,21,28,0.75,51,153,204,61,39,20,40,125,193,111,79,7,-90,-117,14,82.25,-193,-110.75,0.3728813559322034,0.33613445378151263,0.75
2020,Milwaukee Bucks,Texas-Austin,P.J. Tucker,195.58,111.13004,PF,52,1356,66,177,0.373,40,119,0.336,21,28,0.75,51,153,204,61,39,20,40,125,193,111,79,7,-90,-117,14,82.25,-193,-110.75,0.3728813559322034,0.33613445378151263,0.75
2020,Milwaukee Bucks,Texas-Austin,P.J. Tucker,195.58,111.13004,PF,52,1356,66,177,0.373,40,119,0.336,21,28,0.75,51,153,204,61,39,20,40,125,193,111,79,7,-90,-117,14,82.25,-193,-110.75,0.3728813559322034,0.33613445378151263,0.75
2020,Phoenix Suns,St. Joseph's (PA),Langston Galloway,185.42,90.7184,SG,40,438,66,147,0.449,36,85,0.424,22,23,0.957,7,35,42,26,8,0,13,25,190,81,49,1,-30,-39,21,15.0,-48,-33.0,0.4489795918367347,0.4235294117647059,0.9565217391304348
2020,Memphis Grizzlies,Indiana-Purdue Fort Wayne,John Konchar,195.58,95.25432,SG,43,575,69,138,0.5,21,56,0.375,25,30,0.833,35,93,128,47,30,9,18,40,184,69,35,5,0,-42,20,61.0,-22,39.0,0.5,0.375,0.8333333333333334
2020,Houston Rockets,Michigan,D.J. Wilson,208.28,104.779752,PF,35,433,68,168,0.405,30,87,0.345,17,25,0.68,20,92,112,23,11,16,22,44,183,100,57,8,-64,-81,9,39.05,-136,-96.95,0.40476190476190477,0.3448275862068966,0.68
2020,Houston Rockets,Michigan,D.J. Wilson,208.28,104.779752,PF,35,433,68,168,0.405,30,87,0.345,17,25,0.68,20,92,112,23,11,16,22,44,183,100,57,8,-64,-81,9,39.05,-136,-96.95,0.40476190476190477,0.3448275862068966,0.68
2020,Houston Rockets,Michigan,D.J. Wilson,208.28,104.779752,PF,35,433,68,168,0.405,30,87,0.345,17,25,0.68,20,92,112,23,11,16,22,44,183,100,57,8,-64,-81,9,39.05,-136,-96.95,0.40476190476190477,0.3448275862068966,0.68
2020,Houston Rockets,Michigan,D.J. Wilson,208.28,104.779752,PF,35,433,68,168,0.405,30,87,0.345,17,25,0.68,20,92,112,23,11,16,22,44,183,100,57,8,-64,-81,9,39.05,-136,-96.95,0.40476190476190477,0.3448275862068966,0.68
2020,Houston Rockets,Michigan,D.J. Wilson,208.28,104.779752,PF,35,433,68,168,0.405,30,87,0.345,17,25,0.68,20,92,112,23,11,16,22,44,183,100,57,8,-64,-81,9,39.05,-136,-96.95,0.40476190476190477,0.3448275862068966,0.68
2020,Houston Rockets,Michigan,D.J. Wilson,208.28,104.779752,PF,35,433,68,168,0.405,30,87,0.345,17,25,0.68,20,92,112,23,11,16,22,44,183,100,57,8,-64,-81,9,39.05,-136,-96.95,0.40476190476190477,0.3448275862068966,0.68
2020,Houston Rockets,Michigan,D.J. Wilson,208.28,104.779752,PF,35,433,68,168,0.405,30,87,0.345,17,25,0.68,20,92,112,23,11,16,22,44,183,100,57,8,-64,-81,9,39.05,-136,-96.95,0.40476190476190477,0.3448275862068966,0.68
2020,Houston Rockets,Michigan,D.J. Wilson,208.28,104.779752,PF,35,433,68,168,0.405,30,87,0.345,17,25,0.68,20,92,112,23,11,16,22,44,183,100,57,8,-64,-81,9,39.05,-136,-96.95,0.40476190476190477,0.3448275862068966,0.68
2020,Houston Rockets,Michigan,D.J. Wilson,208.28,104.779752,PF,35,433,68,168,0.405,30,87,0.345,17,25,0.68,20,92,112,23,11,16,22,44,183,100,57,8,-64,-81,9,39.05,-136,-96.95,0.40476190476190477,0.3448275862068966,0.68
2020,Sacramento Kings,Vanderbilt,Damian Jones,210.82,111.13004,C,39,546,70,103,0.68,1,5,0.2,42,58,0.724,36,85,121,29,11,29,26,77,183,33,4,16,74,-9,26,49.65,91,140.65,0.6796116504854369,0.2,0.7241379310344828
2020,Sacramento Kings,Vanderbilt,Damian Jones,210.82,111.13004,C,39,546,70,103,0.68,1,5,0.2,42,58,0.724,36,85,121,29,11,29,26,77,183,33,4,16,74,-9,26,49.65,91,140.65,0.6796116504854369,0.2,0.7241379310344828
2020,Sacramento Kings,Vanderbilt,Damian Jones,210.82,111.13004,C,39,546,70,103,0.68,1,5,0.2,42,58,0.724,36,85,121,29,11,29,26,77,183,33,4,16,74,-9,26,49.65,91,140.65,0.6796116504854369,0.2,0.7241379310344828
2020,Sacramento Kings,Vanderbilt,Damian Jones,210.82,111.13004,C,39,546,70,103,0.68,1,5,0.2,42,58,0.724,36,85,121,29,11,29,26,77,183,33,4,16,74,-9,26,49.65,91,140.65,0.6796116504854369,0.2,0.7241379310344828
2020,Sacramento Kings,Vanderbilt,Damian Jones,210.82,111.13004,C,39,546,70,103,0.68,1,5,0.2,42,58,0.724,36,85,121,29,11,29,26,77,183,33,4,16,74,-9,26,49.65,91,140.65,0.6796116504854369,0.2,0.7241379310344828
2020,Sacramento Kings,Vanderbilt,Damian Jones,210.82,111.13004,C,39,546,70,103,0.68,1,5,0.2,42,58,0.724,36,85,121,29,11,29,26,77,183,33,4,16,74,-9,26,49.65,91,140.65,0.6796116504854369,0.2,0.7241379310344828
2020,Sacramento Kings,Vanderbilt,Damian Jones,210.82,111.13004,C,39,546,70,103,0.68,1,5,0.2,42,58,0.724,36,85,121,29,11,29,26,77,183,33,4,16,74,-9,26,49.65,91,140.65,0.6796116504854369,0.2,0.7241379310344828
2020,Sacramento Kings,Vanderbilt,Damian Jones,210.82,111.13004,C,39,546,70,103,0.68,1,5,0.2,42,58,0.724,36,85,121,29,11,29,26,77,183,33,4,16,74,-9,26,49.65,91,140.65,0.6796116504854369,0.2,0.7241379310344828
2020,Sacramento Kings,Vanderbilt,Damian Jones,210.82,111.13004,C,39,546,70,103,0.68,1,5,0.2,42,58,0.724,36,85,121,29,11,29,26,77,183,33,4,16,74,-9,26,49.65,91,140.65,0.6796116504854369,0.2,0.7241379310344828
2020,Sacramento Kings,Vanderbilt,Damian Jones,210.82,111.13004,C,39,546,70,103,0.68,1,5,0.2,42,58,0.724,36,85,121,29,11,29,26,77,183,33,4,16,74,-9,26,49.65,91,140.65,0.6796116504854369,0.2,0.7241379310344828
2020,Sacramento Kings,Vanderbilt,Damian Jones,210.82,111.13004,C,39,546,70,103,0.68,1,5,0.2,42,58,0.724,36,85,121,29,11,29,26,77,183,33,4,16,74,-9,26,49.65,91,140.65,0.6796116504854369,0.2,0.7241379310344828
2020,Sacramento Kings,Vanderbilt,Damian Jones,210.82,111.13004,C,39,546,70,103,0.68,1,5,0.2,42,58,0.724,36,85,121,29,11,29,26,77,183,33,4,16,74,-9,26,49.65,91,140.65,0.6796116504854369,0.2,0.7241379310344828
2020,Sacramento Kings,Vanderbilt,Damian Jones,210.82,111.13004,C,39,546,70,103,0.68,1,5,0.2,42,58,0.724,36,85,121,29,11,29,26,77,183,33,4,16,74,-9,26,49.65,91,140.65,0.6796116504854369,0.2,0.7241379310344828
2020,Sacramento Kings,Vanderbilt,Damian Jones,210.82,111.13004,C,39,546,70,103,0.68,1,5,0.2,42,58,0.724,36,85,121,29,11,29,26,77,183,33,4,16,74,-9,26,49.65,91,140.65,0.6796116504854369,0.2,0.7241379310344828
2020,Sacramento Kings,Vanderbilt,Damian Jones,210.82,111.13004,C,39,546,70,103,0.68,1,5,0.2,42,58,0.724,36,85,121,29,11,29,26,77,183,33,4,16,74,-9,26,49.65,91,140.65,0.6796116504854369,0.2,0.7241379310344828
2020,Sacramento Kings,Vanderbilt,Damian Jones,210.82,111.13004,C,39,546,70,103,0.68,1,5,0.2,42,58,0.724,36,85,121,29,11,29,26,77,183,33,4,16,74,-9,26,49.65,91,140.65,0.6796116504854369,0.2,0.7241379310344828
2020,Minnesota Timberwolves,Texas Tech,Jarrett Culver,198.12,88.45044,SG,34,499,69,168,0.411,13,53,0.245,29,48,0.604,34,70,104,24,17,9,28,58,180,99,40,19,-60,-81,10,36.6,-131,-94.4,0.4107142857142857,0.24528301886792453,0.6041666666666666
2020,Memphis Grizzlies,Duke,Justise Winslow,198.12,100.697424,SF,26,507,74,210,0.352,10,54,0.185,20,35,0.571,18,100,118,50,15,12,37,47,178,136,44,15,-124,-102,5,39.15,-221,-181.85,0.3523809523809524,0.18518518518518517,0.5714285714285714
2020,Detroit Pistons,,Killian Hayes,195.58,88.45044,PG,26,670,71,201,0.353,20,72,0.278,14,17,0.824,6,63,69,138,27,10,83,57,176,130,52,3,-118,-96,11,27.4,-203,-175.6,0.35323383084577115,0.2777777777777778,0.8235294117647058
2020,Houston Rockets,Texas-Austin,Avery Bradley,190.5,81.64656,SG,27,602,64,171,0.374,33,101,0.327,12,15,0.8,8,49,57,46,21,3,28,55,173,107,68,3,-86,-105,9,23.0,-182,-159.0,0.3742690058479532,0.32673267326732675,0.8
2020,Houston Rockets,Texas-Austin,Avery Bradley,190.5,81.64656,SG,27,602,64,171,0.374,33,101,0.327,12,15,0.8,8,49,57,46,21,3,28,55,173,107,68,3,-86,-105,9,23.0,-182,-159.0,0.3742690058479532,0.32673267326732675,0.8
2020,Houston Rockets,Texas-Austin,Avery Bradley,190.5,81.64656,SG,27,602,64,171,0.374,33,101,0.327,12,15,0.8,8,49,57,46,21,3,28,55,173,107,68,3,-86,-105,9,23.0,-182,-159.0,0.3742690058479532,0.32673267326732675,0.8
2020,Houston Rockets,Texas-Austin,Avery Bradley,190.5,81.64656,SG,27,602,64,171,0.374,33,101,0.327,12,15,0.8,8,49,57,46,21,3,28,55,173,107,68,3,-86,-105,9,23.0,-182,-159.0,0.3742690058479532,0.32673267326732675,0.8
2020,Houston Rockets,Texas-Austin,Avery Bradley,190.5,81.64656,SG,27,602,64,171,0.374,33,101,0.327,12,15,0.8,8,49,57,46,21,3,28,55,173,107,68,3,-86,-105,9,23.0,-182,-159.0,0.3742690058479532,0.32673267326732675,0.8
2020,Houston Rockets,Texas-Austin,Avery Bradley,190.5,81.64656,SG,27,602,64,171,0.374,33,101,0.327,12,15,0.8,8,49,57,46,21,3,28,55,173,107,68,3,-86,-105,9,23.0,-182,-159.0,0.3742690058479532,0.32673267326732675,0.8
2020,Houston Rockets,Texas-Austin,Avery Bradley,190.5,81.64656,SG,27,602,64,171,0.374,33,101,0.327,12,15,0.8,8,49,57,46,21,3,28,55,173,107,68,3,-86,-105,9,23.0,-182,-159.0,0.3742690058479532,0.32673267326732675,0.8
2020,Houston Rockets,Texas-Austin,Avery Bradley,190.5,81.64656,SG,27,602,64,171,0.374,33,101,0.327,12,15,0.8,8,49,57,46,21,3,28,55,173,107,68,3,-86,-105,9,23.0,-182,-159.0,0.3742690058479532,0.32673267326732675,0.8
2020,Houston Rockets,Texas-Austin,Avery Bradley,190.5,81.64656,SG,27,602,64,171,0.374,33,101,0.327,12,15,0.8,8,49,57,46,21,3,28,55,173,107,68,3,-86,-105,9,23.0,-182,-159.0,0.3742690058479532,0.32673267326732675,0.8
2020,Milwaukee Bucks,Louisville,Jordan Nwora,203.2,102.0582,SF,30,274,62,135,0.459,28,62,0.452,19,25,0.76,9,51,60,7,17,8,24,22,171,73,34,6,-22,-18,13,18.4,-27,-8.600000000000001,0.45925925925925926,0.45161290322580644,0.76
2020,Philadelphia 76ers,Arkansas,Mason Jones,193.04,90.7184,SG,32,334,52,123,0.423,24,66,0.364,40,64,0.625,7,48,55,42,7,1,29,24,168,71,42,24,-38,-54,16,14.3,-76,-61.7,0.42276422764227645,0.36363636363636365,0.625
2020,Philadelphia 76ers,Arkansas,Mason Jones,193.04,90.7184,SG,32,334,52,123,0.423,24,66,0.364,40,64,0.625,7,48,55,42,7,1,29,24,168,71,42,24,-38,-54,16,14.3,-76,-61.7,0.42276422764227645,0.36363636363636365,0.625
2020,Philadelphia 76ers,Arkansas,Mason Jones,193.04,90.7184,SG,32,334,52,123,0.423,24,66,0.364,40,64,0.625,7,48,55,42,7,1,29,24,168,71,42,24,-38,-54,16,14.3,-76,-61.7,0.42276422764227645,0.36363636363636365,0.625
2020,Philadelphia 76ers,Arkansas,Mason Jones,193.04,90.7184,SG,32,334,52,123,0.423,24,66,0.364,40,64,0.625,7,48,55,42,7,1,29,24,168,71,42,24,-38,-54,16,14.3,-76,-61.7,0.42276422764227645,0.36363636363636365,0.625
2020,Philadelphia 76ers,Arkansas,Mason Jones,193.04,90.7184,SG,32,334,52,123,0.423,24,66,0.364,40,64,0.625,7,48,55,42,7,1,29,24,168,71,42,24,-38,-54,16,14.3,-76,-61.7,0.42276422764227645,0.36363636363636365,0.625
2020,Philadelphia 76ers,Arkansas,Mason Jones,193.04,90.7184,SG,32,334,52,123,0.423,24,66,0.364,40,64,0.625,7,48,55,42,7,1,29,24,168,71,42,24,-38,-54,16,14.3,-76,-61.7,0.42276422764227645,0.36363636363636365,0.625
2020,Philadelphia 76ers,Arkansas,Mason Jones,193.04,90.7184,SG,32,334,52,123,0.423,24,66,0.364,40,64,0.625,7,48,55,42,7,1,29,24,168,71,42,24,-38,-54,16,14.3,-76,-61.7,0.42276422764227645,0.36363636363636365,0.625
2020,Philadelphia 76ers,Arkansas,Mason Jones,193.04,90.7184,SG,32,334,52,123,0.423,24,66,0.364,40,64,0.625,7,48,55,42,7,1,29,24,168,71,42,24,-38,-54,16,14.3,-76,-61.7,0.42276422764227645,0.36363636363636365,0.625
2020,Philadelphia 76ers,Arkansas,Mason Jones,193.04,90.7184,SG,32,334,52,123,0.423,24,66,0.364,40,64,0.625,7,48,55,42,7,1,29,24,168,71,42,24,-38,-54,16,14.3,-76,-61.7,0.42276422764227645,0.36363636363636365,0.625
2020,Milwaukee Bucks,,Thanasis Antetokounmpo,198.12,99.336648,SF,57,551,67,137,0.489,7,29,0.241,25,49,0.51,54,70,124,46,22,10,43,74,166,70,22,24,-6,-45,1,46.8,-50,-3.200000000000003,0.48905109489051096,0.2413793103448276,0.5102040816326531
2020,Cleveland Cavaliers,Penn State,Lamar Stevens,198.12,104.32616,PF,40,499,62,136,0.456,4,25,0.16,37,51,0.725,24,72,96,25,17,13,23,53,165,74,21,14,-24,-51,23,37.1,-52,-14.899999999999999,0.45588235294117646,0.16,0.7254901960784313
2020,Cleveland Cavaliers,Belmont,Dylan Windler,198.12,88.904032,SF,31,513,57,130,0.438,26,77,0.338,21,27,0.778,20,87,107,33,19,12,32,37,161,73,51,6,-32,-75,15,37.65,-92,-54.35,0.43846153846153846,0.33766233766233766,0.7777777777777778
2020,Chicago Bulls,Oregon,Troy Brown Jr.,198.12,97.52228,SF,34,523,62,144,0.431,22,70,0.314,15,21,0.714,20,85,105,29,10,6,21,49,161,82,48,6,-40,-78,9,33.55,-109,-75.45,0.4305555555555556,0.3142857142857143,0.7142857142857143
2020,Chicago Bulls,Oregon,Troy Brown Jr.,198.12,97.52228,SF,34,523,62,144,0.431,22,70,0.314,15,21,0.714,20,85,105,29,10,6,21,49,161,82,48,6,-40,-78,9,33.55,-109,-75.45,0.4305555555555556,0.3142857142857143,0.7142857142857143
2020,Chicago Bulls,Oregon,Troy Brown Jr.,198.12,97.52228,SF,34,523,62,144,0.431,22,70,0.314,15,21,0.714,20,85,105,29,10,6,21,49,161,82,48,6,-40,-78,9,33.55,-109,-75.45,0.4305555555555556,0.3142857142857143,0.7142857142857143
2020,Chicago Bulls,Oregon,Troy Brown Jr.,198.12,97.52228,SF,34,523,62,144,0.431,22,70,0.314,15,21,0.714,20,85,105,29,10,6,21,49,161,82,48,6,-40,-78,9,33.55,-109,-75.45,0.4305555555555556,0.3142857142857143,0.7142857142857143
2020,Chicago Bulls,Oregon,Troy Brown Jr.,198.12,97.52228,SF,34,523,62,144,0.431,22,70,0.314,15,21,0.714,20,85,105,29,10,6,21,49,161,82,48,6,-40,-78,9,33.55,-109,-75.45,0.4305555555555556,0.3142857142857143,0.7142857142857143
2020,Chicago Bulls,Oregon,Troy Brown Jr.,198.12,97.52228,SF,34,523,62,144,0.431,22,70,0.314,15,21,0.714,20,85,105,29,10,6,21,49,161,82,48,6,-40,-78,9,33.55,-109,-75.45,0.4305555555555556,0.3142857142857143,0.7142857142857143
2020,Chicago Bulls,Oregon,Troy Brown Jr.,198.12,97.52228,SF,34,523,62,144,0.431,22,70,0.314,15,21,0.714,20,85,105,29,10,6,21,49,161,82,48,6,-40,-78,9,33.55,-109,-75.45,0.4305555555555556,0.3142857142857143,0.7142857142857143
2020,Chicago Bulls,Oregon,Troy Brown Jr.,198.12,97.52228,SF,34,523,62,144,0.431,22,70,0.314,15,21,0.714,20,85,105,29,10,6,21,49,161,82,48,6,-40,-78,9,33.55,-109,-75.45,0.4305555555555556,0.3142857142857143,0.7142857142857143
2020,Chicago Bulls,Oregon,Troy Brown Jr.,198.12,97.52228,SF,34,523,62,144,0.431,22,70,0.314,15,21,0.714,20,85,105,29,10,6,21,49,161,82,48,6,-40,-78,9,33.55,-109,-75.45,0.4305555555555556,0.3142857142857143,0.7142857142857143
2020,Phoenix Suns,Iowa State,Abdel Nader,195.58,102.0582,SF,24,355,57,116,0.491,18,43,0.419,28,37,0.757,7,55,62,19,10,9,19,34,160,59,25,9,-4,-21,19,20.3,-6,14.3,0.49137931034482757,0.4186046511627907,0.7567567567567568
2020,Memphis Grizzlies,Michigan State,Jaren Jackson Jr.,210.82,109.769264,C,11,258,53,125,0.424,17,60,0.283,35,42,0.833,17,45,62,12,12,18,15,42,158,72,43,7,-38,-78,28,28.15,-88,-59.85,0.424,0.2833333333333333,0.8333333333333334
2020,Indiana Pacers,Butler,Kelan Martin,195.58,104.32616,SF,35,323,62,138,0.449,24,60,0.4,9,10,0.9,18,60,78,17,10,10,16,35,157,76,36,1,-28,-36,8,28.5,-56,-27.5,0.4492753623188406,0.4,0.9
2020,Detroit Pistons,Iowa,Tyler Cook,203.2,115.66596,SF,32,437,69,103,0.67,1,2,0.5,17,35,0.486,28,67,95,17,8,2,21,35,156,34,1,18,70,0,-1,27.75,69,96.75,0.6699029126213593,0.5,0.4857142857142857
2020,Detroit Pistons,Iowa,Tyler Cook,203.2,115.66596,SF,32,437,69,103,0.67,1,2,0.5,17,35,0.486,28,67,95,17,8,2,21,35,156,34,1,18,70,0,-1,27.75,69,96.75,0.6699029126213593,0.5,0.4857142857142857
2020,Detroit Pistons,Iowa,Tyler Cook,203.2,115.66596,SF,32,437,69,103,0.67,1,2,0.5,17,35,0.486,28,67,95,17,8,2,21,35,156,34,1,18,70,0,-1,27.75,69,96.75,0.6699029126213593,0.5,0.4857142857142857
2020,Detroit Pistons,Iowa,Tyler Cook,203.2,115.66596,PF,32,437,69,103,0.67,1,2,0.5,17,35,0.486,28,67,95,17,8,2,21,35,156,34,1,18,70,0,-1,27.75,69,96.75,0.6699029126213593,0.5,0.4857142857142857
2020,Detroit Pistons,Iowa,Tyler Cook,203.2,115.66596,PF,32,437,69,103,0.67,1,2,0.5,17,35,0.486,28,67,95,17,8,2,21,35,156,34,1,18,70,0,-1,27.75,69,96.75,0.6699029126213593,0.5,0.4857142857142857
2020,Detroit Pistons,Iowa,Tyler Cook,203.2,115.66596,PF,32,437,69,103,0.67,1,2,0.5,17,35,0.486,28,67,95,17,8,2,21,35,156,34,1,18,70,0,-1,27.75,69,96.75,0.6699029126213593,0.5,0.4857142857142857
2020,Detroit Pistons,Iowa,Tyler Cook,203.2,115.66596,SF,32,437,69,103,0.67,1,2,0.5,17,35,0.486,28,67,95,17,8,2,21,35,156,34,1,18,70,0,-1,27.75,69,96.75,0.6699029126213593,0.5,0.4857142857142857
2020,Detroit Pistons,Iowa,Tyler Cook,203.2,115.66596,SF,32,437,69,103,0.67,1,2,0.5,17,35,0.486,28,67,95,17,8,2,21,35,156,34,1,18,70,0,-1,27.75,69,96.75,0.6699029126213593,0.5,0.4857142857142857
2020,Detroit Pistons,Iowa,Tyler Cook,203.2,115.66596,SF,32,437,69,103,0.67,1,2,0.5,17,35,0.486,28,67,95,17,8,2,21,35,156,34,1,18,70,0,-1,27.75,69,96.75,0.6699029126213593,0.5,0.4857142857142857
2020,Detroit Pistons,North Carolina State,Dennis Smith Jr.,187.96,92.98636,PG,23,420,58,145,0.4,19,58,0.328,19,26,0.731,12,43,55,77,23,14,26,37,154,87,39,7,-58,-60,12,39.65,-106,-66.35,0.4,0.3275862068965517,0.7307692307692307
2020,Detroit Pistons,North Carolina State,Dennis Smith Jr.,187.96,92.98636,PG,23,420,58,145,0.4,19,58,0.328,19,26,0.731,12,43,55,77,23,14,26,37,154,87,39,7,-58,-60,12,39.65,-106,-66.35,0.4,0.3275862068965517,0.7307692307692307
2020,Detroit Pistons,North Carolina State,Dennis Smith Jr.,187.96,92.98636,PG,23,420,58,145,0.4,19,58,0.328,19,26,0.731,12,43,55,77,23,14,26,37,154,87,39,7,-58,-60,12,39.65,-106,-66.35,0.4,0.3275862068965517,0.7307692307692307
2020,Detroit Pistons,North Carolina State,Dennis Smith Jr.,187.96,92.98636,PG,23,420,58,145,0.4,19,58,0.328,19,26,0.731,12,43,55,77,23,14,26,37,154,87,39,7,-58,-60,12,39.65,-106,-66.35,0.4,0.3275862068965517,0.7307692307692307
2020,Detroit Pistons,North Carolina State,Dennis Smith Jr.,187.96,92.98636,PG,23,420,58,145,0.4,19,58,0.328,19,26,0.731,12,43,55,77,23,14,26,37,154,87,39,7,-58,-60,12,39.65,-106,-66.35,0.4,0.3275862068965517,0.7307692307692307
2020,Detroit Pistons,North Carolina State,Dennis Smith Jr.,187.96,92.98636,PG,23,420,58,145,0.4,19,58,0.328,19,26,0.731,12,43,55,77,23,14,26,37,154,87,39,7,-58,-60,12,39.65,-106,-66.35,0.4,0.3275862068965517,0.7307692307692307
2020,Detroit Pistons,North Carolina State,Dennis Smith Jr.,187.96,92.98636,PG,23,420,58,145,0.4,19,58,0.328,19,26,0.731,12,43,55,77,23,14,26,37,154,87,39,7,-58,-60,12,39.65,-106,-66.35,0.4,0.3275862068965517,0.7307692307692307
2020,Detroit Pistons,North Carolina State,Dennis Smith Jr.,187.96,92.98636,PG,23,420,58,145,0.4,19,58,0.328,19,26,0.731,12,43,55,77,23,14,26,37,154,87,39,7,-58,-60,12,39.65,-106,-66.35,0.4,0.3275862068965517,0.7307692307692307
2020,Detroit Pistons,North Carolina State,Dennis Smith Jr.,187.96,92.98636,PG,23,420,58,145,0.4,19,58,0.328,19,26,0.731,12,43,55,77,23,14,26,37,154,87,39,7,-58,-60,12,39.65,-106,-66.35,0.4,0.3275862068965517,0.7307692307692307
2020,Philadelphia 76ers,Arkansas,Isaiah Joe,193.04,74.84268,SG,41,383,48,133,0.361,39,106,0.368,18,24,0.75,6,30,36,20,12,4,11,34,153,85,67,6,-74,-84,12,16.3,-146,-129.7,0.3609022556390977,0.36792452830188677,0.75
2020,Chicago Bulls,Radford,Javonte Green,193.04,92.98636,SF,41,474,53,102,0.52,10,30,0.333,30,40,0.75,26,45,71,17,28,6,19,45,146,49,20,10,8,-30,20,33.75,-2,31.75,0.5196078431372549,0.3333333333333333,0.75
2020,Chicago Bulls,Radford,Javonte Green,193.04,92.98636,SF,41,474,53,102,0.52,10,30,0.333,30,40,0.75,26,45,71,17,28,6,19,45,146,49,20,10,8,-30,20,33.75,-2,31.75,0.5196078431372549,0.3333333333333333,0.75
2020,Chicago Bulls,Radford,Javonte Green,193.04,92.98636,SF,41,474,53,102,0.52,10,30,0.333,30,40,0.75,26,45,71,17,28,6,19,45,146,49,20,10,8,-30,20,33.75,-2,31.75,0.5196078431372549,0.3333333333333333,0.75
2020,Chicago Bulls,Radford,Javonte Green,193.04,92.98636,SF,41,474,53,102,0.52,10,30,0.333,30,40,0.75,26,45,71,17,28,6,19,45,146,49,20,10,8,-30,20,33.75,-2,31.75,0.5196078431372549,0.3333333333333333,0.75
2020,Chicago Bulls,Radford,Javonte Green,193.04,92.98636,SF,41,474,53,102,0.52,10,30,0.333,30,40,0.75,26,45,71,17,28,6,19,45,146,49,20,10,8,-30,20,33.75,-2,31.75,0.5196078431372549,0.3333333333333333,0.75
2020,Chicago Bulls,Radford,Javonte Green,193.04,92.98636,SF,41,474,53,102,0.52,10,30,0.333,30,40,0.75,26,45,71,17,28,6,19,45,146,49,20,10,8,-30,20,33.75,-2,31.75,0.5196078431372549,0.3333333333333333,0.75
2020,Chicago Bulls,Radford,Javonte Green,193.04,92.98636,SG,41,474,53,102,0.52,10,30,0.333,30,40,0.75,26,45,71,17,28,6,19,45,146,49,20,10,8,-30,20,33.75,-2,31.75,0.5196078431372549,0.3333333333333333,0.75
2020,Chicago Bulls,Radford,Javonte Green,193.04,92.98636,SG,41,474,53,102,0.52,10,30,0.333,30,40,0.75,26,45,71,17,28,6,19,45,146,49,20,10,8,-30,20,33.75,-2,31.75,0.5196078431372549,0.3333333333333333,0.75
2020,Chicago Bulls,Radford,Javonte Green,193.04,92.98636,SG,41,474,53,102,0.52,10,30,0.333,30,40,0.75,26,45,71,17,28,6,19,45,146,49,20,10,8,-30,20,33.75,-2,31.75,0.5196078431372549,0.3333333333333333,0.75
2020,Detroit Pistons,Duke,Jahlil Okafor,208.28,122.46984,C,27,347,63,102,0.618,2,9,0.222,17,24,0.708,23,43,66,13,6,5,21,39,145,39,7,7,48,-15,10,18.55,43,61.55,0.6176470588235294,0.2222222222222222,0.7083333333333334
2020,Washington Wizards,Indiana,Thomas Bryant,208.28,112.490816,C,10,271,59,91,0.648,9,21,0.429,16,24,0.667,18,43,61,15,4,8,11,31,143,32,12,8,54,-9,8,22.45,53,75.45,0.6483516483516484,0.42857142857142855,0.6666666666666666
2020,Los Angeles Clippers,Minnesota,Amir Coffey,200.66,95.25432,SG,44,395,45,103,0.437,23,56,0.411,27,38,0.711,10,34,44,22,10,0,15,30,140,58,33,11,-26,-30,16,15.0,-40,-25.0,0.4368932038834951,0.4107142857142857,0.7105263157894737
2020,Sacramento Kings,Wyoming,Justin James,200.66,86.18248,SF,36,310,52,111,0.468,14,38,0.368,21,36,0.583,9,21,30,22,8,3,15,23,139,59,24,15,-14,-30,6,12.1,-38,-25.9,0.46846846846846846,0.3684210526315789,0.5833333333333334
2020,Utah Jazz,Iowa State,Matt Thomas,193.04,86.18248,SG,45,327,50,127,0.394,27,80,0.338,12,14,0.857,7,37,44,19,4,0,14,18,139,77,53,2,-54,-78,10,11.6,-122,-110.4,0.3937007874015748,0.3375,0.8571428571428571
2020,Utah Jazz,Iowa State,Matt Thomas,193.04,86.18248,SG,45,327,50,127,0.394,27,80,0.338,12,14,0.857,7,37,44,19,4,0,14,18,139,77,53,2,-54,-78,10,11.6,-122,-110.4,0.3937007874015748,0.3375,0.8571428571428571
2020,Utah Jazz,Iowa State,Matt Thomas,193.04,86.18248,SG,45,327,50,127,0.394,27,80,0.338,12,14,0.857,7,37,44,19,4,0,14,18,139,77,53,2,-54,-78,10,11.6,-122,-110.4,0.3937007874015748,0.3375,0.8571428571428571
2020,Utah Jazz,Iowa State,Matt Thomas,193.04,86.18248,SG,45,327,50,127,0.394,27,80,0.338,12,14,0.857,7,37,44,19,4,0,14,18,139,77,53,2,-54,-78,10,11.6,-122,-110.4,0.3937007874015748,0.3375,0.8571428571428571
2020,Utah Jazz,Iowa State,Matt Thomas,193.04,86.18248,SG,45,327,50,127,0.394,27,80,0.338,12,14,0.857,7,37,44,19,4,0,14,18,139,77,53,2,-54,-78,10,11.6,-122,-110.4,0.3937007874015748,0.3375,0.8571428571428571
2020,Utah Jazz,Iowa State,Matt Thomas,193.04,86.18248,SG,45,327,50,127,0.394,27,80,0.338,12,14,0.857,7,37,44,19,4,0,14,18,139,77,53,2,-54,-78,10,11.6,-122,-110.4,0.3937007874015748,0.3375,0.8571428571428571
2020,Utah Jazz,Iowa State,Matt Thomas,193.04,86.18248,SG,45,327,50,127,0.394,27,80,0.338,12,14,0.857,7,37,44,19,4,0,14,18,139,77,53,2,-54,-78,10,11.6,-122,-110.4,0.3937007874015748,0.3375,0.8571428571428571
2020,Utah Jazz,Iowa State,Matt Thomas,193.04,86.18248,SG,45,327,50,127,0.394,27,80,0.338,12,14,0.857,7,37,44,19,4,0,14,18,139,77,53,2,-54,-78,10,11.6,-122,-110.4,0.3937007874015748,0.3375,0.8571428571428571
2020,Utah Jazz,Iowa State,Matt Thomas,193.04,86.18248,SG,45,327,50,127,0.394,27,80,0.338,12,14,0.857,7,37,44,19,4,0,14,18,139,77,53,2,-54,-78,10,11.6,-122,-110.4,0.3937007874015748,0.3375,0.8571428571428571
2020,Chicago Bulls,Villanova,Ryan Arcidiacono,190.5,88.45044,PG,44,450,49,117,0.419,25,67,0.373,13,20,0.65,5,62,67,56,9,0,10,47,136,68,42,7,-38,-51,6,29.15,-83,-53.85,0.4188034188034188,0.373134328358209,0.65
2020,Denver Nuggets,Arizona,Zeke Nnaji,205.74,108.86208,PF,42,397,50,104,0.481,24,59,0.407,12,15,0.8,14,51,65,10,8,4,7,29,136,54,35,3,-8,-33,9,23.3,-32,-8.7,0.4807692307692308,0.4067796610169492,0.8
2020,Indiana Pacers,St. John's,JaKarr Sampson,200.66,97.068688,PF,29,316,56,113,0.496,3,15,0.2,19,29,0.655,27,50,77,4,2,14,15,52,134,57,12,10,-2,-27,9,24.9,-20,4.899999999999999,0.49557522123893805,0.2,0.6551724137931034
2020,Houston Rockets,Vermont,Anthony Lamb,198.12,102.965384,SF,24,415,46,118,0.39,23,71,0.324,18,21,0.857,27,43,70,23,6,5,19,34,133,72,48,3,-52,-75,15,24.3,-112,-87.7,0.3898305084745763,0.323943661971831,0.8571428571428571
2020,Phoenix Suns,Purdue,E'Twaun Moore,190.5,86.636072,SG,27,389,55,121,0.455,11,35,0.314,12,14,0.857,14,31,45,40,15,5,23,32,133,66,24,2,-22,-39,10,21.65,-51,-29.35,0.45454545454545453,0.3142857142857143,0.8571428571428571
2020,San Antonio Spurs,Tulsa,DaQuan Jeffries,195.58,104.32616,SG,31,493,50,120,0.417,20,67,0.299,7,8,0.875,19,52,71,22,15,10,14,48,127,70,47,1,-40,-81,6,31.1,-115,-83.9,0.4166666666666667,0.29850746268656714,0.875
2020,San Antonio Spurs,Tulsa,DaQuan Jeffries,195.58,104.32616,SG,31,493,50,120,0.417,20,67,0.299,7,8,0.875,19,52,71,22,15,10,14,48,127,70,47,1,-40,-81,6,31.1,-115,-83.9,0.4166666666666667,0.29850746268656714,0.875
2020,San Antonio Spurs,Tulsa,DaQuan Jeffries,195.58,104.32616,SG,31,493,50,120,0.417,20,67,0.299,7,8,0.875,19,52,71,22,15,10,14,48,127,70,47,1,-40,-81,6,31.1,-115,-83.9,0.4166666666666667,0.29850746268656714,0.875
2020,San Antonio Spurs,Tulsa,DaQuan Jeffries,195.58,104.32616,SG,31,493,50,120,0.417,20,67,0.299,7,8,0.875,19,52,71,22,15,10,14,48,127,70,47,1,-40,-81,6,31.1,-115,-83.9,0.4166666666666667,0.29850746268656714,0.875
2020,San Antonio Spurs,Tulsa,DaQuan Jeffries,195.58,104.32616,SG,31,493,50,120,0.417,20,67,0.299,7,8,0.875,19,52,71,22,15,10,14,48,127,70,47,1,-40,-81,6,31.1,-115,-83.9,0.4166666666666667,0.29850746268656714,0.875
2020,San Antonio Spurs,Tulsa,DaQuan Jeffries,195.58,104.32616,SG,31,493,50,120,0.417,20,67,0.299,7,8,0.875,19,52,71,22,15,10,14,48,127,70,47,1,-40,-81,6,31.1,-115,-83.9,0.4166666666666667,0.29850746268656714,0.875
2020,San Antonio Spurs,Tulsa,DaQuan Jeffries,195.58,104.32616,SG,31,493,50,120,0.417,20,67,0.299,7,8,0.875,19,52,71,22,15,10,14,48,127,70,47,1,-40,-81,6,31.1,-115,-83.9,0.4166666666666667,0.29850746268656714,0.875
2020,San Antonio Spurs,Tulsa,DaQuan Jeffries,195.58,104.32616,SG,31,493,50,120,0.417,20,67,0.299,7,8,0.875,19,52,71,22,15,10,14,48,127,70,47,1,-40,-81,6,31.1,-115,-83.9,0.4166666666666667,0.29850746268656714,0.875
2020,San Antonio Spurs,Tulsa,DaQuan Jeffries,195.58,104.32616,SG,31,493,50,120,0.417,20,67,0.299,7,8,0.875,19,52,71,22,15,10,14,48,127,70,47,1,-40,-81,6,31.1,-115,-83.9,0.4166666666666667,0.29850746268656714,0.875
2020,Cleveland Cavaliers,Truman State,Brodric Thomas,195.58,83.91452,SG,32,399,39,108,0.361,16,59,0.271,31,46,0.674,8,45,53,30,15,10,22,40,125,69,43,15,-60,-81,16,22.25,-125,-102.75,0.3611111111111111,0.2711864406779661,0.6739130434782609
2020,Cleveland Cavaliers,Truman State,Brodric Thomas,195.58,83.91452,SG,32,399,39,108,0.361,16,59,0.271,31,46,0.674,8,45,53,30,15,10,22,40,125,69,43,15,-60,-81,16,22.25,-125,-102.75,0.3611111111111111,0.2711864406779661,0.6739130434782609
2020,Cleveland Cavaliers,Truman State,Brodric Thomas,195.58,83.91452,SG,32,399,39,108,0.361,16,59,0.271,31,46,0.674,8,45,53,30,15,10,22,40,125,69,43,15,-60,-81,16,22.25,-125,-102.75,0.3611111111111111,0.2711864406779661,0.6739130434782609
2020,Cleveland Cavaliers,Truman State,Brodric Thomas,195.58,83.91452,SG,32,399,39,108,0.361,16,59,0.271,31,46,0.674,8,45,53,30,15,10,22,40,125,69,43,15,-60,-81,16,22.25,-125,-102.75,0.3611111111111111,0.2711864406779661,0.6739130434782609
2020,Cleveland Cavaliers,Truman State,Brodric Thomas,195.58,83.91452,SG,32,399,39,108,0.361,16,59,0.271,31,46,0.674,8,45,53,30,15,10,22,40,125,69,43,15,-60,-81,16,22.25,-125,-102.75,0.3611111111111111,0.2711864406779661,0.6739130434782609
2020,Cleveland Cavaliers,Truman State,Brodric Thomas,195.58,83.91452,SG,32,399,39,108,0.361,16,59,0.271,31,46,0.674,8,45,53,30,15,10,22,40,125,69,43,15,-60,-81,16,22.25,-125,-102.75,0.3611111111111111,0.2711864406779661,0.6739130434782609
2020,Cleveland Cavaliers,Truman State,Brodric Thomas,195.58,83.91452,SG,32,399,39,108,0.361,16,59,0.271,31,46,0.674,8,45,53,30,15,10,22,40,125,69,43,15,-60,-81,16,22.25,-125,-102.75,0.3611111111111111,0.2711864406779661,0.6739130434782609
2020,Cleveland Cavaliers,Truman State,Brodric Thomas,195.58,83.91452,SG,32,399,39,108,0.361,16,59,0.271,31,46,0.674,8,45,53,30,15,10,22,40,125,69,43,15,-60,-81,16,22.25,-125,-102.75,0.3611111111111111,0.2711864406779661,0.6739130434782609
2020,Cleveland Cavaliers,Truman State,Brodric Thomas,195.58,83.91452,SG,32,399,39,108,0.361,16,59,0.271,31,46,0.674,8,45,53,30,15,10,22,40,125,69,43,15,-60,-81,16,22.25,-125,-102.75,0.3611111111111111,0.2711864406779661,0.6739130434782609
2020,Atlanta Hawks,William & Mary,Nathan Knight,208.28,114.758776,PF,33,279,37,100,0.37,6,33,0.182,44,55,0.8,27,45,72,8,9,10,15,22,124,63,27,11,-52,-63,33,27.65,-82,-54.35,0.37,0.18181818181818182,0.8
2020,Atlanta Hawks,Louisiana State,Skylar Mays,193.04,92.98636,SG,33,269,44,98,0.449,14,40,0.35,22,25,0.88,10,25,35,30,14,2,9,15,124,54,26,3,-20,-36,19,21.5,-37,-15.5,0.4489795918367347,0.35,0.88
2020,Boston Celtics,Purdue,Carsen Edwards,180.34,90.7184,SG,31,276,47,111,0.423,18,63,0.286,11,13,0.846,3,23,26,14,7,1,7,25,123,64,45,2,-34,-81,9,10.0,-106,-96.0,0.42342342342342343,0.2857142857142857,0.8461538461538461
2020,Golden State Warriors,Arizona,Nico Mannion,187.96,86.18248,PG,30,364,39,114,0.342,22,60,0.367,23,28,0.821,6,40,46,70,16,1,31,29,123,75,38,5,-72,-48,18,22.05,-102,-79.95,0.34210526315789475,0.36666666666666664,0.8214285714285714
2020,Los Angeles Lakers,Wisconsin-Green Bay,Alfonzo McKinnie,200.66,97.52228,SF,39,258,48,93,0.516,16,39,0.41,10,18,0.556,22,32,54,6,7,0,5,26,122,45,23,8,6,-21,2,20.2,-13,7.199999999999999,0.5161290322580645,0.41025641025641024,0.5555555555555556
2020,Sacramento Kings,Michigan,Glenn Robinson III,198.12,100.697424,SF,23,369,42,99,0.424,16,44,0.364,21,23,0.913,11,34,45,20,4,3,11,23,121,57,28,2,-30,-36,19,15.85,-47,-31.15,0.42424242424242425,0.36363636363636365,0.9130434782608695
2020,Philadelphia 76ers,Cincinnati,Gary Clark,198.12,102.0582,SF,39,654,40,132,0.303,31,108,0.287,8,10,0.8,33,82,115,31,13,7,17,35,119,92,77,2,-104,-138,6,44.5,-236,-191.5,0.30303030303030304,0.28703703703703703,0.8
2020,Philadelphia 76ers,Cincinnati,Gary Clark,198.12,102.0582,SF,39,654,40,132,0.303,31,108,0.287,8,10,0.8,33,82,115,31,13,7,17,35,119,92,77,2,-104,-138,6,44.5,-236,-191.5,0.30303030303030304,0.28703703703703703,0.8
2020,Philadelphia 76ers,Cincinnati,Gary Clark,198.12,102.0582,SF,39,654,40,132,0.303,31,108,0.287,8,10,0.8,33,82,115,31,13,7,17,35,119,92,77,2,-104,-138,6,44.5,-236,-191.5,0.30303030303030304,0.28703703703703703,0.8
2020,Philadelphia 76ers,Cincinnati,Gary Clark,198.12,102.0582,SF,39,654,40,132,0.303,31,108,0.287,8,10,0.8,33,82,115,31,13,7,17,35,119,92,77,2,-104,-138,6,44.5,-236,-191.5,0.30303030303030304,0.28703703703703703,0.8
2020,Philadelphia 76ers,Cincinnati,Gary Clark,198.12,102.0582,SF,39,654,40,132,0.303,31,108,0.287,8,10,0.8,33,82,115,31,13,7,17,35,119,92,77,2,-104,-138,6,44.5,-236,-191.5,0.30303030303030304,0.28703703703703703,0.8
2020,Philadelphia 76ers,Cincinnati,Gary Clark,198.12,102.0582,SF,39,654,40,132,0.303,31,108,0.287,8,10,0.8,33,82,115,31,13,7,17,35,119,92,77,2,-104,-138,6,44.5,-236,-191.5,0.30303030303030304,0.28703703703703703,0.8
2020,Philadelphia 76ers,Cincinnati,Gary Clark,198.12,102.0582,SF,39,654,40,132,0.303,31,108,0.287,8,10,0.8,33,82,115,31,13,7,17,35,119,92,77,2,-104,-138,6,44.5,-236,-191.5,0.30303030303030304,0.28703703703703703,0.8
2020,Philadelphia 76ers,Cincinnati,Gary Clark,198.12,102.0582,SF,39,654,40,132,0.303,31,108,0.287,8,10,0.8,33,82,115,31,13,7,17,35,119,92,77,2,-104,-138,6,44.5,-236,-191.5,0.30303030303030304,0.28703703703703703,0.8
2020,Philadelphia 76ers,Cincinnati,Gary Clark,198.12,102.0582,SF,39,654,40,132,0.303,31,108,0.287,8,10,0.8,33,82,115,31,13,7,17,35,119,92,77,2,-104,-138,6,44.5,-236,-191.5,0.30303030303030304,0.28703703703703703,0.8
2020,Philadelphia 76ers,Cincinnati,Gary Clark,198.12,102.0582,SF,39,654,40,132,0.303,31,108,0.287,8,10,0.8,33,82,115,31,13,7,17,35,119,92,77,2,-104,-138,6,44.5,-236,-191.5,0.30303030303030304,0.28703703703703703,0.8
2020,Philadelphia 76ers,Cincinnati,Gary Clark,198.12,102.0582,SF,39,654,40,132,0.303,31,108,0.287,8,10,0.8,33,82,115,31,13,7,17,35,119,92,77,2,-104,-138,6,44.5,-236,-191.5,0.30303030303030304,0.28703703703703703,0.8
2020,Philadelphia 76ers,Cincinnati,Gary Clark,198.12,102.0582,SF,39,654,40,132,0.303,31,108,0.287,8,10,0.8,33,82,115,31,13,7,17,35,119,92,77,2,-104,-138,6,44.5,-236,-191.5,0.30303030303030304,0.28703703703703703,0.8
2020,Philadelphia 76ers,Cincinnati,Gary Clark,198.12,102.0582,PF,39,654,40,132,0.303,31,108,0.287,8,10,0.8,33,82,115,31,13,7,17,35,119,92,77,2,-104,-138,6,44.5,-236,-191.5,0.30303030303030304,0.28703703703703703,0.8
2020,Philadelphia 76ers,Cincinnati,Gary Clark,198.12,102.0582,PF,39,654,40,132,0.303,31,108,0.287,8,10,0.8,33,82,115,31,13,7,17,35,119,92,77,2,-104,-138,6,44.5,-236,-191.5,0.30303030303030304,0.28703703703703703,0.8
2020,Philadelphia 76ers,Cincinnati,Gary Clark,198.12,102.0582,PF,39,654,40,132,0.303,31,108,0.287,8,10,0.8,33,82,115,31,13,7,17,35,119,92,77,2,-104,-138,6,44.5,-236,-191.5,0.30303030303030304,0.28703703703703703,0.8
2020,Philadelphia 76ers,Cincinnati,Gary Clark,198.12,102.0582,PF,39,654,40,132,0.303,31,108,0.287,8,10,0.8,33,82,115,31,13,7,17,35,119,92,77,2,-104,-138,6,44.5,-236,-191.5,0.30303030303030304,0.28703703703703703,0.8
2020,Oklahoma City Thunder,Wake Forest,Jaylen Hoard,203.2,97.975872,SF,19,320,44,88,0.5,0,11,0.0,28,41,0.683,21,44,65,24,13,5,17,19,116,44,11,13,0,-33,15,27.05,-18,9.05,0.5,0.0,0.6829268292682927
2020,San Antonio Spurs,Kentucky,Trey Lyles,205.74,106.140528,PF,23,358,43,90,0.478,14,40,0.35,15,23,0.652,9,77,86,14,6,1,6,13,115,47,26,8,-8,-36,7,27.1,-37,-9.899999999999999,0.4777777777777778,0.35,0.6521739130434783
2020,Miami Heat,Southern California,Dewayne Dedmon,213.36,111.13004,C,16,210,46,65,0.708,1,5,0.2,20,27,0.741,28,58,86,12,9,6,13,36,113,19,4,7,54,-9,13,30.7,58,88.7,0.7076923076923077,0.2,0.7407407407407407
2020,Toronto Raptors,Baylor,Freddie Gillespie,205.74,111.13004,PF,20,392,44,84,0.524,0,0,0.0,23,33,0.697,42,55,97,9,13,20,12,43,111,40,0,10,8,0,13,45.35,21,66.35,0.5238095238095238,,0.696969696969697
2020,Toronto Raptors,Fresno State,Paul Watson,198.12,95.25432,SF,27,297,38,82,0.463,30,64,0.469,5,8,0.625,4,41,45,17,6,3,9,36,111,44,34,3,-12,-12,2,14.7,-22,-7.300000000000001,0.4634146341463415,0.46875,0.625
2020,Washington Wizards,Boise State,Chandler Hutchison,198.12,95.25432,SF,25,346,39,103,0.379,8,22,0.364,21,25,0.84,6,72,78,17,12,5,20,33,107,64,14,4,-50,-18,17,22.1,-51,-28.9,0.3786407766990291,0.36363636363636365,0.84
2020,Washington Wizards,Boise State,Chandler Hutchison,198.12,95.25432,SF,25,346,39,103,0.379,8,22,0.364,21,25,0.84,6,72,78,17,12,5,20,33,107,64,14,4,-50,-18,17,22.1,-51,-28.9,0.3786407766990291,0.36363636363636365,0.84
2020,Washington Wizards,Boise State,Chandler Hutchison,198.12,95.25432,SF,25,346,39,103,0.379,8,22,0.364,21,25,0.84,6,72,78,17,12,5,20,33,107,64,14,4,-50,-18,17,22.1,-51,-28.9,0.3786407766990291,0.36363636363636365,0.84
2020,Washington Wizards,Boise State,Chandler Hutchison,198.12,95.25432,SF,25,346,39,103,0.379,8,22,0.364,21,25,0.84,6,72,78,17,12,5,20,33,107,64,14,4,-50,-18,17,22.1,-51,-28.9,0.3786407766990291,0.36363636363636365,0.84
2020,Washington Wizards,Boise State,Chandler Hutchison,198.12,95.25432,SF,25,346,39,103,0.379,8,22,0.364,21,25,0.84,6,72,78,17,12,5,20,33,107,64,14,4,-50,-18,17,22.1,-51,-28.9,0.3786407766990291,0.36363636363636365,0.84
2020,Washington Wizards,Boise State,Chandler Hutchison,198.12,95.25432,SF,25,346,39,103,0.379,8,22,0.364,21,25,0.84,6,72,78,17,12,5,20,33,107,64,14,4,-50,-18,17,22.1,-51,-28.9,0.3786407766990291,0.36363636363636365,0.84
2020,Washington Wizards,Boise State,Chandler Hutchison,198.12,95.25432,SF,25,346,39,103,0.379,8,22,0.364,21,25,0.84,6,72,78,17,12,5,20,33,107,64,14,4,-50,-18,17,22.1,-51,-28.9,0.3786407766990291,0.36363636363636365,0.84
2020,Washington Wizards,Boise State,Chandler Hutchison,198.12,95.25432,SF,25,346,39,103,0.379,8,22,0.364,21,25,0.84,6,72,78,17,12,5,20,33,107,64,14,4,-50,-18,17,22.1,-51,-28.9,0.3786407766990291,0.36363636363636365,0.84
2020,Washington Wizards,Boise State,Chandler Hutchison,198.12,95.25432,SF,25,346,39,103,0.379,8,22,0.364,21,25,0.84,6,72,78,17,12,5,20,33,107,64,14,4,-50,-18,17,22.1,-51,-28.9,0.3786407766990291,0.36363636363636365,0.84
2020,Boston Celtics,Vanderbilt,Luke Kornet,218.44,113.398,C,31,347,44,101,0.436,15,59,0.254,3,6,0.5,14,53,67,24,4,32,7,20,106,57,44,3,-26,-87,0,39.75,-113,-73.25,0.43564356435643564,0.2542372881355932,0.5
2020,Boston Celtics,Vanderbilt,Luke Kornet,218.44,113.398,C,31,347,44,101,0.436,15,59,0.254,3,6,0.5,14,53,67,24,4,32,7,20,106,57,44,3,-26,-87,0,39.75,-113,-73.25,0.43564356435643564,0.2542372881355932,0.5
2020,Boston Celtics,Vanderbilt,Luke Kornet,218.44,113.398,C,31,347,44,101,0.436,15,59,0.254,3,6,0.5,14,53,67,24,4,32,7,20,106,57,44,3,-26,-87,0,39.75,-113,-73.25,0.43564356435643564,0.2542372881355932,0.5
2020,Boston Celtics,Vanderbilt,Luke Kornet,218.44,113.398,C,31,347,44,101,0.436,15,59,0.254,3,6,0.5,14,53,67,24,4,32,7,20,106,57,44,3,-26,-87,0,39.75,-113,-73.25,0.43564356435643564,0.2542372881355932,0.5
2020,Boston Celtics,Vanderbilt,Luke Kornet,218.44,113.398,C,31,347,44,101,0.436,15,59,0.254,3,6,0.5,14,53,67,24,4,32,7,20,106,57,44,3,-26,-87,0,39.75,-113,-73.25,0.43564356435643564,0.2542372881355932,0.5
2020,Boston Celtics,Vanderbilt,Luke Kornet,218.44,113.398,C,31,347,44,101,0.436,15,59,0.254,3,6,0.5,14,53,67,24,4,32,7,20,106,57,44,3,-26,-87,0,39.75,-113,-73.25,0.43564356435643564,0.2542372881355932,0.5
2020,Boston Celtics,Vanderbilt,Luke Kornet,218.44,113.398,C,31,347,44,101,0.436,15,59,0.254,3,6,0.5,14,53,67,24,4,32,7,20,106,57,44,3,-26,-87,0,39.75,-113,-73.25,0.43564356435643564,0.2542372881355932,0.5
2020,Boston Celtics,Vanderbilt,Luke Kornet,218.44,113.398,C,31,347,44,101,0.436,15,59,0.254,3,6,0.5,14,53,67,24,4,32,7,20,106,57,44,3,-26,-87,0,39.75,-113,-73.25,0.43564356435643564,0.2542372881355932,0.5
2020,Boston Celtics,Vanderbilt,Luke Kornet,218.44,113.398,C,31,347,44,101,0.436,15,59,0.254,3,6,0.5,14,53,67,24,4,32,7,20,106,57,44,3,-26,-87,0,39.75,-113,-73.25,0.43564356435643564,0.2542372881355932,0.5
2020,Denver Nuggets,Marquette,Markus Howard,177.8,79.3786,SG,37,205,40,106,0.377,18,65,0.277,7,9,0.778,1,20,21,18,4,1,18,23,105,66,47,2,-52,-87,5,2.3499999999999996,-134,-131.65,0.37735849056603776,0.27692307692307694,0.7777777777777778
2020,Utah Jazz,Yale,Miye Oni,195.58,93.439952,SG,54,519,35,99,0.354,30,88,0.341,5,6,0.833,23,61,84,28,11,8,16,61,105,64,58,1,-58,-84,4,32.2,-138,-105.8,0.35353535353535354,0.3409090909090909,0.8333333333333334
2020,Orlando Magic,Washington,Markelle Fultz,190.5,94.800728,PG,8,215,41,104,0.394,4,16,0.25,17,19,0.895,5,20,25,43,8,2,18,18,103,63,12,2,-44,-24,15,13.35,-53,-39.65,0.3942307692307692,0.25,0.8947368421052632
2020,Chicago Bulls,Wake Forest,Al-Farouq Aminu,203.2,99.79024,PF,23,434,38,99,0.384,8,37,0.216,18,22,0.818,22,88,110,31,19,9,28,29,102,61,29,4,-46,-63,14,39.3,-95,-55.7,0.3838383838383838,0.21621621621621623,0.8181818181818182
2020,Chicago Bulls,Wake Forest,Al-Farouq Aminu,203.2,99.79024,PF,23,434,38,99,0.384,8,37,0.216,18,22,0.818,22,88,110,31,19,9,28,29,102,61,29,4,-46,-63,14,39.3,-95,-55.7,0.3838383838383838,0.21621621621621623,0.8181818181818182
2020,Chicago Bulls,Wake Forest,Al-Farouq Aminu,203.2,99.79024,PF,23,434,38,99,0.384,8,37,0.216,18,22,0.818,22,88,110,31,19,9,28,29,102,61,29,4,-46,-63,14,39.3,-95,-55.7,0.3838383838383838,0.21621621621621623,0.8181818181818182
2020,Chicago Bulls,Wake Forest,Al-Farouq Aminu,203.2,99.79024,PF,23,434,38,99,0.384,8,37,0.216,18,22,0.818,22,88,110,31,19,9,28,29,102,61,29,4,-46,-63,14,39.3,-95,-55.7,0.3838383838383838,0.21621621621621623,0.8181818181818182
2020,Chicago Bulls,Wake Forest,Al-Farouq Aminu,203.2,99.79024,PF,23,434,38,99,0.384,8,37,0.216,18,22,0.818,22,88,110,31,19,9,28,29,102,61,29,4,-46,-63,14,39.3,-95,-55.7,0.3838383838383838,0.21621621621621623,0.8181818181818182
2020,Chicago Bulls,Wake Forest,Al-Farouq Aminu,203.2,99.79024,PF,23,434,38,99,0.384,8,37,0.216,18,22,0.818,22,88,110,31,19,9,28,29,102,61,29,4,-46,-63,14,39.3,-95,-55.7,0.3838383838383838,0.21621621621621623,0.8181818181818182
2020,Chicago Bulls,Wake Forest,Al-Farouq Aminu,203.2,99.79024,PF,23,434,38,99,0.384,8,37,0.216,18,22,0.818,22,88,110,31,19,9,28,29,102,61,29,4,-46,-63,14,39.3,-95,-55.7,0.3838383838383838,0.21621621621621623,0.8181818181818182
2020,Chicago Bulls,Wake Forest,Al-Farouq Aminu,203.2,99.79024,PF,23,434,38,99,0.384,8,37,0.216,18,22,0.818,22,88,110,31,19,9,28,29,102,61,29,4,-46,-63,14,39.3,-95,-55.7,0.3838383838383838,0.21621621621621623,0.8181818181818182
2020,Chicago Bulls,Wake Forest,Al-Farouq Aminu,203.2,99.79024,PF,23,434,38,99,0.384,8,37,0.216,18,22,0.818,22,88,110,31,19,9,28,29,102,61,29,4,-46,-63,14,39.3,-95,-55.7,0.3838383838383838,0.21621621621621623,0.8181818181818182
2020,Dallas Mavericks,Arizona,Josh Green,195.58,90.7184,SG,39,445,42,93,0.452,4,25,0.16,13,23,0.565,28,50,78,28,16,3,17,35,101,51,21,10,-18,-51,3,32.75,-66,-33.25,0.45161290322580644,0.16,0.5652173913043478
2020,Brooklyn Nets,Lamar,Mike James,185.42,79.3786,PG,13,236,34,92,0.37,11,31,0.355,21,27,0.778,3,29,32,54,6,1,20,10,100,58,20,6,-48,-27,15,15.25,-60,-44.75,0.3695652173913043,0.3548387096774194,0.7777777777777778
2020,Boston Celtics,Louisiana State,Tremont Waters,177.8,79.3786,PG,26,238,34,84,0.405,15,38,0.395,16,17,0.941,5,16,21,62,15,1,27,17,99,50,23,1,-32,-24,15,15.65,-41,-25.35,0.40476190476190477,0.39473684210526316,0.9411764705882353
2020,New Orleans Pelicans,Kansas State,Wes Iwundu,198.12,88.45044,SF,41,539,34,102,0.333,5,41,0.122,26,31,0.839,15,75,90,18,15,4,19,49,99,68,36,5,-68,-93,21,28.3,-140,-111.7,0.3333333333333333,0.12195121951219512,0.8387096774193549
2020,New Orleans Pelicans,Kansas State,Wes Iwundu,198.12,88.45044,SF,41,539,34,102,0.333,5,41,0.122,26,31,0.839,15,75,90,18,15,4,19,49,99,68,36,5,-68,-93,21,28.3,-140,-111.7,0.3333333333333333,0.12195121951219512,0.8387096774193549
2020,New Orleans Pelicans,Kansas State,Wes Iwundu,198.12,88.45044,SF,41,539,34,102,0.333,5,41,0.122,26,31,0.839,15,75,90,18,15,4,19,49,99,68,36,5,-68,-93,21,28.3,-140,-111.7,0.3333333333333333,0.12195121951219512,0.8387096774193549
2020,New Orleans Pelicans,Kansas State,Wes Iwundu,198.12,88.45044,SF,41,539,34,102,0.333,5,41,0.122,26,31,0.839,15,75,90,18,15,4,19,49,99,68,36,5,-68,-93,21,28.3,-140,-111.7,0.3333333333333333,0.12195121951219512,0.8387096774193549
2020,New Orleans Pelicans,Kansas State,Wes Iwundu,198.12,88.45044,SF,41,539,34,102,0.333,5,41,0.122,26,31,0.839,15,75,90,18,15,4,19,49,99,68,36,5,-68,-93,21,28.3,-140,-111.7,0.3333333333333333,0.12195121951219512,0.8387096774193549
2020,New Orleans Pelicans,Kansas State,Wes Iwundu,198.12,88.45044,SF,41,539,34,102,0.333,5,41,0.122,26,31,0.839,15,75,90,18,15,4,19,49,99,68,36,5,-68,-93,21,28.3,-140,-111.7,0.3333333333333333,0.12195121951219512,0.8387096774193549
2020,New Orleans Pelicans,Kansas State,Wes Iwundu,198.12,88.45044,SF,41,539,34,102,0.333,5,41,0.122,26,31,0.839,15,75,90,18,15,4,19,49,99,68,36,5,-68,-93,21,28.3,-140,-111.7,0.3333333333333333,0.12195121951219512,0.8387096774193549
2020,New Orleans Pelicans,Kansas State,Wes Iwundu,198.12,88.45044,SF,41,539,34,102,0.333,5,41,0.122,26,31,0.839,15,75,90,18,15,4,19,49,99,68,36,5,-68,-93,21,28.3,-140,-111.7,0.3333333333333333,0.12195121951219512,0.8387096774193549
2020,New Orleans Pelicans,Kansas State,Wes Iwundu,198.12,88.45044,SF,41,539,34,102,0.333,5,41,0.122,26,31,0.839,15,75,90,18,15,4,19,49,99,68,36,5,-68,-93,21,28.3,-140,-111.7,0.3333333333333333,0.12195121951219512,0.8387096774193549
2020,Toronto Raptors,Nevada,Jalen Harris,195.58,88.45044,SG,13,172,36,72,0.5,17,36,0.472,7,9,0.778,3,15,18,17,8,0,14,15,96,36,19,2,0,-6,5,5.75,-1,4.75,0.5,0.4722222222222222,0.7777777777777778
2020,Cleveland Cavaliers,Florida State,Mfiondu Kabengele,205.74,113.398,PF,39,280,33,89,0.371,13,50,0.26,16,20,0.8,12,48,60,17,8,13,15,36,95,56,37,4,-46,-72,12,23.45,-106,-82.55,0.3707865168539326,0.26,0.8
2020,Cleveland Cavaliers,Florida State,Mfiondu Kabengele,205.74,113.398,PF,39,280,33,89,0.371,13,50,0.26,16,20,0.8,12,48,60,17,8,13,15,36,95,56,37,4,-46,-72,12,23.45,-106,-82.55,0.3707865168539326,0.26,0.8
2020,Cleveland Cavaliers,Florida State,Mfiondu Kabengele,205.74,113.398,PF,39,280,33,89,0.371,13,50,0.26,16,20,0.8,12,48,60,17,8,13,15,36,95,56,37,4,-46,-72,12,23.45,-106,-82.55,0.3707865168539326,0.26,0.8
2020,Cleveland Cavaliers,Florida State,Mfiondu Kabengele,205.74,113.398,PF,39,280,33,89,0.371,13,50,0.26,16,20,0.8,12,48,60,17,8,13,15,36,95,56,37,4,-46,-72,12,23.45,-106,-82.55,0.3707865168539326,0.26,0.8
2020,Cleveland Cavaliers,Florida State,Mfiondu Kabengele,205.74,113.398,PF,39,280,33,89,0.371,13,50,0.26,16,20,0.8,12,48,60,17,8,13,15,36,95,56,37,4,-46,-72,12,23.45,-106,-82.55,0.3707865168539326,0.26,0.8
2020,Cleveland Cavaliers,Florida State,Mfiondu Kabengele,205.74,113.398,PF,39,280,33,89,0.371,13,50,0.26,16,20,0.8,12,48,60,17,8,13,15,36,95,56,37,4,-46,-72,12,23.45,-106,-82.55,0.3707865168539326,0.26,0.8
2020,Cleveland Cavaliers,Florida State,Mfiondu Kabengele,205.74,113.398,PF,39,280,33,89,0.371,13,50,0.26,16,20,0.8,12,48,60,17,8,13,15,36,95,56,37,4,-46,-72,12,23.45,-106,-82.55,0.3707865168539326,0.26,0.8
2020,Cleveland Cavaliers,Florida State,Mfiondu Kabengele,205.74,113.398,PF,39,280,33,89,0.371,13,50,0.26,16,20,0.8,12,48,60,17,8,13,15,36,95,56,37,4,-46,-72,12,23.45,-106,-82.55,0.3707865168539326,0.26,0.8
2020,Cleveland Cavaliers,Florida State,Mfiondu Kabengele,205.74,113.398,PF,39,280,33,89,0.371,13,50,0.26,16,20,0.8,12,48,60,17,8,13,15,36,95,56,37,4,-46,-72,12,23.45,-106,-82.55,0.3707865168539326,0.26,0.8
2020,Brooklyn Nets,Missouri State,Alize Johnson,200.66,96.161504,PF,18,189,40,68,0.588,1,6,0.167,13,13,1.0,27,63,90,14,5,5,9,16,94,28,5,0,24,-12,13,32.45,25,57.45,0.5882352941176471,0.16666666666666666,1.0
2020,San Antonio Spurs,Duke,Tre Jones,185.42,83.91452,PG,37,269,37,78,0.474,3,5,0.6,17,19,0.895,8,13,21,39,8,0,13,13,94,41,2,2,-8,3,15,13.85,10,23.85,0.47435897435897434,0.6,0.8947368421052632
2020,Miami Heat,Stanford,KZ Okpala,203.2,97.52228,PF,37,447,36,96,0.375,12,50,0.24,8,15,0.533,21,47,68,19,10,11,15,59,92,60,38,7,-48,-78,1,27.05,-125,-97.95,0.375,0.24,0.5333333333333333
2020,Orlando Magic,Michigan,Ignas Brazdeikis,198.12,100.243832,SF,13,249,35,83,0.422,11,28,0.393,10,14,0.714,11,34,45,17,4,3,12,22,91,48,17,4,-26,-18,6,14.65,-38,-23.35,0.42168674698795183,0.39285714285714285,0.7142857142857143
2020,Orlando Magic,Michigan,Ignas Brazdeikis,198.12,100.243832,SF,13,249,35,83,0.422,11,28,0.393,10,14,0.714,11,34,45,17,4,3,12,22,91,48,17,4,-26,-18,6,14.65,-38,-23.35,0.42168674698795183,0.39285714285714285,0.7142857142857143
2020,Orlando Magic,Michigan,Ignas Brazdeikis,198.12,100.243832,SF,13,249,35,83,0.422,11,28,0.393,10,14,0.714,11,34,45,17,4,3,12,22,91,48,17,4,-26,-18,6,14.65,-38,-23.35,0.42168674698795183,0.39285714285714285,0.7142857142857143
2020,Orlando Magic,Michigan,Ignas Brazdeikis,198.12,100.243832,SF,13,249,35,83,0.422,11,28,0.393,10,14,0.714,11,34,45,17,4,3,12,22,91,48,17,4,-26,-18,6,14.65,-38,-23.35,0.42168674698795183,0.39285714285714285,0.7142857142857143
2020,Orlando Magic,Michigan,Ignas Brazdeikis,198.12,100.243832,SF,13,249,35,83,0.422,11,28,0.393,10,14,0.714,11,34,45,17,4,3,12,22,91,48,17,4,-26,-18,6,14.65,-38,-23.35,0.42168674698795183,0.39285714285714285,0.7142857142857143
2020,Orlando Magic,Michigan,Ignas Brazdeikis,198.12,100.243832,SF,13,249,35,83,0.422,11,28,0.393,10,14,0.714,11,34,45,17,4,3,12,22,91,48,17,4,-26,-18,6,14.65,-38,-23.35,0.42168674698795183,0.39285714285714285,0.7142857142857143
2020,Orlando Magic,Michigan,Ignas Brazdeikis,198.12,100.243832,SF,13,249,35,83,0.422,11,28,0.393,10,14,0.714,11,34,45,17,4,3,12,22,91,48,17,4,-26,-18,6,14.65,-38,-23.35,0.42168674698795183,0.39285714285714285,0.7142857142857143
2020,Orlando Magic,Michigan,Ignas Brazdeikis,198.12,100.243832,SF,13,249,35,83,0.422,11,28,0.393,10,14,0.714,11,34,45,17,4,3,12,22,91,48,17,4,-26,-18,6,14.65,-38,-23.35,0.42168674698795183,0.39285714285714285,0.7142857142857143
2020,Orlando Magic,Michigan,Ignas Brazdeikis,198.12,100.243832,SF,13,249,35,83,0.422,11,28,0.393,10,14,0.714,11,34,45,17,4,3,12,22,91,48,17,4,-26,-18,6,14.65,-38,-23.35,0.42168674698795183,0.39285714285714285,0.7142857142857143
2020,Orlando Magic,Michigan,Ignas Brazdeikis,198.12,100.243832,SF,13,249,35,83,0.422,11,28,0.393,10,14,0.714,11,34,45,17,4,3,12,22,91,48,17,4,-26,-18,6,14.65,-38,-23.35,0.42168674698795183,0.39285714285714285,0.7142857142857143
2020,Orlando Magic,Michigan,Ignas Brazdeikis,198.12,100.243832,SF,13,249,35,83,0.422,11,28,0.393,10,14,0.714,11,34,45,17,4,3,12,22,91,48,17,4,-26,-18,6,14.65,-38,-23.35,0.42168674698795183,0.39285714285714285,0.7142857142857143
2020,Orlando Magic,Michigan,Ignas Brazdeikis,198.12,100.243832,SF,13,249,35,83,0.422,11,28,0.393,10,14,0.714,11,34,45,17,4,3,12,22,91,48,17,4,-26,-18,6,14.65,-38,-23.35,0.42168674698795183,0.39285714285714285,0.7142857142857143
2020,Orlando Magic,Michigan,Ignas Brazdeikis,198.12,100.243832,SF,13,249,35,83,0.422,11,28,0.393,10,14,0.714,11,34,45,17,4,3,12,22,91,48,17,4,-26,-18,6,14.65,-38,-23.35,0.42168674698795183,0.39285714285714285,0.7142857142857143
2020,Orlando Magic,Michigan,Ignas Brazdeikis,198.12,100.243832,SF,13,249,35,83,0.422,11,28,0.393,10,14,0.714,11,34,45,17,4,3,12,22,91,48,17,4,-26,-18,6,14.65,-38,-23.35,0.42168674698795183,0.39285714285714285,0.7142857142857143
2020,Orlando Magic,Michigan,Ignas Brazdeikis,198.12,100.243832,SF,13,249,35,83,0.422,11,28,0.393,10,14,0.714,11,34,45,17,4,3,12,22,91,48,17,4,-26,-18,6,14.65,-38,-23.35,0.42168674698795183,0.39285714285714285,0.7142857142857143
2020,Orlando Magic,Michigan,Ignas Brazdeikis,198.12,100.243832,SF,13,249,35,83,0.422,11,28,0.393,10,14,0.714,11,34,45,17,4,3,12,22,91,48,17,4,-26,-18,6,14.65,-38,-23.35,0.42168674698795183,0.39285714285714285,0.7142857142857143
2020,Detroit Pistons,Kansas State,Rodney McGruder,193.04,92.98636,SG,16,194,37,70,0.529,11,24,0.458,6,8,0.75,8,14,22,16,8,1,7,12,91,33,13,2,8,-6,4,11.9,6,17.9,0.5285714285714286,0.4583333333333333,0.75
2020,New York Knicks,,Frank Ntilikina,193.04,90.7184,PG,33,322,29,79,0.367,23,48,0.479,8,18,0.444,6,25,31,19,18,4,11,45,89,50,25,10,-42,-6,-2,17.25,-50,-32.75,0.3670886075949367,0.4791666666666667,0.4444444444444444
2020,Milwaukee Bucks,Utah State,Sam Merrill,193.04,92.98636,SG,30,233,32,72,0.444,21,47,0.447,4,4,1.0,6,24,30,21,8,1,10,17,89,40,26,0,-16,-15,4,12.9,-27,-14.1,0.4444444444444444,0.44680851063829785,1.0
2020,Brooklyn Nets,Florida,Chris Chiozza,180.34,79.3786,PG,22,232,31,88,0.352,13,42,0.31,13,17,0.765,3,21,24,65,7,6,16,19,88,57,29,4,-52,-48,9,20.55,-91,-70.45,0.3522727272727273,0.30952380952380953,0.7647058823529411
2020,Philadelphia 76ers,DePaul,Paul Reed,205.74,95.25432,PF,26,177,42,78,0.538,0,6,0.0,4,8,0.5,30,31,61,12,10,13,12,29,88,36,6,4,12,-18,0,29.8,-6,23.8,0.5384615384615384,0.0,0.5
2020,Utah Jazz,Florida State,Trent Forrest,193.04,95.25432,PG,30,302,32,71,0.451,5,26,0.192,19,19,1.0,11,33,44,45,9,4,21,22,88,39,21,0,-14,-48,19,19.9,-43,-23.1,0.4507042253521127,0.19230769230769232,1.0
2020,Sacramento Kings,Virginia,Kyle Guy,185.42,75.749864,PG,31,235,29,88,0.33,13,46,0.283,16,20,0.8,5,30,35,32,6,0,11,20,87,59,33,4,-60,-60,12,14.5,-108,-93.5,0.32954545454545453,0.2826086956521739,0.8
2020,Oklahoma City Thunder,,Josh Hall,205.74,86.18248,SF,21,336,30,99,0.303,4,37,0.108,22,44,0.5,6,53,59,28,4,1,25,37,86,69,33,22,-78,-87,0,11.4,-165,-153.6,0.30303030303030304,0.10810810810810811,0.5
2020,Oklahoma City Thunder,,Gabriel Deck,198.12,104.779752,PF,10,212,32,67,0.478,2,15,0.133,18,22,0.818,16,24,40,24,8,0,6,9,84,35,13,4,-6,-33,14,20.55,-25,-4.449999999999999,0.47761194029850745,0.13333333333333333,0.8181818181818182
2020,Washington Wizards,Boston College,Jerome Robinson,193.04,86.18248,SG,17,305,28,95,0.295,11,42,0.262,16,20,0.8,4,34,38,25,12,6,19,31,83,67,31,4,-78,-60,12,14.7,-126,-111.3,0.29473684210526313,0.2619047619047619,0.8
2020,Houston Rockets,Creighton,Khyri Thomas,190.5,95.25432,SG,5,153,32,66,0.485,9,27,0.333,9,9,1.0,7,11,18,25,9,6,6,8,82,34,18,0,-4,-27,9,16.6,-22,-5.399999999999999,0.48484848484848486,0.3333333333333333,1.0
2020,Washington Wizards,Virginia,Anthony Gill,200.66,104.32616,PF,26,218,30,60,0.5,7,24,0.292,13,16,0.813,16,35,51,11,10,4,8,27,80,30,17,3,0,-30,10,21.15,-20,1.1499999999999986,0.5,0.2916666666666667,0.8125
2020,San Antonio Spurs,Ohio State,Keita Bates-Diop,203.2,103.872568,SF,30,245,30,67,0.448,5,17,0.294,14,21,0.667,9,40,49,12,11,5,7,11,79,37,12,7,-14,-21,7,21.45,-28,-6.550000000000001,0.44776119402985076,0.29411764705882354,0.6666666666666666
2020,Washington Wizards,,Isaac Bonga,203.2,81.64656,SF,40,432,30,81,0.37,13,47,0.277,5,8,0.625,18,48,66,23,11,9,22,63,78,51,34,3,-42,-63,2,22.6,-103,-80.4,0.37037037037037035,0.2765957446808511,0.625
2020,Brooklyn Nets,Mississippi State,Reggie Perry,203.2,113.398,PF,26,211,32,78,0.41,4,21,0.19,10,13,0.769,27,46,73,14,6,6,15,40,78,46,17,3,-28,-39,7,25.0,-60,-35.0,0.41025641025641024,0.19047619047619047,0.7692307692307693
2020,Cleveland Cavaliers,Duke,Quinn Cook,185.42,81.64656,PG,23,157,29,68,0.426,11,26,0.423,7,8,0.875,2,15,17,18,4,1,7,10,76,39,15,1,-20,-12,6,7.75,-26,-18.25,0.4264705882352941,0.4230769230769231,0.875
2020,Cleveland Cavaliers,Duke,Quinn Cook,185.42,81.64656,PG,23,157,29,68,0.426,11,26,0.423,7,8,0.875,2,15,17,18,4,1,7,10,76,39,15,1,-20,-12,6,7.75,-26,-18.25,0.4264705882352941,0.4230769230769231,0.875
2020,Cleveland Cavaliers,Duke,Quinn Cook,185.42,81.64656,PG,23,157,29,68,0.426,11,26,0.423,7,8,0.875,2,15,17,18,4,1,7,10,76,39,15,1,-20,-12,6,7.75,-26,-18.25,0.4264705882352941,0.4230769230769231,0.875
2020,Cleveland Cavaliers,Duke,Quinn Cook,185.42,81.64656,PG,23,157,29,68,0.426,11,26,0.423,7,8,0.875,2,15,17,18,4,1,7,10,76,39,15,1,-20,-12,6,7.75,-26,-18.25,0.4264705882352941,0.4230769230769231,0.875
2020,Cleveland Cavaliers,Duke,Quinn Cook,185.42,81.64656,PG,23,157,29,68,0.426,11,26,0.423,7,8,0.875,2,15,17,18,4,1,7,10,76,39,15,1,-20,-12,6,7.75,-26,-18.25,0.4264705882352941,0.4230769230769231,0.875
2020,Cleveland Cavaliers,Duke,Quinn Cook,185.42,81.64656,PG,23,157,29,68,0.426,11,26,0.423,7,8,0.875,2,15,17,18,4,1,7,10,76,39,15,1,-20,-12,6,7.75,-26,-18.25,0.4264705882352941,0.4230769230769231,0.875
2020,Cleveland Cavaliers,Duke,Quinn Cook,185.42,81.64656,PG,23,157,29,68,0.426,11,26,0.423,7,8,0.875,2,15,17,18,4,1,7,10,76,39,15,1,-20,-12,6,7.75,-26,-18.25,0.4264705882352941,0.4230769230769231,0.875
2020,Cleveland Cavaliers,Duke,Quinn Cook,185.42,81.64656,PG,23,157,29,68,0.426,11,26,0.423,7,8,0.875,2,15,17,18,4,1,7,10,76,39,15,1,-20,-12,6,7.75,-26,-18.25,0.4264705882352941,0.4230769230769231,0.875
2020,Cleveland Cavaliers,Duke,Quinn Cook,185.42,81.64656,PG,23,157,29,68,0.426,11,26,0.423,7,8,0.875,2,15,17,18,4,1,7,10,76,39,15,1,-20,-12,6,7.75,-26,-18.25,0.4264705882352941,0.4230769230769231,0.875
2020,Oklahoma City Thunder,Kentucky,Darius Miller,198.12,102.0582,SF,18,197,22,48,0.458,17,42,0.405,12,12,1.0,2,22,24,21,13,5,8,13,73,26,25,0,-8,-24,12,16.1,-20,-3.8999999999999986,0.4583333333333333,0.40476190476190477,1.0
2020,Orlando Magic,Alabama,Donta Hall,208.28,104.32616,PF,13,179,25,35,0.714,0,0,0.0,23,34,0.676,24,38,62,11,5,10,8,18,73,10,0,11,30,0,12,26.85,42,68.85,0.7142857142857143,,0.6764705882352942
2020,Denver Nuggets,Tulsa,Shaquille Harrison,200.66,86.18248,SG,34,332,26,78,0.333,3,16,0.188,18,22,0.818,7,41,48,25,17,5,11,33,73,52,13,4,-52,-30,14,23.85,-68,-44.15,0.3333333333333333,0.1875,0.8181818181818182
2020,Denver Nuggets,Tulsa,Shaquille Harrison,200.66,86.18248,SG,34,332,26,78,0.333,3,16,0.188,18,22,0.818,7,41,48,25,17,5,11,33,73,52,13,4,-52,-30,14,23.85,-68,-44.15,0.3333333333333333,0.1875,0.8181818181818182
2020,Denver Nuggets,Tulsa,Shaquille Harrison,200.66,86.18248,SG,34,332,26,78,0.333,3,16,0.188,18,22,0.818,7,41,48,25,17,5,11,33,73,52,13,4,-52,-30,14,23.85,-68,-44.15,0.3333333333333333,0.1875,0.8181818181818182
2020,Denver Nuggets,Tulsa,Shaquille Harrison,200.66,86.18248,SG,34,332,26,78,0.333,3,16,0.188,18,22,0.818,7,41,48,25,17,5,11,33,73,52,13,4,-52,-30,14,23.85,-68,-44.15,0.3333333333333333,0.1875,0.8181818181818182
2020,Denver Nuggets,Tulsa,Shaquille Harrison,200.66,86.18248,SG,34,332,26,78,0.333,3,16,0.188,18,22,0.818,7,41,48,25,17,5,11,33,73,52,13,4,-52,-30,14,23.85,-68,-44.15,0.3333333333333333,0.1875,0.8181818181818182
2020,Denver Nuggets,Tulsa,Shaquille Harrison,200.66,86.18248,SG,34,332,26,78,0.333,3,16,0.188,18,22,0.818,7,41,48,25,17,5,11,33,73,52,13,4,-52,-30,14,23.85,-68,-44.15,0.3333333333333333,0.1875,0.8181818181818182
2020,Denver Nuggets,Tulsa,Shaquille Harrison,200.66,86.18248,SG,34,332,26,78,0.333,3,16,0.188,18,22,0.818,7,41,48,25,17,5,11,33,73,52,13,4,-52,-30,14,23.85,-68,-44.15,0.3333333333333333,0.1875,0.8181818181818182
2020,Denver Nuggets,Tulsa,Shaquille Harrison,200.66,86.18248,SG,34,332,26,78,0.333,3,16,0.188,18,22,0.818,7,41,48,25,17,5,11,33,73,52,13,4,-52,-30,14,23.85,-68,-44.15,0.3333333333333333,0.1875,0.8181818181818182
2020,Denver Nuggets,Tulsa,Shaquille Harrison,200.66,86.18248,SG,34,332,26,78,0.333,3,16,0.188,18,22,0.818,7,41,48,25,17,5,11,33,73,52,13,4,-52,-30,14,23.85,-68,-44.15,0.3333333333333333,0.1875,0.8181818181818182
2020,Boston Celtics,Duke,Jabari Parker,203.2,111.13004,PF,13,165,30,55,0.545,2,11,0.182,10,13,0.769,10,32,42,11,1,5,10,13,72,25,9,3,10,-21,7,13.1,-4,9.1,0.5454545454545454,0.18181818181818182,0.7692307692307693
2020,Boston Celtics,Duke,Jabari Parker,203.2,111.13004,PF,13,165,30,55,0.545,2,11,0.182,10,13,0.769,10,32,42,11,1,5,10,13,72,25,9,3,10,-21,7,13.1,-4,9.1,0.5454545454545454,0.18181818181818182,0.7692307692307693
2020,Boston Celtics,Duke,Jabari Parker,203.2,111.13004,PF,13,165,30,55,0.545,2,11,0.182,10,13,0.769,10,32,42,11,1,5,10,13,72,25,9,3,10,-21,7,13.1,-4,9.1,0.5454545454545454,0.18181818181818182,0.7692307692307693
2020,Boston Celtics,Duke,Jabari Parker,203.2,111.13004,PF,13,165,30,55,0.545,2,11,0.182,10,13,0.769,10,32,42,11,1,5,10,13,72,25,9,3,10,-21,7,13.1,-4,9.1,0.5454545454545454,0.18181818181818182,0.7692307692307693
2020,Boston Celtics,Duke,Jabari Parker,203.2,111.13004,PF,13,165,30,55,0.545,2,11,0.182,10,13,0.769,10,32,42,11,1,5,10,13,72,25,9,3,10,-21,7,13.1,-4,9.1,0.5454545454545454,0.18181818181818182,0.7692307692307693
2020,Boston Celtics,Duke,Jabari Parker,203.2,111.13004,PF,13,165,30,55,0.545,2,11,0.182,10,13,0.769,10,32,42,11,1,5,10,13,72,25,9,3,10,-21,7,13.1,-4,9.1,0.5454545454545454,0.18181818181818182,0.7692307692307693
2020,Boston Celtics,Duke,Jabari Parker,203.2,111.13004,PF,13,165,30,55,0.545,2,11,0.182,10,13,0.769,10,32,42,11,1,5,10,13,72,25,9,3,10,-21,7,13.1,-4,9.1,0.5454545454545454,0.18181818181818182,0.7692307692307693
2020,Boston Celtics,Duke,Jabari Parker,203.2,111.13004,PF,13,165,30,55,0.545,2,11,0.182,10,13,0.769,10,32,42,11,1,5,10,13,72,25,9,3,10,-21,7,13.1,-4,9.1,0.5454545454545454,0.18181818181818182,0.7692307692307693
2020,Boston Celtics,Duke,Jabari Parker,203.2,111.13004,PF,13,165,30,55,0.545,2,11,0.182,10,13,0.769,10,32,42,11,1,5,10,13,72,25,9,3,10,-21,7,13.1,-4,9.1,0.5454545454545454,0.18181818181818182,0.7692307692307693
2020,New Orleans Pelicans,Kentucky,Wenyen Gabriel,205.74,92.98636,PF,21,241,24,60,0.4,13,32,0.406,11,17,0.647,20,34,54,11,9,8,15,32,72,36,19,6,-24,-18,5,20.65,-37,-16.35,0.4,0.40625,0.6470588235294118
2020,Houston Rockets,Creighton,Justin Patton,210.82,109.315672,C,13,247,29,70,0.414,9,34,0.265,3,4,0.75,14,35,49,14,12,14,4,34,70,41,25,1,-24,-48,2,28.55,-70,-41.45,0.4142857142857143,0.2647058823529412,0.75
2020,Denver Nuggets,Oregon,Bol Bol,218.44,99.79024,PF,32,160,25,58,0.431,9,24,0.375,10,15,0.667,0,24,24,7,3,10,13,14,69,33,15,5,-16,-18,5,7.05,-29,-21.95,0.43103448275862066,0.375,0.6666666666666666
2020,Portland Trail Blazers,Washington State,CJ Elleby,198.12,90.7184,SF,30,192,25,66,0.379,7,34,0.206,11,15,0.733,11,21,32,10,6,3,5,27,68,41,27,4,-32,-60,7,13.9,-85,-71.1,0.3787878787878788,0.20588235294117646,0.7333333333333333
2020,Utah Jazz,College of Charleston,Jarrell Brantley,195.58,113.398,PF,28,138,25,52,0.481,12,28,0.429,2,2,1.0,9,18,27,15,7,2,8,17,64,27,16,0,-4,-12,2,12.4,-14,-1.5999999999999996,0.4807692307692308,0.42857142857142855,1.0
2020,Indiana Pacers,North Carolina State,T.J. Warren,203.2,99.79024,SF,4,117,27,51,0.529,0,7,0.0,8,10,0.8,2,12,14,5,2,0,4,16,62,24,7,2,6,-21,6,3.45,-9,-5.55,0.5294117647058824,0.0,0.8
2020,Memphis Grizzlies,Gonzaga,Killian Tillie,205.74,99.79024,C,18,182,19,57,0.333,10,33,0.303,9,11,0.818,6,18,24,8,5,8,2,20,57,38,23,2,-38,-39,7,14.0,-70,-56.0,0.3333333333333333,0.30303030303030304,0.8181818181818182
2020,Orlando Magic,Tennessee,Jordan Bone,187.96,81.64656,PG,14,196,23,54,0.426,10,32,0.313,0,0,0.0,4,20,24,18,2,0,3,11,56,31,22,0,-16,-36,0,10.45,-52,-41.55,0.42592592592592593,0.3125,
2020,Boston Celtics,Indiana,Romeo Langford,193.04,97.975872,SG,18,283,21,59,0.356,5,18,0.278,9,12,0.75,12,23,35,13,6,5,10,24,56,38,13,3,-34,-24,6,14.3,-52,-37.7,0.3559322033898305,0.2777777777777778,0.75
2020,Los Angeles Clippers,Indiana,Yogi Ferrell,182.88,80.73937600000001,PG,10,137,20,57,0.351,9,28,0.321,7,9,0.778,5,14,19,22,7,3,3,11,56,37,19,2,-34,-30,5,14.45,-59,-44.55,0.3508771929824561,0.32142857142857145,0.7777777777777778
2020,Los Angeles Clippers,Indiana,Yogi Ferrell,182.88,80.73937600000001,PG,10,137,20,57,0.351,9,28,0.321,7,9,0.778,5,14,19,22,7,3,3,11,56,37,19,2,-34,-30,5,14.45,-59,-44.55,0.3508771929824561,0.32142857142857145,0.7777777777777778
2020,Los Angeles Clippers,Indiana,Yogi Ferrell,182.88,80.73937600000001,PG,10,137,20,57,0.351,9,28,0.321,7,9,0.778,5,14,19,22,7,3,3,11,56,37,19,2,-34,-30,5,14.45,-59,-44.55,0.3508771929824561,0.32142857142857145,0.7777777777777778
2020,Los Angeles Clippers,Indiana,Yogi Ferrell,182.88,80.73937600000001,PG,10,137,20,57,0.351,9,28,0.321,7,9,0.778,5,14,19,22,7,3,3,11,56,37,19,2,-34,-30,5,14.45,-59,-44.55,0.3508771929824561,0.32142857142857145,0.7777777777777778
2020,Los Angeles Clippers,Indiana,Yogi Ferrell,182.88,80.73937600000001,PG,10,137,20,57,0.351,9,28,0.321,7,9,0.778,5,14,19,22,7,3,3,11,56,37,19,2,-34,-30,5,14.45,-59,-44.55,0.3508771929824561,0.32142857142857145,0.7777777777777778
2020,Los Angeles Clippers,Indiana,Yogi Ferrell,182.88,80.73937600000001,PG,10,137,20,57,0.351,9,28,0.321,7,9,0.778,5,14,19,22,7,3,3,11,56,37,19,2,-34,-30,5,14.45,-59,-44.55,0.3508771929824561,0.32142857142857145,0.7777777777777778
2020,Los Angeles Clippers,Indiana,Yogi Ferrell,182.88,80.73937600000001,PG,10,137,20,57,0.351,9,28,0.321,7,9,0.778,5,14,19,22,7,3,3,11,56,37,19,2,-34,-30,5,14.45,-59,-44.55,0.3508771929824561,0.32142857142857145,0.7777777777777778
2020,Los Angeles Clippers,Indiana,Yogi Ferrell,182.88,80.73937600000001,PG,10,137,20,57,0.351,9,28,0.321,7,9,0.778,5,14,19,22,7,3,3,11,56,37,19,2,-34,-30,5,14.45,-59,-44.55,0.3508771929824561,0.32142857142857145,0.7777777777777778
2020,Los Angeles Clippers,Indiana,Yogi Ferrell,182.88,80.73937600000001,PG,10,137,20,57,0.351,9,28,0.321,7,9,0.778,5,14,19,22,7,3,3,11,56,37,19,2,-34,-30,5,14.45,-59,-44.55,0.3508771929824561,0.32142857142857145,0.7777777777777778
2020,Los Angeles Clippers,Minnesota,Daniel Oturu,203.2,108.86208,C,30,161,22,52,0.423,1,5,0.2,9,12,0.75,21,27,48,10,4,7,9,24,54,30,4,3,-16,-9,6,19.55,-19,0.5500000000000007,0.4230769230769231,0.2,0.75
2020,Phoenix Suns,Maryland,Jalen Smith,208.28,97.52228,PF,27,156,22,50,0.44,4,17,0.235,5,7,0.714,7,30,37,4,1,4,7,16,53,28,13,2,-12,-27,3,10.2,-36,-25.8,0.44,0.23529411764705882,0.7142857142857143
2020,Atlanta Hawks,Maryland,Bruno Fernando,205.74,108.86208,C,33,226,18,44,0.409,0,2,0.0,15,22,0.682,16,62,78,10,4,3,21,23,51,26,2,7,-16,-6,8,17.85,-14,3.8500000000000014,0.4090909090909091,0.0,0.6818181818181818
2020,Philadelphia 76ers,Purdue,Dakota Mathias,193.04,90.7184,SG,8,123,19,48,0.396,8,26,0.308,2,6,0.333,1,6,7,13,1,3,1,7,48,29,18,4,-20,-30,-2,6.4,-52,-45.6,0.3958333333333333,0.3076923076923077,0.3333333333333333
2020,Minnesota Timberwolves,North Carolina,Ed Davis,205.74,98.883056,C,23,299,19,44,0.432,0,0,0.0,10,12,0.833,46,69,115,21,13,13,7,56,48,25,0,2,-12,0,8,52.2,-4,48.2,0.4318181818181818,,0.8333333333333334
2020,Boston Celtics,Central Florida,Tacko Fall,226.06,141.067112,C,19,136,21,29,0.724,0,0,0.0,5,15,0.333,16,36,52,3,1,20,6,22,47,8,0,10,26,0,-5,24.15,21,45.15,0.7241379310344828,,0.3333333333333333
2020,San Antonio Spurs,Mississippi State,Quinndary Weatherspoon,190.5,92.98636,SG,20,121,16,35,0.457,1,6,0.167,13,16,0.813,3,8,11,8,8,2,10,18,46,19,5,3,-6,-12,10,4.6,-8,-3.4000000000000004,0.45714285714285713,0.16666666666666666,0.8125
2020,Charlotte Hornets,Duke,Vernon Carey Jr.,205.74,122.46984,C,19,115,18,36,0.5,1,7,0.143,9,11,0.818,6,21,27,2,1,5,5,13,46,18,6,2,0,-15,7,8.6,-8,0.5999999999999996,0.5,0.14285714285714285,0.8181818181818182
2020,Sacramento Kings,Oregon,Louis King,200.66,92.98636,SF,6,85,17,34,0.5,4,11,0.364,6,6,1.0,5,13,18,9,7,3,4,9,44,17,7,0,0,-9,6,10.55,-3,7.550000000000001,0.5,0.36363636363636365,1.0
2020,Milwaukee Bucks,Virginia,Mamadi Diakite,205.74,103.418976,PF,14,141,16,40,0.4,1,8,0.125,11,14,0.786,8,26,34,8,6,5,3,16,44,24,7,3,-16,-18,8,15.7,-26,-10.3,0.4,0.125,0.7857142857142857
2020,Houston Rockets,Nevada,Cameron Oliver,203.2,102.0582,SF,4,87,19,33,0.576,4,13,0.308,1,4,0.25,5,16,21,5,2,4,3,11,43,14,9,3,10,-15,-2,8.7,-7,1.6999999999999993,0.5757575757575758,0.3076923076923077,0.25
2020,Orlando Magic,Washington State,Robert Franks,200.66,102.0582,PF,7,101,13,28,0.464,5,15,0.333,12,13,0.923,6,8,14,5,3,3,2,8,43,15,10,1,-4,-15,11,7.85,-8,-0.15000000000000036,0.4642857142857143,0.3333333333333333,0.9230769230769231
2020,Washington Wizards,Michigan State,Cassius Winston,185.42,83.91452,PG,22,98,14,33,0.424,8,17,0.471,5,6,0.833,0,9,9,12,2,1,5,8,41,19,9,1,-10,-3,4,3.85,-9,-5.15,0.42424242424242425,0.47058823529411764,0.8333333333333334
2020,Detroit Pistons,,Deividas Sirvydis,203.2,86.18248,SG,20,133,14,40,0.35,10,28,0.357,3,6,0.5,0,29,29,5,2,0,5,9,41,26,18,3,-24,-24,0,6.55,-48,-41.45,0.35,0.35714285714285715,0.5
2020,Dallas Mavericks,Houston,Nate Hinton,195.58,95.25432,SG,21,93,15,42,0.357,4,19,0.211,7,10,0.7,1,8,9,8,7,2,5,8,41,27,15,3,-24,-33,4,6.1,-53,-46.9,0.35714285714285715,0.21052631578947367,0.7
2020,Orlando Magic,South Carolina,Sindarius Thornwell,193.04,97.52228,SG,21,217,15,46,0.326,7,23,0.304,4,8,0.5,3,15,18,21,13,2,7,15,41,31,16,4,-32,-27,0,13.75,-59,-45.25,0.32608695652173914,0.30434782608695654,0.5
2020,Orlando Magic,South Carolina,Sindarius Thornwell,193.04,97.52228,SG,21,217,15,46,0.326,7,23,0.304,4,8,0.5,3,15,18,21,13,2,7,15,41,31,16,4,-32,-27,0,13.75,-59,-45.25,0.32608695652173914,0.30434782608695654,0.5
2020,Orlando Magic,South Carolina,Sindarius Thornwell,193.04,97.52228,SG,21,217,15,46,0.326,7,23,0.304,4,8,0.5,3,15,18,21,13,2,7,15,41,31,16,4,-32,-27,0,13.75,-59,-45.25,0.32608695652173914,0.30434782608695654,0.5
2020,Orlando Magic,South Carolina,Sindarius Thornwell,193.04,97.52228,SG,21,217,15,46,0.326,7,23,0.304,4,8,0.5,3,15,18,21,13,2,7,15,41,31,16,4,-32,-27,0,13.75,-59,-45.25,0.32608695652173914,0.30434782608695654,0.5
2020,Orlando Magic,South Carolina,Sindarius Thornwell,193.04,97.52228,SG,21,217,15,46,0.326,7,23,0.304,4,8,0.5,3,15,18,21,13,2,7,15,41,31,16,4,-32,-27,0,13.75,-59,-45.25,0.32608695652173914,0.30434782608695654,0.5
2020,Orlando Magic,South Carolina,Sindarius Thornwell,193.04,97.52228,SG,21,217,15,46,0.326,7,23,0.304,4,8,0.5,3,15,18,21,13,2,7,15,41,31,16,4,-32,-27,0,13.75,-59,-45.25,0.32608695652173914,0.30434782608695654,0.5
2020,Orlando Magic,South Carolina,Sindarius Thornwell,193.04,97.52228,SG,21,217,15,46,0.326,7,23,0.304,4,8,0.5,3,15,18,21,13,2,7,15,41,31,16,4,-32,-27,0,13.75,-59,-45.25,0.32608695652173914,0.30434782608695654,0.5
2020,Orlando Magic,South Carolina,Sindarius Thornwell,193.04,97.52228,SG,21,217,15,46,0.326,7,23,0.304,4,8,0.5,3,15,18,21,13,2,7,15,41,31,16,4,-32,-27,0,13.75,-59,-45.25,0.32608695652173914,0.30434782608695654,0.5
2020,Orlando Magic,South Carolina,Sindarius Thornwell,193.04,97.52228,SG,21,217,15,46,0.326,7,23,0.304,4,8,0.5,3,15,18,21,13,2,7,15,41,31,16,4,-32,-27,0,13.75,-59,-45.25,0.32608695652173914,0.30434782608695654,0.5
2020,Oklahoma City Thunder,St. Joseph's (PA),Charlie Brown Jr.,198.12,90.264808,SG,9,152,13,43,0.302,5,21,0.238,9,10,0.9,3,14,17,9,4,2,6,19,40,30,16,1,-34,-33,8,6.3,-59,-52.7,0.3023255813953488,0.23809523809523808,0.9
2020,Sacramento Kings,Texas Tech,Jahmi'us Ramsey,190.5,86.18248,SG,13,94,15,38,0.395,5,19,0.263,5,5,1.0,2,8,10,6,4,1,3,8,40,23,14,0,-16,-27,5,5.1,-38,-32.9,0.39473684210526316,0.2631578947368421,1.0
2020,Los Angeles Lakers,North Carolina-Wilmington,Devontae Cacok,200.66,108.86208,PF,20,98,17,29,0.586,0,0,0.0,5,11,0.455,12,20,32,1,5,4,5,8,39,12,0,6,10,0,-1,12.85,9,21.85,0.5862068965517241,,0.45454545454545453
2020,Memphis Grizzlies,Butler,Sean McDermott,198.12,88.45044,SF,18,158,13,33,0.394,5,22,0.227,8,8,1.0,6,13,19,4,2,3,4,8,39,20,17,0,-14,-36,8,7.35,-42,-34.65,0.3939393939393939,0.22727272727272727,1.0
2020,Indiana Pacers,Duke,Cassius Stanley,195.58,86.18248,SG,24,93,13,43,0.302,3,13,0.231,7,9,0.778,8,12,20,1,1,2,1,14,36,30,10,2,-34,-21,5,7.55,-50,-42.45,0.3023255813953488,0.23076923076923078,0.7777777777777778
2020,Cleveland Cavaliers,St.Mary's College of California,Matthew Dellavedova,190.5,90.7184,PG,13,224,14,56,0.25,4,25,0.16,4,4,1.0,6,18,24,58,4,1,6,21,36,42,21,0,-56,-51,4,20.45,-103,-82.55,0.25,0.16,1.0
2020,Los Angeles Clippers,                                   ,Jay Scrubb,195.58,99.79024,SG,4,84,14,36,0.389,2,9,0.222,5,5,1.0,2,12,14,1,4,0,7,5,35,22,7,0,-16,-15,5,2.5,-26,-23.5,0.3888888888888889,0.2222222222222222,1.0
2020,Utah Jazz,Indiana,Juwan Morgan,200.66,105.233344,PF,29,147,14,30,0.467,4,13,0.308,3,7,0.429,9,19,28,9,4,1,4,21,35,16,9,4,-4,-15,-1,10.95,-20,-9.05,0.4666666666666667,0.3076923076923077,0.42857142857142855
2020,Orlando Magic,Princeton,Devin Cannady,187.96,83.007336,PG,8,74,11,28,0.393,6,16,0.375,6,7,0.857,0,5,5,1,5,1,2,9,34,17,10,1,-12,-12,5,3.05,-19,-15.95,0.39285714285714285,0.375,0.8571428571428571
2020,Philadelphia 76ers,Arkansas-Little Rock,Rayjon Tucker,190.5,94.800728,PG,14,68,9,18,0.5,2,7,0.286,14,19,0.737,1,10,11,6,2,0,4,8,34,9,5,5,0,-9,9,3.1,0,3.1,0.5,0.2857142857142857,0.7368421052631579
2020,Sacramento Kings,South Carolina,Chris Silva,203.2,106.140528,PF,15,92,10,16,0.625,1,1,1.0,11,15,0.733,7,20,27,6,1,6,10,24,32,6,0,4,8,3,7,7.3,18,25.3,0.625,1.0,0.7333333333333333
2020,Sacramento Kings,South Carolina,Chris Silva,203.2,106.140528,PF,15,92,10,16,0.625,1,1,1.0,11,15,0.733,7,20,27,6,1,6,10,24,32,6,0,4,8,3,7,7.3,18,25.3,0.625,1.0,0.7333333333333333
2020,Sacramento Kings,South Carolina,Chris Silva,203.2,106.140528,PF,15,92,10,16,0.625,1,1,1.0,11,15,0.733,7,20,27,6,1,6,10,24,32,6,0,4,8,3,7,7.3,18,25.3,0.625,1.0,0.7333333333333333
2020,Sacramento Kings,South Carolina,Chris Silva,203.2,106.140528,PF,15,92,10,16,0.625,1,1,1.0,11,15,0.733,7,20,27,6,1,6,10,24,32,6,0,4,8,3,7,7.3,18,25.3,0.625,1.0,0.7333333333333333
2020,Sacramento Kings,South Carolina,Chris Silva,203.2,106.140528,PF,15,92,10,16,0.625,1,1,1.0,11,15,0.733,7,20,27,6,1,6,10,24,32,6,0,4,8,3,7,7.3,18,25.3,0.625,1.0,0.7333333333333333
2020,Sacramento Kings,South Carolina,Chris Silva,203.2,106.140528,PF,15,92,10,16,0.625,1,1,1.0,11,15,0.733,7,20,27,6,1,6,10,24,32,6,0,4,8,3,7,7.3,18,25.3,0.625,1.0,0.7333333333333333
2020,Sacramento Kings,South Carolina,Chris Silva,203.2,106.140528,PF,15,92,10,16,0.625,1,1,1.0,11,15,0.733,7,20,27,6,1,6,10,24,32,6,0,4,8,3,7,7.3,18,25.3,0.625,1.0,0.7333333333333333
2020,Sacramento Kings,South Carolina,Chris Silva,203.2,106.140528,PF,15,92,10,16,0.625,1,1,1.0,11,15,0.733,7,20,27,6,1,6,10,24,32,6,0,4,8,3,7,7.3,18,25.3,0.625,1.0,0.7333333333333333
2020,Sacramento Kings,South Carolina,Chris Silva,203.2,106.140528,PF,15,92,10,16,0.625,1,1,1.0,11,15,0.733,7,20,27,6,1,6,10,24,32,6,0,4,8,3,7,7.3,18,25.3,0.625,1.0,0.7333333333333333
2020,Utah Jazz,Syracuse,Elijah Hughes,195.58,97.52228,SF,18,64,10,30,0.333,8,23,0.348,3,4,0.75,1,8,9,6,1,1,6,1,31,20,15,1,-20,-21,2,1.95,-39,-37.05,0.3333333333333333,0.34782608695652173,0.75
2020,Milwaukee Bucks,,Rodions Kurucs,205.74,103.418976,SF,21,125,11,32,0.344,6,21,0.286,3,4,0.75,5,18,23,10,9,4,13,16,31,21,15,1,-20,-27,2,8.7,-45,-36.3,0.34375,0.2857142857142857,0.75
2020,Milwaukee Bucks,,Rodions Kurucs,205.74,103.418976,SF,21,125,11,32,0.344,6,21,0.286,3,4,0.75,5,18,23,10,9,4,13,16,31,21,15,1,-20,-27,2,8.7,-45,-36.3,0.34375,0.2857142857142857,0.75
2020,Milwaukee Bucks,,Rodions Kurucs,205.74,103.418976,SF,21,125,11,32,0.344,6,21,0.286,3,4,0.75,5,18,23,10,9,4,13,16,31,21,15,1,-20,-27,2,8.7,-45,-36.3,0.34375,0.2857142857142857,0.75
2020,Milwaukee Bucks,,Rodions Kurucs,205.74,103.418976,SF,21,125,11,32,0.344,6,21,0.286,3,4,0.75,5,18,23,10,9,4,13,16,31,21,15,1,-20,-27,2,8.7,-45,-36.3,0.34375,0.2857142857142857,0.75
2020,Milwaukee Bucks,,Rodions Kurucs,205.74,103.418976,PF,21,125,11,32,0.344,6,21,0.286,3,4,0.75,5,18,23,10,9,4,13,16,31,21,15,1,-20,-27,2,8.7,-45,-36.3,0.34375,0.2857142857142857,0.75
2020,Milwaukee Bucks,,Rodions Kurucs,205.74,103.418976,PF,21,125,11,32,0.344,6,21,0.286,3,4,0.75,5,18,23,10,9,4,13,16,31,21,15,1,-20,-27,2,8.7,-45,-36.3,0.34375,0.2857142857142857,0.75
2020,Milwaukee Bucks,,Rodions Kurucs,205.74,103.418976,PF,21,125,11,32,0.344,6,21,0.286,3,4,0.75,5,18,23,10,9,4,13,16,31,21,15,1,-20,-27,2,8.7,-45,-36.3,0.34375,0.2857142857142857,0.75
2020,Milwaukee Bucks,,Rodions Kurucs,205.74,103.418976,PF,21,125,11,32,0.344,6,21,0.286,3,4,0.75,5,18,23,10,9,4,13,16,31,21,15,1,-20,-27,2,8.7,-45,-36.3,0.34375,0.2857142857142857,0.75
2020,Milwaukee Bucks,,Rodions Kurucs,205.74,103.418976,SF,21,125,11,32,0.344,6,21,0.286,3,4,0.75,5,18,23,10,9,4,13,16,31,21,15,1,-20,-27,2,8.7,-45,-36.3,0.34375,0.2857142857142857,0.75
2020,Milwaukee Bucks,,Rodions Kurucs,205.74,103.418976,SF,21,125,11,32,0.344,6,21,0.286,3,4,0.75,5,18,23,10,9,4,13,16,31,21,15,1,-20,-27,2,8.7,-45,-36.3,0.34375,0.2857142857142857,0.75
2020,Milwaukee Bucks,,Rodions Kurucs,205.74,103.418976,SF,21,125,11,32,0.344,6,21,0.286,3,4,0.75,5,18,23,10,9,4,13,16,31,21,15,1,-20,-27,2,8.7,-45,-36.3,0.34375,0.2857142857142857,0.75
2020,Milwaukee Bucks,,Rodions Kurucs,205.74,103.418976,SF,21,125,11,32,0.344,6,21,0.286,3,4,0.75,5,18,23,10,9,4,13,16,31,21,15,1,-20,-27,2,8.7,-45,-36.3,0.34375,0.2857142857142857,0.75
2020,Milwaukee Bucks,,Rodions Kurucs,205.74,103.418976,SF,21,125,11,32,0.344,6,21,0.286,3,4,0.75,5,18,23,10,9,4,13,16,31,21,15,1,-20,-27,2,8.7,-45,-36.3,0.34375,0.2857142857142857,0.75
2020,Milwaukee Bucks,,Rodions Kurucs,205.74,103.418976,SF,21,125,11,32,0.344,6,21,0.286,3,4,0.75,5,18,23,10,9,4,13,16,31,21,15,1,-20,-27,2,8.7,-45,-36.3,0.34375,0.2857142857142857,0.75
2020,Milwaukee Bucks,,Rodions Kurucs,205.74,103.418976,SF,21,125,11,32,0.344,6,21,0.286,3,4,0.75,5,18,23,10,9,4,13,16,31,21,15,1,-20,-27,2,8.7,-45,-36.3,0.34375,0.2857142857142857,0.75
2020,Milwaukee Bucks,,Rodions Kurucs,205.74,103.418976,SF,21,125,11,32,0.344,6,21,0.286,3,4,0.75,5,18,23,10,9,4,13,16,31,21,15,1,-20,-27,2,8.7,-45,-36.3,0.34375,0.2857142857142857,0.75
2020,Cleveland Cavaliers,,Thon Maker,213.36,100.243832,C,8,76,10,18,0.556,0,2,0.0,10,11,0.909,8,10,18,4,2,4,3,7,30,8,2,1,4,-6,9,8.65,7,15.65,0.5555555555555556,0.0,0.9090909090909091
2020,Portland Trail Blazers,Arizona,Rondae Hollis-Jefferson,198.12,98.429464,PF,11,107,9,18,0.5,0,1,0.0,9,16,0.563,11,15,26,13,2,4,2,15,27,9,1,7,0,-3,2,13.75,-1,12.75,0.5,0.0,0.5625
2020,Golden State Warriors,Oregon State,Gary Payton II,190.5,88.45044,PG,10,40,10,13,0.769,2,4,0.5,3,4,0.75,2,9,11,1,6,1,1,8,25,3,2,1,14,0,2,6.1,16,22.1,0.7692307692307693,0.5,0.75
2020,Houston Rockets,,Dante Exum,195.58,97.068688,SG,6,116,10,26,0.385,2,11,0.182,1,2,0.5,2,15,17,13,4,2,7,9,23,16,9,1,-12,-21,0,7.05,-33,-25.95,0.38461538461538464,0.18181818181818182,0.5
2020,Chicago Bulls,Kansas,Devon Dotson,187.96,83.91452,PG,11,50,11,21,0.524,1,7,0.143,0,0,0.0,2,3,5,7,4,0,0,3,23,10,6,0,2,-15,0,5.35,-13,-7.65,0.5238095238095238,0.14285714285714285,
2020,New Orleans Pelicans,Washington,Isaiah Thomas,175.26,83.91452,PG,3,48,9,27,0.333,3,12,0.25,2,2,1.0,1,3,4,5,1,0,6,3,23,18,9,0,-18,-18,2,-0.15000000000000002,-34,-34.15,0.3333333333333333,0.25,1.0
2020,Cleveland Cavaliers,Memphis,Jeremiah Martin,187.96,83.91452,PG,9,75,9,33,0.273,3,12,0.25,1,5,0.2,2,5,7,4,5,2,6,1,22,24,9,4,-30,-18,-3,3.7,-51,-47.3,0.2727272727272727,0.25,0.2
2020,Memphis Grizzlies,Missouri,Jontay Porter,210.82,108.86208,PF,11,54,8,15,0.533,3,8,0.375,3,5,0.6,4,10,14,1,3,1,7,12,22,7,5,2,2,-6,1,2.65,-3,-0.3500000000000001,0.5333333333333333,0.375,0.6
2020,Oklahoma City Thunder,Virginia Tech ,Justin Robinson,185.42,88.45044,PG,9,88,7,21,0.333,4,14,0.286,3,5,0.6,1,6,7,9,3,0,2,10,21,14,10,2,-14,-18,1,4.25,-31,-26.75,0.3333333333333333,0.2857142857142857,0.6
2020,New York Knicks,Iona,Norvel Pelle,208.28,104.779752,C,13,83,8,15,0.533,0,0,0.0,4,6,0.667,6,13,19,2,1,9,3,14,20,7,0,2,2,0,2,9.55,4,13.55,0.5333333333333333,,0.6666666666666666
2020,New York Knicks,Iona,Norvel Pelle,208.28,104.779752,C,13,83,8,15,0.533,0,0,0.0,4,6,0.667,6,13,19,2,1,9,3,14,20,7,0,2,2,0,2,9.55,4,13.55,0.5333333333333333,,0.6666666666666666
2020,New York Knicks,Iona,Norvel Pelle,208.28,104.779752,C,13,83,8,15,0.533,0,0,0.0,4,6,0.667,6,13,19,2,1,9,3,14,20,7,0,2,2,0,2,9.55,4,13.55,0.5333333333333333,,0.6666666666666666
2020,New York Knicks,Iona,Norvel Pelle,208.28,104.779752,C,13,83,8,15,0.533,0,0,0.0,4,6,0.667,6,13,19,2,1,9,3,14,20,7,0,2,2,0,2,9.55,4,13.55,0.5333333333333333,,0.6666666666666666
2020,New York Knicks,Iona,Norvel Pelle,208.28,104.779752,C,13,83,8,15,0.533,0,0,0.0,4,6,0.667,6,13,19,2,1,9,3,14,20,7,0,2,2,0,2,9.55,4,13.55,0.5333333333333333,,0.6666666666666666
2020,New York Knicks,Iona,Norvel Pelle,208.28,104.779752,C,13,83,8,15,0.533,0,0,0.0,4,6,0.667,6,13,19,2,1,9,3,14,20,7,0,2,2,0,2,9.55,4,13.55,0.5333333333333333,,0.6666666666666666
2020,New York Knicks,Iona,Norvel Pelle,208.28,104.779752,C,13,83,8,15,0.533,0,0,0.0,4,6,0.667,6,13,19,2,1,9,3,14,20,7,0,2,2,0,2,9.55,4,13.55,0.5333333333333333,,0.6666666666666666
2020,New York Knicks,Iona,Norvel Pelle,208.28,104.779752,C,13,83,8,15,0.533,0,0,0.0,4,6,0.667,6,13,19,2,1,9,3,14,20,7,0,2,2,0,2,9.55,4,13.55,0.5333333333333333,,0.6666666666666666
2020,New York Knicks,Iona,Norvel Pelle,208.28,104.779752,C,13,83,8,15,0.533,0,0,0.0,4,6,0.667,6,13,19,2,1,9,3,14,20,7,0,2,2,0,2,9.55,4,13.55,0.5333333333333333,,0.6666666666666666
2020,New York Knicks,Iona,Norvel Pelle,208.28,104.779752,C,13,83,8,15,0.533,0,0,0.0,4,6,0.667,6,13,19,2,1,9,3,14,20,7,0,2,2,0,2,9.55,4,13.55,0.5333333333333333,,0.6666666666666666
2020,New York Knicks,Iona,Norvel Pelle,208.28,104.779752,C,13,83,8,15,0.533,0,0,0.0,4,6,0.667,6,13,19,2,1,9,3,14,20,7,0,2,2,0,2,9.55,4,13.55,0.5333333333333333,,0.6666666666666666
2020,New York Knicks,Iona,Norvel Pelle,208.28,104.779752,C,13,83,8,15,0.533,0,0,0.0,4,6,0.667,6,13,19,2,1,9,3,14,20,7,0,2,2,0,2,9.55,4,13.55,0.5333333333333333,,0.6666666666666666
2020,New York Knicks,Iona,Norvel Pelle,208.28,104.779752,C,13,83,8,15,0.533,0,0,0.0,4,6,0.667,6,13,19,2,1,9,3,14,20,7,0,2,2,0,2,9.55,4,13.55,0.5333333333333333,,0.6666666666666666
2020,New York Knicks,Iona,Norvel Pelle,208.28,104.779752,C,13,83,8,15,0.533,0,0,0.0,4,6,0.667,6,13,19,2,1,9,3,14,20,7,0,2,2,0,2,9.55,4,13.55,0.5333333333333333,,0.6666666666666666
2020,New York Knicks,Iona,Norvel Pelle,208.28,104.779752,C,13,83,8,15,0.533,0,0,0.0,4,6,0.667,6,13,19,2,1,9,3,14,20,7,0,2,2,0,2,9.55,4,13.55,0.5333333333333333,,0.6666666666666666
2020,New York Knicks,Iona,Norvel Pelle,208.28,104.779752,C,13,83,8,15,0.533,0,0,0.0,4,6,0.667,6,13,19,2,1,9,3,14,20,7,0,2,2,0,2,9.55,4,13.55,0.5333333333333333,,0.6666666666666666
2020,Sacramento Kings,Mississippi State,Robert Woodard II,198.12,106.59412,SF,13,45,8,20,0.4,1,6,0.167,3,8,0.375,4,12,16,2,0,3,1,4,20,12,5,5,-8,-12,-2,6.3,-22,-15.7,0.4,0.16666666666666666,0.375
2020,Brooklyn Nets,Colorado,Spencer Dinwiddie,195.58,97.52228,SG,3,64,6,16,0.375,2,7,0.286,6,6,1.0,0,13,13,9,2,1,5,4,20,10,5,0,-8,-9,6,4.3,-11,-6.7,0.375,0.2857142857142857,1.0
2020,Charlotte Hornets,College of Charleston,Grant Riller,187.96,86.18248,PG,7,27,8,12,0.667,2,4,0.5,0,0,0.0,0,1,1,3,1,0,1,0,18,4,2,0,8,0,0,1.0,8,9.0,0.6666666666666666,0.5,
2020,Dallas Mavericks,Colorado,Tyler Bey,200.66,97.52228,SF,18,71,7,22,0.318,1,4,0.25,3,5,0.6,8,11,19,3,0,1,3,6,18,15,3,2,-16,-6,1,6.2,-21,-14.8,0.3181818181818182,0.25,0.6
2020,Philadelphia 76ers,Creighton,Anthony Tolliver,203.2,108.86208,PF,11,99,4,17,0.235,4,14,0.286,5,6,0.833,3,7,10,2,3,2,3,7,17,13,10,1,-18,-18,4,4.4,-32,-27.6,0.23529411764705882,0.2857142857142857,0.8333333333333334
2020,Houston Rockets,,Bruno Caboclo,205.74,98.883056,PF,6,36,8,17,0.471,0,5,0.0,1,2,0.5,3,11,14,1,0,2,4,6,17,9,5,1,-2,-15,0,3.2,-17,-13.8,0.47058823529411764,0.0,0.5
2020,Milwaukee Bucks,Brigham Young,Elijah Bryant,195.58,95.25432,SG,1,32,6,13,0.462,1,5,0.2,3,3,1.0,2,4,6,3,0,1,4,4,16,7,4,0,-2,-9,3,1.05,-8,-6.95,0.46153846153846156,0.2,1.0
2020,Utah Jazz,Kansas,Udoka Azubuike,208.28,127.00576,C,15,57,4,9,0.444,0,0,0.0,8,10,0.8,4,9,13,0,1,4,3,9,16,5,0,2,-2,0,6,4.8,4,8.8,0.4444444444444444,,0.8
2020,Chicago Bulls,,Adam Mokoka,193.04,86.18248,SG,14,56,7,19,0.368,1,10,0.1,0,1,0.0,1,4,5,5,2,1,5,5,15,12,9,1,-10,-24,-1,1.5,-35,-33.5,0.3684210526315789,0.1,0.0
2020,Toronto Raptors,Marquette,Henry Ellenson,208.28,108.86208,PF,2,38,5,14,0.357,2,9,0.222,3,4,0.75,3,9,12,5,0,0,0,7,15,9,7,1,-8,-15,2,4.65,-21,-16.35,0.35714285714285715,0.2222222222222222,0.75
2020,New Orleans Pelicans,California-Santa Barbara,James Nunnally,200.66,92.98636,SF,9,48,5,13,0.385,4,12,0.333,1,2,0.5,2,7,9,3,0,0,2,1,15,8,8,1,-6,-12,0,2.45,-18,-15.55,0.38461538461538464,0.3333333333333333,0.5
2020,Golden State Warriors,Oregon,Jordan Bell,203.2,97.975872,C,6,82,7,22,0.318,0,2,0.0,1,2,0.5,7,17,24,7,3,5,4,7,15,15,2,1,-16,-6,0,11.15,-22,-10.85,0.3181818181818182,0.0,0.5
2020,Golden State Warriors,Oregon,Jordan Bell,203.2,97.975872,C,6,82,7,22,0.318,0,2,0.0,1,2,0.5,7,17,24,7,3,5,4,7,15,15,2,1,-16,-6,0,11.15,-22,-10.85,0.3181818181818182,0.0,0.5
2020,Golden State Warriors,Oregon,Jordan Bell,203.2,97.975872,C,6,82,7,22,0.318,0,2,0.0,1,2,0.5,7,17,24,7,3,5,4,7,15,15,2,1,-16,-6,0,11.15,-22,-10.85,0.3181818181818182,0.0,0.5
2020,Golden State Warriors,Oregon,Jordan Bell,203.2,97.975872,C,6,82,7,22,0.318,0,2,0.0,1,2,0.5,7,17,24,7,3,5,4,7,15,15,2,1,-16,-6,0,11.15,-22,-10.85,0.3181818181818182,0.0,0.5
2020,Golden State Warriors,Oregon,Jordan Bell,203.2,97.975872,C,6,82,7,22,0.318,0,2,0.0,1,2,0.5,7,17,24,7,3,5,4,7,15,15,2,1,-16,-6,0,11.15,-22,-10.85,0.3181818181818182,0.0,0.5
2020,Golden State Warriors,Oregon,Jordan Bell,203.2,97.975872,C,6,82,7,22,0.318,0,2,0.0,1,2,0.5,7,17,24,7,3,5,4,7,15,15,2,1,-16,-6,0,11.15,-22,-10.85,0.3181818181818182,0.0,0.5
2020,Golden State Warriors,Oregon,Jordan Bell,203.2,97.975872,C,6,82,7,22,0.318,0,2,0.0,1,2,0.5,7,17,24,7,3,5,4,7,15,15,2,1,-16,-6,0,11.15,-22,-10.85,0.3181818181818182,0.0,0.5
2020,Golden State Warriors,Oregon,Jordan Bell,203.2,97.975872,C,6,82,7,22,0.318,0,2,0.0,1,2,0.5,7,17,24,7,3,5,4,7,15,15,2,1,-16,-6,0,11.15,-22,-10.85,0.3181818181818182,0.0,0.5
2020,Golden State Warriors,Oregon,Jordan Bell,203.2,97.975872,C,6,82,7,22,0.318,0,2,0.0,1,2,0.5,7,17,24,7,3,5,4,7,15,15,2,1,-16,-6,0,11.15,-22,-10.85,0.3181818181818182,0.0,0.5
2020,Charlotte Hornets,Kentucky,Nick Richards,213.36,111.13004,PF,18,63,4,9,0.444,0,1,0.0,7,11,0.636,4,7,11,2,0,0,3,7,15,5,1,4,-2,-3,3,2.4,-2,0.3999999999999999,0.4444444444444444,0.0,0.6363636363636364
2020,Milwaukee Bucks,,Axel Toupane,200.66,95.25432,SF,8,61,4,11,0.364,1,2,0.5,5,7,0.714,0,6,6,4,2,3,0,6,14,7,1,2,-6,0,3,4.7,-3,1.7000000000000002,0.36363636363636365,0.5,0.7142857142857143
2020,Indiana Pacers,Connecticut,Amida Brimah,208.28,104.32616,C,5,29,5,8,0.625,0,0,0.0,3,3,1.0,2,6,8,1,0,5,4,4,13,3,0,0,4,0,3,3.05,7,10.05,0.625,,1.0
2020,Golden State Warriors,Washington,Marquese Chriss,205.74,108.86208,PF,2,27,5,14,0.357,1,5,0.2,2,4,0.5,3,10,13,2,0,2,2,3,13,9,4,2,-8,-9,0,4.35,-17,-12.65,0.35714285714285715,0.2,0.5
2020,Portland Trail Blazers,Montana State,Keljin Blevins,193.04,90.7184,SF,17,75,5,20,0.25,2,8,0.25,0,0,0.0,3,7,10,4,2,0,5,8,12,15,6,0,-20,-12,0,2.35,-32,-29.65,0.25,0.25,
2020,Los Angeles Lakers,Dayton,Kostas Antetokounmpo,208.28,90.7184,PF,15,56,3,10,0.3,0,0,0.0,6,13,0.462,4,15,19,1,2,4,11,8,12,7,0,7,-8,0,-1,3.1,-9,-5.9,0.3,,0.46153846153846156
2020,Portland Trail Blazers,UCLA,T.J. Leaf,208.28,100.697424,PF,7,35,5,10,0.5,0,0,0.0,2,2,1.0,0,5,5,1,2,1,2,1,12,5,0,0,0,0,2,1.95,2,3.95,0.5,,1.0
2020,Dallas Mavericks,Stanford,Tyrell Terry,187.96,72.57472,PG,11,56,5,16,0.313,0,7,0.0,1,3,0.333,0,6,6,6,5,0,2,2,11,11,7,2,-12,-21,-1,4.4,-34,-29.6,0.3125,0.0,0.3333333333333333
2020,Miami Heat,Illinois,Meyers Leonard,213.36,117.93392,C,3,29,3,7,0.429,3,7,0.429,1,2,0.5,0,7,7,2,0,0,2,5,10,4,4,1,-2,-3,0,1.0,-5,-4.0,0.42857142857142855,0.42857142857142855,0.5
2020,Charlotte Hornets,Delaware,Nate Darling,198.12,90.7184,SG,7,26,2,7,0.286,2,7,0.286,3,3,1.0,1,0,1,1,0,1,1,1,9,5,5,0,-6,-9,3,0.7,-12,-11.3,0.2857142857142857,0.2857142857142857,1.0
2020,Phoenix Suns,Creighton,Ty-Shon Alexander,190.5,88.45044,SG,15,47,3,12,0.25,2,9,0.222,1,2,0.5,2,8,10,6,0,1,3,2,9,9,7,1,-12,-15,0,3.4,-27,-23.6,0.25,0.2222222222222222,0.5
2020,New Orleans Pelicans,,Didi Louzada,195.58,85.275296,SF,3,56,3,13,0.231,2,8,0.25,0,0,0.0,1,2,3,3,2,0,3,5,8,10,6,0,-14,-12,0,1.0,-26,-25.0,0.23076923076923078,0.25,
2020,Memphis Grizzlies,Penn State,Tim Frazier,182.88,77.11064,PG,5,62,3,20,0.15,0,8,0.0,2,6,0.333,0,8,8,16,2,1,4,7,8,17,8,4,-28,-24,-2,5.15,-54,-48.85,0.15,0.0,0.3333333333333333
2020,Philadelphia 76ers,,Vincent Poirier,213.36,106.59412,C,10,39,3,12,0.25,0,1,0.0,2,6,0.333,6,8,14,2,0,3,4,8,8,9,1,4,-12,-3,-2,4.6,-17,-12.4,0.25,0.0,0.3333333333333333
2020,Cleveland Cavaliers,Duke,Marques Bolden,208.28,112.944408,C,6,29,1,3,0.333,0,0,0.0,5,8,0.625,3,3,6,0,2,2,2,0,7,2,0,3,-2,0,2,3.25,0,3.25,0.3333333333333333,,0.625
2020,Brooklyn Nets,Colorado,Andre Roberson,200.66,95.25432,SG,5,63,2,14,0.143,1,8,0.125,1,2,0.5,7,8,15,4,3,1,2,4,6,12,7,1,-20,-18,0,7.3,-38,-30.7,0.14285714285714285,0.125,0.5
2020,Los Angeles Lakers,Boston College,Jared Dudley,198.12,107.501304,PF,12,81,2,9,0.222,2,6,0.333,0,0,0.0,4,17,21,5,1,1,2,7,6,7,4,0,-10,-6,0,7.15,-16,-8.85,0.2222222222222222,0.3333333333333333,
2020,Indiana Pacers,,Jalen Lecque,193.04,83.91452,PG,4,12,1,9,0.111,0,1,0.0,3,3,1.0,2,3,5,2,0,0,0,0,5,8,1,0,-14,-3,3,2.25,-14,-11.75,0.1111111111111111,0.0,1.0
2020,Atlanta Hawks,Providence,Kris Dunn,190.5,92.98636,PG,4,45,1,12,0.083,0,2,0.0,3,4,0.75,0,6,6,2,2,2,3,10,5,11,2,1,-20,-6,2,2.0,-24,-22.0,0.08333333333333333,0.0,0.75
2020,Toronto Raptors,UNLV,Patrick McCaw,200.66,82.10015200000001,SF,5,33,1,1,1.0,0,0,0.0,3,3,1.0,1,2,3,4,2,0,0,6,5,0,0,0,2,0,3,2.7,5,7.7,1.0,,1.0
2020,Houston Rockets,Louisville,Ray Spalding,205.74,102.0582,C,2,19,2,4,0.5,0,1,0.0,0,2,0.0,2,2,4,0,0,2,3,3,4,2,1,2,0,-3,-2,0.85,-5,-4.15,0.5,0.0,0.0
2020,Miami Heat,Florida,Udonis Haslem,203.2,106.59412,C,1,3,2,2,1.0,0,0,0.0,0,0,0.0,0,1,1,0,0,0,0,0,4,0,0,0,4,0,0,0.25,4,4.25,1.0,,
2020,New York Knicks,Auburn,Jared Harper,177.8,79.3786,PG,8,16,0,4,0.0,0,1,0.0,3,4,0.75,0,2,2,1,0,0,3,1,3,4,1,1,-8,-3,2,-0.8,-9,-9.8,0.0,0.0,0.75
2020,Los Angeles Clippers,,Malik Fitts,203.2,104.32616,PF,3,11,1,3,0.333,1,2,0.5,0,0,0.0,0,3,3,0,0,0,0,3,3,2,1,0,-2,0,0,0.6,-2,-1.4,0.3333333333333333,0.5,
2020,Brooklyn Nets,Georgia Tech,Iman Shumpert,195.58,96.161504,SG,2,11,1,4,0.25,0,3,0.0,0,0,0.0,1,0,1,0,1,0,1,0,2,3,3,0,-4,-9,0,0.5,-13,-12.5,0.25,0.0,
2020,Milwaukee Bucks,St. Bonaventure,Jaylen Adams,182.88,102.0582,PG,7,18,1,8,0.125,0,2,0.0,0,0,0.0,0,3,3,2,0,0,0,1,2,7,2,0,-12,-6,0,1.2,-18,-16.8,0.125,0.0,
2020,Philadelphia 76ers,,Terrance Ferguson,198.12,86.18248,SG,13,49,1,7,0.143,0,5,0.0,0,0,0.0,0,1,1,2,1,0,4,7,2,6,5,0,-10,-15,0,-1.1,-25,-26.1,0.14285714285714285,0.0,
2020,New York Knicks,North Carolina,Theo Pinson,195.58,96.161504,SG,17,34,1,9,0.111,0,8,0.0,0,0,0.0,0,5,5,1,0,0,1,4,2,8,8,0,-14,-24,0,0.8,-38,-37.2,0.1111111111111111,0.0,
2020,Minnesota Timberwolves,Kentucky,Ashton Hagans,190.5,86.18248,PG,2,4,0,0,0.0,0,0,0.0,0,0,0.0,0,0,0,0,0,0,1,0,0,0,0,0,0,0,0,-0.5,0,-0.5,,,
2020,Denver Nuggets,Georgetown,Greg Whittington,203.2,95.25432,PF,4,12,0,3,0.0,0,2,0.0,0,0,0.0,0,0,0,0,0,0,0,0,0,3,2,0,-6,-6,0,0.0,-12,-12.0,0.0,0.0,
2020,Brooklyn Nets,Indiana,Noah Vonleh,208.28,116.573144,C,4,11,0,3,0.0,0,2,0.0,0,0,0.0,0,1,1,1,0,0,2,2,0,3,2,0,-6,-6,0,-0.6,-12,-12.6,0.0,0.0,
2020,New Orleans Pelicans,,Will Magnay,208.28,106.140528,C,1,3,0,1,0.0,0,1,0.0,0,0,0.0,0,0,0,0,0,0,1,1,0,1,1,0,-2,-3,0,-0.55,-5,-5.55,0.0,0.0,
2021,Atlanta Hawks,Oklahoma,Trae Young,185.42,74.389088,PG,76,2652,711,1544,0.46,233,610,0.382,500,553,0.904,50,234,284,737,72,7,303,128,2155,833,377,53,-244,-432,447,149.35,-229,-79.65,0.46049222797927464,0.3819672131147541,0.9041591320072333
2021,Chicago Bulls,Southern California,DeMar DeRozan,198.12,99.79024,PF,76,2743,774,1535,0.504,50,142,0.352,520,593,0.877,56,336,392,374,68,24,181,178,2118,761,92,73,26,-126,447,152.1,347,499.1,0.5042345276872964,0.352112676056338,0.8768971332209107
2021,Philadelphia 76ers,Kansas,Joel Embiid,213.36,127.00576,C,68,2296,666,1334,0.499,93,251,0.371,654,803,0.814,146,650,796,284,77,99,214,181,2079,668,158,149,-4,-195,505,278.45,306,584.45,0.4992503748125937,0.3705179282868526,0.8144458281444583
2021,Boston Celtics,Duke,Jayson Tatum,203.2,95.25432,SF,76,2731,708,1564,0.453,230,651,0.353,400,469,0.853,85,524,609,334,75,49,217,174,2046,856,421,69,-296,-573,331,201.8,-538,-336.2,0.45268542199488493,0.3533026113671275,0.8528784648187633
2021,Milwaukee Bucks,,Giannis Antetokounmpo,210.82,109.769264,PF,67,2204,689,1245,0.553,71,242,0.293,553,766,0.722,134,644,778,388,72,91,219,212,2002,556,171,213,266,-300,340,286.4,306,592.4,0.5534136546184739,0.29338842975206614,0.7219321148825065
2021,Phoenix Suns,Kentucky,Devin Booker,195.58,93.439952,SG,68,2345,662,1421,0.466,183,478,0.383,315,363,0.868,45,297,342,329,77,26,162,180,1822,759,295,48,-194,-336,267,140.5,-263,-122.5,0.46586910626319494,0.38284518828451886,0.8677685950413223
2021,Minnesota Timberwolves,Kentucky,Karl-Anthony Towns,210.82,112.490816,C,74,2475,642,1214,0.529,150,366,0.41,384,467,0.822,194,533,727,269,72,83,226,267,1818,572,216,83,140,-198,301,248.65,243,491.65,0.528830313014827,0.4098360655737705,0.8222698072805139
2021,Utah Jazz,Louisville,Donovan Mitchell,185.42,97.52228,SG,67,2266,617,1376,0.448,232,654,0.355,267,313,0.853,55,227,282,358,99,12,200,164,1733,759,422,46,-284,-570,221,121.05,-633,-511.95,0.4484011627906977,0.3547400611620795,0.853035143769968
2021,Los Angeles Lakers,,LeBron James,205.74,113.398,C,56,2084,640,1221,0.524,161,448,0.359,254,336,0.756,63,396,459,349,73,59,196,121,1695,581,287,82,118,-378,172,179.7,-88,91.69999999999999,0.5241605241605242,0.359375,0.7559523809523809
2021,Brooklyn Nets,Texas-Austin,Kevin Durant,208.28,108.86208,PF,55,2047,578,1115,0.518,115,300,0.383,372,409,0.91,29,378,407,351,48,52,191,113,1643,537,185,37,82,-210,335,145.6,207,352.6,0.5183856502242152,0.38333333333333336,0.9095354523227384
2021,Chicago Bulls,UCLA,Zach LaVine,195.58,90.7184,SG,67,2328,565,1186,0.476,185,475,0.389,320,375,0.853,22,286,308,303,41,23,171,120,1635,621,290,55,-112,-315,265,98.75,-162,-63.25,0.4763912310286678,0.3894736842105263,0.8533333333333334
2021,Golden State Warriors,Davidson,Stephen Curry,187.96,83.91452,PG,64,2211,535,1224,0.437,285,750,0.38,275,298,0.923,34,301,335,404,85,23,206,130,1630,689,465,23,-308,-540,252,137.75,-596,-458.25,0.43709150326797386,0.38,0.9228187919463087
2021,Charlotte Hornets,Michigan State,Miles Bridges,200.66,102.0582,PF,80,2837,596,1214,0.491,154,465,0.331,267,333,0.802,90,469,559,300,74,67,150,193,1613,618,311,66,-44,-471,201,223.1,-314,-90.9,0.49093904448105435,0.3311827956989247,0.8018018018018018
2021,Memphis Grizzlies,Murray State,Ja Morant,190.5,78.92500799999999,PG,57,1889,580,1177,0.493,88,256,0.344,316,415,0.761,77,248,325,384,66,22,196,86,1564,597,168,99,-34,-240,217,138.2,-57,81.19999999999999,0.4927782497875956,0.34375,0.7614457831325301
2021,Boston Celtics,California,Jaylen Brown,198.12,101.151016,SF,66,2220,576,1217,0.473,166,464,0.358,241,318,0.758,53,351,404,231,70,18,178,163,1559,641,298,77,-130,-396,164,118.85,-362,-243.15,0.4732949876746097,0.3577586206896552,0.7578616352201258
2021,Toronto Raptors,New Mexico State,Pascal Siakam,203.2,104.32616,PF,68,2578,596,1207,0.494,75,218,0.344,284,379,0.749,128,452,580,360,85,42,181,225,1551,611,143,95,-30,-204,189,228.75,-45,183.75,0.49378624689312345,0.3440366972477064,0.7493403693931399
2021,Minnesota Timberwolves,Georgia,Anthony Edwards,193.04,102.0582,SG,72,2466,549,1245,0.441,215,602,0.357,220,280,0.786,62,281,343,275,105,46,190,164,1533,696,387,60,-294,-516,160,142.3,-650,-507.7,0.44096385542168676,0.35714285714285715,0.7857142857142857
2021,Charlotte Hornets,,LaMelo Ball,200.66,81.64656,PG,75,2422,538,1254,0.429,220,565,0.389,212,243,0.872,108,393,501,571,119,30,245,237,1508,716,345,31,-356,-375,181,235.15,-550,-314.85,0.42902711323763953,0.3893805309734513,0.8724279835390947
2021,Cleveland Cavaliers,Vanderbilt,Darius Garland,185.42,87.089664,PG,68,2430,542,1173,0.462,174,454,0.383,215,241,0.892,39,185,224,583,89,7,248,115,1473,631,280,26,-178,-318,189,129.75,-307,-177.25,0.4620630861040068,0.3832599118942731,0.8921161825726142
2021,New York Knicks,Kentucky,Julius Randle,203.2,113.398,PF,72,2544,512,1246,0.411,120,390,0.308,303,401,0.756,125,591,716,370,53,39,245,205,1447,734,270,98,-444,-450,205,216.0,-689,-473.0,0.41091492776886035,0.3076923076923077,0.7556109725685786
2021,Los Angeles Lakers,UCLA,Russell Westbrook,190.5,90.7184,PG,78,2678,548,1233,0.444,79,265,0.298,266,399,0.667,110,470,580,550,75,20,295,235,1441,685,186,133,-274,-321,133,198.25,-462,-263.75,0.4444444444444444,0.2981132075471698,0.6666666666666666
2021,San Antonio Spurs,Washington,Dejounte Murray,193.04,81.64656,PG,68,2366,573,1241,0.462,96,294,0.327,196,247,0.794,80,483,563,627,138,23,180,138,1438,668,198,51,-190,-306,145,301.1,-351,-49.89999999999998,0.46172441579371476,0.32653061224489793,0.7935222672064778
2021,Philadelphia 76ers,Arizona State,James Harden,195.58,99.79024,PG,65,2420,407,992,0.41,148,448,0.33,470,536,0.877,55,445,500,667,82,36,284,153,1432,585,300,66,-356,-456,404,214.85,-408,-193.15,0.4102822580645161,0.33035714285714285,0.8768656716417911
2021,Philadelphia 76ers,Arizona State,James Harden,195.58,99.79024,PG,65,2420,407,992,0.41,148,448,0.33,470,536,0.877,55,445,500,667,82,36,284,153,1432,585,300,66,-356,-456,404,214.85,-408,-193.15,0.4102822580645161,0.33035714285714285,0.8768656716417911
2021,Philadelphia 76ers,Arizona State,James Harden,195.58,99.79024,PG,65,2420,407,992,0.41,148,448,0.33,470,536,0.877,55,445,500,667,82,36,284,153,1432,585,300,66,-356,-456,404,214.85,-408,-193.15,0.4102822580645161,0.33035714285714285,0.8768656716417911
2021,Philadelphia 76ers,Arizona State,James Harden,195.58,99.79024,PG,65,2420,407,992,0.41,148,448,0.33,470,536,0.877,55,445,500,667,82,36,284,153,1432,585,300,66,-356,-456,404,214.85,-408,-193.15,0.4102822580645161,0.33035714285714285,0.8768656716417911
2021,Philadelphia 76ers,Arizona State,James Harden,195.58,99.79024,PG,65,2420,407,992,0.41,148,448,0.33,470,536,0.877,55,445,500,667,82,36,284,153,1432,585,300,66,-356,-456,404,214.85,-408,-193.15,0.4102822580645161,0.33035714285714285,0.8768656716417911
2021,Philadelphia 76ers,Arizona State,James Harden,195.58,99.79024,PG,65,2420,407,992,0.41,148,448,0.33,470,536,0.877,55,445,500,667,82,36,284,153,1432,585,300,66,-356,-456,404,214.85,-408,-193.15,0.4102822580645161,0.33035714285714285,0.8768656716417911
2021,Philadelphia 76ers,Arizona State,James Harden,195.58,99.79024,PG,65,2420,407,992,0.41,148,448,0.33,470,536,0.877,55,445,500,667,82,36,284,153,1432,585,300,66,-356,-456,404,214.85,-408,-193.15,0.4102822580645161,0.33035714285714285,0.8768656716417911
2021,Philadelphia 76ers,Arizona State,James Harden,195.58,99.79024,PG,65,2420,407,992,0.41,148,448,0.33,470,536,0.877,55,445,500,667,82,36,284,153,1432,585,300,66,-356,-456,404,214.85,-408,-193.15,0.4102822580645161,0.33035714285714285,0.8768656716417911
2021,Philadelphia 76ers,Arizona State,James Harden,195.58,99.79024,PG,65,2420,407,992,0.41,148,448,0.33,470,536,0.877,55,445,500,667,82,36,284,153,1432,585,300,66,-356,-456,404,214.85,-408,-193.15,0.4102822580645161,0.33035714285714285,0.8768656716417911
2021,Charlotte Hornets,Louisville,Terry Rozier,185.42,86.18248,SG,73,2458,518,1167,0.444,222,593,0.374,150,176,0.852,56,259,315,326,93,25,96,119,1408,649,371,26,-262,-447,124,179.3,-585,-405.7,0.4438731790916881,0.37436762225969644,0.8522727272727273
2021,Golden State Warriors,Michigan,Jordan Poole,193.04,87.996848,SG,76,2283,474,1058,0.448,211,580,0.364,246,266,0.925,34,226,260,304,60,23,187,206,1405,584,369,20,-220,-474,226,87.2,-468,-380.8,0.44801512287334594,0.36379310344827587,0.924812030075188
2021,New York Knicks,Duke,RJ Barrett,198.12,97.068688,SF,70,2417,487,1194,0.408,138,404,0.342,290,406,0.714,66,342,408,208,43,16,151,142,1402,707,266,116,-440,-384,174,117.4,-650,-532.6,0.40787269681742044,0.3415841584158416,0.7142857142857143
2021,Memphis Grizzlies,TCU,Desmond Bane,195.58,97.52228,SG,76,2266,508,1101,0.461,228,523,0.436,140,155,0.903,46,288,334,208,92,29,111,196,1384,593,295,15,-170,-201,125,142.2,-246,-103.80000000000001,0.46139872842870117,0.4359464627151052,0.9032258064516129
2021,Oklahoma City Thunder,Kentucky,Shai Gilgeous-Alexander,198.12,81.64656,PG,56,1942,477,1052,0.453,89,297,0.3,328,405,0.81,37,241,278,331,71,46,154,142,1371,575,208,77,-196,-357,251,135.9,-302,-166.1,0.4534220532319392,0.2996632996632997,0.8098765432098766
2021,New Orleans Pelicans,Lehigh,CJ McCollum,190.5,86.18248,SG,62,2145,536,1164,0.46,182,469,0.388,116,170,0.682,53,216,269,315,70,22,127,121,1370,628,287,54,-184,-315,62,135.7,-437,-301.3,0.46048109965635736,0.3880597014925373,0.6823529411764706
2021,New Orleans Pelicans,Lehigh,CJ McCollum,190.5,86.18248,SG,62,2145,536,1164,0.46,182,469,0.388,116,170,0.682,53,216,269,315,70,22,127,121,1370,628,287,54,-184,-315,62,135.7,-437,-301.3,0.46048109965635736,0.3880597014925373,0.6823529411764706
2021,New Orleans Pelicans,Lehigh,CJ McCollum,190.5,86.18248,SG,62,2145,536,1164,0.46,182,469,0.388,116,170,0.682,53,216,269,315,70,22,127,121,1370,628,287,54,-184,-315,62,135.7,-437,-301.3,0.46048109965635736,0.3880597014925373,0.6823529411764706
2021,New Orleans Pelicans,Lehigh,CJ McCollum,190.5,86.18248,SG,62,2145,536,1164,0.46,182,469,0.388,116,170,0.682,53,216,269,315,70,22,127,121,1370,628,287,54,-184,-315,62,135.7,-437,-301.3,0.46048109965635736,0.3880597014925373,0.6823529411764706
2021,New Orleans Pelicans,Lehigh,CJ McCollum,190.5,86.18248,SG,62,2145,536,1164,0.46,182,469,0.388,116,170,0.682,53,216,269,315,70,22,127,121,1370,628,287,54,-184,-315,62,135.7,-437,-301.3,0.46048109965635736,0.3880597014925373,0.6823529411764706
2021,New Orleans Pelicans,Lehigh,CJ McCollum,190.5,86.18248,SG,62,2145,536,1164,0.46,182,469,0.388,116,170,0.682,53,216,269,315,70,22,127,121,1370,628,287,54,-184,-315,62,135.7,-437,-301.3,0.46048109965635736,0.3880597014925373,0.6823529411764706
2021,New Orleans Pelicans,Lehigh,CJ McCollum,190.5,86.18248,PG,62,2145,536,1164,0.46,182,469,0.388,116,170,0.682,53,216,269,315,70,22,127,121,1370,628,287,54,-184,-315,62,135.7,-437,-301.3,0.46048109965635736,0.3880597014925373,0.6823529411764706
2021,New Orleans Pelicans,Lehigh,CJ McCollum,190.5,86.18248,PG,62,2145,536,1164,0.46,182,469,0.388,116,170,0.682,53,216,269,315,70,22,127,121,1370,628,287,54,-184,-315,62,135.7,-437,-301.3,0.46048109965635736,0.3880597014925373,0.6823529411764706
2021,New Orleans Pelicans,Lehigh,CJ McCollum,190.5,86.18248,PG,62,2145,536,1164,0.46,182,469,0.388,116,170,0.682,53,216,269,315,70,22,127,121,1370,628,287,54,-184,-315,62,135.7,-437,-301.3,0.46048109965635736,0.3880597014925373,0.6823529411764706
2021,Sacramento Kings,Kentucky,De'Aaron Fox,190.5,83.91452,PG,59,2083,516,1092,0.473,74,249,0.297,261,348,0.75,25,206,231,330,68,25,168,172,1367,576,175,87,-120,-303,174,100.4,-249,-148.6,0.4725274725274725,0.2971887550200803,0.75
2021,Miami Heat,Kentucky,Tyler Herro,195.58,88.45044,SG,66,2151,501,1122,0.447,175,439,0.399,190,219,0.868,32,297,329,263,44,8,174,95,1367,621,264,29,-240,-267,161,90.25,-346,-255.75,0.446524064171123,0.39863325740318906,0.867579908675799
2021,Milwaukee Bucks,Texas A&M,Khris Middleton,200.66,100.697424,SF,66,2141,452,1021,0.443,162,434,0.373,259,291,0.89,41,315,356,358,76,18,190,160,1325,569,272,32,-234,-330,227,132.75,-337,-204.25,0.4427032321253673,0.37327188940092165,0.8900343642611683
2021,Detroit Pistons,Villanova,Saddiq Bey,200.66,97.52228,SF,82,2704,450,1136,0.396,211,610,0.346,210,254,0.827,107,334,441,233,73,16,96,128,1321,686,399,44,-472,-564,166,185.35,-870,-684.65,0.3961267605633803,0.34590163934426227,0.8267716535433071
2021,Toronto Raptors,Wichita State,Fred VanVleet,185.42,89.357624,PG,65,2462,442,1097,0.403,242,642,0.377,194,222,0.874,44,245,289,434,111,35,170,162,1320,655,400,28,-426,-474,166,171.65,-734,-562.35,0.4029170464904284,0.37694704049844235,0.8738738738738738
2021,Philadelphia 76ers,Kentucky,Tyrese Maxey,187.96,90.7184,PG,75,2650,483,995,0.485,132,309,0.427,213,246,0.866,26,214,240,321,55,32,88,156,1311,512,177,33,-58,-135,180,138.45,-13,125.44999999999999,0.48542713567839196,0.42718446601941745,0.8658536585365854
2021,Dallas Mavericks,Villanova,Jalen Brunson,185.42,86.18248,SG,79,2524,506,1008,0.502,94,252,0.373,179,213,0.84,43,266,309,377,66,3,124,151,1285,502,158,34,8,-192,145,147.2,-39,108.19999999999999,0.501984126984127,0.373015873015873,0.8403755868544601
2021,Toronto Raptors,Duke,Gary Trent Jr.,195.58,94.800728,SG,70,2448,450,1086,0.414,209,545,0.383,174,204,0.853,26,165,191,141,122,19,73,144,1283,636,336,30,-372,-381,144,116.3,-609,-492.7,0.4143646408839779,0.3834862385321101,0.8529411764705882
2021,San Antonio Spurs,Kentucky,Keldon Johnson,198.12,99.79024,SF,75,2392,471,1011,0.466,159,399,0.398,177,234,0.756,80,377,457,158,58,14,92,148,1278,540,240,57,-138,-243,120,156.35,-261,-104.65,0.4658753709198813,0.39849624060150374,0.7564102564102564
2021,Memphis Grizzlies,Michigan State,Jaren Jackson Jr.,210.82,109.769264,PF,78,2126,430,1036,0.415,128,401,0.319,284,345,0.823,119,335,454,86,73,177,130,272,1272,606,273,61,-352,-435,223,211.15,-564,-352.85,0.41505791505791506,0.3192019950124688,0.8231884057971014
2021,Utah Jazz,Missouri,Jordan Clarkson,193.04,87.996848,SG,79,2141,466,1113,0.419,190,597,0.318,144,174,0.828,67,206,273,194,66,16,129,149,1266,647,407,30,-362,-651,114,102.55,-899,-796.45,0.41868823000898475,0.31825795644891125,0.8275862068965517
2021,Indiana Pacers,Oklahoma,Buddy Hield,193.04,99.79024,SG,81,2499,446,1098,0.406,262,716,0.366,111,127,0.874,66,287,353,229,73,25,153,184,1265,652,454,16,-412,-576,95,125.3,-893,-767.7,0.40619307832422585,0.3659217877094972,0.8740157480314961
2021,Indiana Pacers,Oklahoma,Buddy Hield,193.04,99.79024,SG,81,2499,446,1098,0.406,262,716,0.366,111,127,0.874,66,287,353,229,73,25,153,184,1265,652,454,16,-412,-576,95,125.3,-893,-767.7,0.40619307832422585,0.3659217877094972,0.8740157480314961
2021,Indiana Pacers,Oklahoma,Buddy Hield,193.04,99.79024,SG,81,2499,446,1098,0.406,262,716,0.366,111,127,0.874,66,287,353,229,73,25,153,184,1265,652,454,16,-412,-576,95,125.3,-893,-767.7,0.40619307832422585,0.3659217877094972,0.8740157480314961
2021,Indiana Pacers,Oklahoma,Buddy Hield,193.04,99.79024,SG,81,2499,446,1098,0.406,262,716,0.366,111,127,0.874,66,287,353,229,73,25,153,184,1265,652,454,16,-412,-576,95,125.3,-893,-767.7,0.40619307832422585,0.3659217877094972,0.8740157480314961
2021,Indiana Pacers,Oklahoma,Buddy Hield,193.04,99.79024,SG,81,2499,446,1098,0.406,262,716,0.366,111,127,0.874,66,287,353,229,73,25,153,184,1265,652,454,16,-412,-576,95,125.3,-893,-767.7,0.40619307832422585,0.3659217877094972,0.8740157480314961
2021,Indiana Pacers,Oklahoma,Buddy Hield,193.04,99.79024,SG,81,2499,446,1098,0.406,262,716,0.366,111,127,0.874,66,287,353,229,73,25,153,184,1265,652,454,16,-412,-576,95,125.3,-893,-767.7,0.40619307832422585,0.3659217877094972,0.8740157480314961
2021,Indiana Pacers,Oklahoma,Buddy Hield,193.04,99.79024,SG,81,2499,446,1098,0.406,262,716,0.366,111,127,0.874,66,287,353,229,73,25,153,184,1265,652,454,16,-412,-576,95,125.3,-893,-767.7,0.40619307832422585,0.3659217877094972,0.8740157480314961
2021,Indiana Pacers,Oklahoma,Buddy Hield,193.04,99.79024,SG,81,2499,446,1098,0.406,262,716,0.366,111,127,0.874,66,287,353,229,73,25,153,184,1265,652,454,16,-412,-576,95,125.3,-893,-767.7,0.40619307832422585,0.3659217877094972,0.8740157480314961
2021,Indiana Pacers,Oklahoma,Buddy Hield,193.04,99.79024,SG,81,2499,446,1098,0.406,262,716,0.366,111,127,0.874,66,287,353,229,73,25,153,184,1265,652,454,16,-412,-576,95,125.3,-893,-767.7,0.40619307832422585,0.3659217877094972,0.8740157480314961
2021,Sacramento Kings,North Carolina,Harrison Barnes,203.2,102.0582,PF,77,2587,391,834,0.469,142,360,0.394,341,413,0.826,82,350,432,186,53,14,118,94,1265,443,218,72,-104,-228,269,144.8,-63,81.80000000000001,0.46882494004796166,0.39444444444444443,0.8256658595641646
2021,Los Angeles Clippers,Boston College,Reggie Jackson,187.96,94.347136,SG,75,2337,479,1222,0.392,167,512,0.326,138,163,0.847,39,232,271,359,55,15,173,159,1263,743,345,25,-528,-534,113,107.8,-949,-841.2,0.39198036006546644,0.326171875,0.8466257668711656
2021,Philadelphia 76ers,Tennessee,Tobias Harris,200.66,102.511792,PF,73,2543,493,1022,0.482,101,275,0.367,170,202,0.842,77,419,496,252,47,43,116,164,1257,529,174,32,-72,-219,138,185.05,-153,32.05000000000001,0.48238747553816047,0.36727272727272725,0.8415841584158416
2021,Golden State Warriors,Kansas,Andrew Wiggins,200.66,89.357624,SF,73,2330,475,1019,0.466,157,399,0.393,149,235,0.634,85,240,325,161,76,51,111,158,1256,544,242,86,-138,-255,63,142.85,-330,-187.15,0.4661432777232581,0.39348370927318294,0.6340425531914894
2021,New Orleans Pelicans,Duke,Brandon Ingram,203.2,86.18248,SF,55,1869,453,983,0.461,74,226,0.327,266,322,0.826,35,285,320,307,34,26,151,119,1246,530,152,56,-154,-234,210,114.05,-178,-63.95,0.46083418107833163,0.3274336283185841,0.8260869565217391
2021,Milwaukee Bucks,UCLA,Jrue Holiday,190.5,92.98636,PG,67,2207,478,954,0.501,132,321,0.411,137,180,0.761,69,232,301,457,108,29,183,133,1225,476,189,43,4,-171,94,177.1,-73,104.1,0.5010482180293501,0.411214953271028,0.7611111111111111
2021,Miami Heat,Marquette,Jimmy Butler,200.66,104.32616,SF,57,1931,398,829,0.48,27,116,0.233,396,455,0.87,102,234,336,312,94,27,121,88,1219,431,89,59,-66,-186,337,183.1,85,268.1,0.48009650180940894,0.23275862068965517,0.8703296703296703
2021,Houston Rockets,UNLV,Christian Wood,205.74,97.068688,C,68,2094,440,878,0.501,131,336,0.39,207,332,0.623,110,576,686,155,54,65,126,171,1218,438,205,125,4,-222,82,225.7,-136,89.69999999999999,0.5011389521640092,0.3898809523809524,0.6234939759036144
2021,Orlando Magic,Michigan,Franz Wagner,208.28,99.79024,SF,79,2429,456,975,0.468,96,271,0.354,189,219,0.863,84,272,356,231,68,34,119,164,1197,519,175,30,-126,-237,159,151.05,-204,-52.94999999999999,0.4676923076923077,0.35424354243542433,0.863013698630137
2021,Indiana Pacers,Iowa State,Tyrese Haliburton,195.58,83.91452,SG,77,2694,430,909,0.473,161,389,0.414,160,190,0.842,61,250,311,628,134,49,199,121,1181,479,228,30,-98,-201,130,235.95,-169,66.94999999999999,0.4730473047304731,0.4138817480719794,0.8421052631578947
2021,Indiana Pacers,Iowa State,Tyrese Haliburton,195.58,83.91452,SG,77,2694,430,909,0.473,161,389,0.414,160,190,0.842,61,250,311,628,134,49,199,121,1181,479,228,30,-98,-201,130,235.95,-169,66.94999999999999,0.4730473047304731,0.4138817480719794,0.8421052631578947
2021,Indiana Pacers,Iowa State,Tyrese Haliburton,195.58,83.91452,SG,77,2694,430,909,0.473,161,389,0.414,160,190,0.842,61,250,311,628,134,49,199,121,1181,479,228,30,-98,-201,130,235.95,-169,66.94999999999999,0.4730473047304731,0.4138817480719794,0.8421052631578947
2021,Indiana Pacers,Iowa State,Tyrese Haliburton,195.58,83.91452,SG,77,2694,430,909,0.473,161,389,0.414,160,190,0.842,61,250,311,628,134,49,199,121,1181,479,228,30,-98,-201,130,235.95,-169,66.94999999999999,0.4730473047304731,0.4138817480719794,0.8421052631578947
2021,Indiana Pacers,Iowa State,Tyrese Haliburton,195.58,83.91452,SG,77,2694,430,909,0.473,161,389,0.414,160,190,0.842,61,250,311,628,134,49,199,121,1181,479,228,30,-98,-201,130,235.95,-169,66.94999999999999,0.4730473047304731,0.4138817480719794,0.8421052631578947
2021,Indiana Pacers,Iowa State,Tyrese Haliburton,195.58,83.91452,SG,77,2694,430,909,0.473,161,389,0.414,160,190,0.842,61,250,311,628,134,49,199,121,1181,479,228,30,-98,-201,130,235.95,-169,66.94999999999999,0.4730473047304731,0.4138817480719794,0.8421052631578947
2021,Indiana Pacers,Iowa State,Tyrese Haliburton,195.58,83.91452,PG,77,2694,430,909,0.473,161,389,0.414,160,190,0.842,61,250,311,628,134,49,199,121,1181,479,228,30,-98,-201,130,235.95,-169,66.94999999999999,0.4730473047304731,0.4138817480719794,0.8421052631578947
2021,Indiana Pacers,Iowa State,Tyrese Haliburton,195.58,83.91452,PG,77,2694,430,909,0.473,161,389,0.414,160,190,0.842,61,250,311,628,134,49,199,121,1181,479,228,30,-98,-201,130,235.95,-169,66.94999999999999,0.4730473047304731,0.4138817480719794,0.8421052631578947
2021,Indiana Pacers,Iowa State,Tyrese Haliburton,195.58,83.91452,PG,77,2694,430,909,0.473,161,389,0.414,160,190,0.842,61,250,311,628,134,49,199,121,1181,479,228,30,-98,-201,130,235.95,-169,66.94999999999999,0.4730473047304731,0.4138817480719794,0.8421052631578947
2021,Minnesota Timberwolves,Ohio State,D'Angelo Russell,193.04,87.543256,PG,65,2077,401,975,0.411,176,518,0.34,198,240,0.825,25,191,216,460,62,22,165,130,1176,574,342,42,-346,-498,156,128.25,-688,-559.75,0.4112820512820513,0.33976833976833976,0.825
2021,Sacramento Kings,Gonzaga,Domantas Sabonis,210.82,108.86208,PF,62,2136,443,773,0.573,39,125,0.312,246,332,0.741,201,551,752,323,59,27,195,203,1171,330,86,86,226,-141,160,254.35,245,499.35,0.5730918499353169,0.312,0.7409638554216867
2021,Sacramento Kings,Gonzaga,Domantas Sabonis,210.82,108.86208,PF,62,2136,443,773,0.573,39,125,0.312,246,332,0.741,201,551,752,323,59,27,195,203,1171,330,86,86,226,-141,160,254.35,245,499.35,0.5730918499353169,0.312,0.7409638554216867
2021,Sacramento Kings,Gonzaga,Domantas Sabonis,210.82,108.86208,PF,62,2136,443,773,0.573,39,125,0.312,246,332,0.741,201,551,752,323,59,27,195,203,1171,330,86,86,226,-141,160,254.35,245,499.35,0.5730918499353169,0.312,0.7409638554216867
2021,Sacramento Kings,Gonzaga,Domantas Sabonis,210.82,108.86208,PF,62,2136,443,773,0.573,39,125,0.312,246,332,0.741,201,551,752,323,59,27,195,203,1171,330,86,86,226,-141,160,254.35,245,499.35,0.5730918499353169,0.312,0.7409638554216867
2021,Sacramento Kings,Gonzaga,Domantas Sabonis,210.82,108.86208,PF,62,2136,443,773,0.573,39,125,0.312,246,332,0.741,201,551,752,323,59,27,195,203,1171,330,86,86,226,-141,160,254.35,245,499.35,0.5730918499353169,0.312,0.7409638554216867
2021,Sacramento Kings,Gonzaga,Domantas Sabonis,210.82,108.86208,PF,62,2136,443,773,0.573,39,125,0.312,246,332,0.741,201,551,752,323,59,27,195,203,1171,330,86,86,226,-141,160,254.35,245,499.35,0.5730918499353169,0.312,0.7409638554216867
2021,Sacramento Kings,Gonzaga,Domantas Sabonis,210.82,108.86208,PF,62,2136,443,773,0.573,39,125,0.312,246,332,0.741,201,551,752,323,59,27,195,203,1171,330,86,86,226,-141,160,254.35,245,499.35,0.5730918499353169,0.312,0.7409638554216867
2021,Sacramento Kings,Gonzaga,Domantas Sabonis,210.82,108.86208,PF,62,2136,443,773,0.573,39,125,0.312,246,332,0.741,201,551,752,323,59,27,195,203,1171,330,86,86,226,-141,160,254.35,245,499.35,0.5730918499353169,0.312,0.7409638554216867
2021,Sacramento Kings,Gonzaga,Domantas Sabonis,210.82,108.86208,PF,62,2136,443,773,0.573,39,125,0.312,246,332,0.741,201,551,752,323,59,27,195,203,1171,330,86,86,226,-141,160,254.35,245,499.35,0.5730918499353169,0.312,0.7409638554216867
2021,Phoenix Suns,Villanova,Mikal Bridges,198.12,94.800728,SF,82,2854,458,858,0.534,115,312,0.369,131,157,0.834,74,273,347,185,96,36,68,150,1162,400,197,26,116,-246,105,176.0,-25,151.0,0.5337995337995338,0.3685897435897436,0.8343949044585988
2021,Houston Rockets,,Jalen Green,193.04,84.368112,SG,67,2138,406,954,0.426,157,458,0.343,188,236,0.797,33,193,226,176,44,18,135,103,1157,548,301,48,-284,-432,140,67.1,-576,-508.9,0.42557651991614254,0.34279475982532753,0.7966101694915254
2021,Charlotte Hornets,Kansas,Kelly Oubre Jr.,198.12,92.079176,SF,76,1999,410,932,0.44,191,553,0.345,126,189,0.667,79,223,302,84,77,31,67,189,1137,522,362,63,-224,-513,63,127.3,-674,-546.7,0.43991416309012876,0.3453887884267631,0.6666666666666666
2021,Toronto Raptors,Florida State,Scottie Barnes,200.66,102.0582,PF,74,2617,459,932,0.492,58,193,0.301,158,215,0.735,195,362,557,256,80,55,136,192,1134,473,135,57,-28,-231,101,241.9,-158,83.9,0.4924892703862661,0.3005181347150259,0.7348837209302326
2021,Washington Wizards,Utah,Kyle Kuzma,205.74,100.243832,PF,66,2204,423,936,0.452,128,375,0.341,156,219,0.712,70,491,561,233,42,57,169,128,1130,513,247,63,-180,-357,93,174.6,-444,-269.4,0.4519230769230769,0.3413333333333333,0.7123287671232876
2021,Denver Nuggets,Arizona,Aaron Gordon,203.2,106.59412,PF,75,2375,434,834,0.52,87,260,0.335,171,230,0.743,125,314,439,188,44,44,133,148,1126,400,173,59,68,-258,112,158.1,-78,80.1,0.5203836930455635,0.3346153846153846,0.7434782608695653
2021,New York Knicks,,Evan Fournier,198.12,92.98636,SG,80,2358,402,965,0.417,241,619,0.389,80,113,0.708,34,176,210,171,79,20,105,180,1125,563,378,33,-322,-411,47,91.75,-686,-594.25,0.41658031088082903,0.3893376413570275,0.7079646017699115
2021,Detroit Pistons,Oklahoma State,Cade Cunningham,198.12,99.79024,SG,64,2088,429,1031,0.416,114,363,0.314,142,168,0.845,58,296,354,356,78,43,234,200,1114,602,249,26,-346,-405,116,125.5,-635,-509.5,0.41610087293889425,0.3140495867768595,0.8452380952380952
2021,Miami Heat,Kentucky,Bam Adebayo,205.74,115.66596,C,56,1825,406,729,0.557,0,6,0.0,256,340,0.753,137,427,564,190,80,44,148,171,1068,323,6,84,166,-18,172,202.2,320,522.2,0.5569272976680384,0.0,0.7529411764705882
2021,Orlando Magic,North Carolina,Cole Anthony,190.5,83.91452,PG,65,2059,357,912,0.391,132,391,0.338,216,253,0.854,32,316,348,369,46,17,170,171,1062,555,259,37,-396,-381,179,125.2,-598,-472.8,0.39144736842105265,0.3375959079283887,0.8537549407114624
2021,Milwaukee Bucks,Arkansas,Bobby Portis,208.28,113.398,C,72,2028,417,871,0.479,133,338,0.393,85,113,0.752,180,477,657,86,53,51,90,174,1052,454,205,28,-74,-216,57,229.05,-233,-3.9499999999999886,0.47876004592422505,0.39349112426035504,0.7522123893805309
2021,Los Angeles Lakers,Kentucky,Malik Monk,190.5,90.7184,SG,76,2138,391,826,0.473,173,442,0.391,93,117,0.795,37,219,256,218,61,29,122,138,1048,435,269,24,-88,-288,69,104.85,-307,-202.15,0.47336561743341404,0.3914027149321267,0.7948717948717948
2021,Denver Nuggets,Memphis,Will Barton,195.58,82.10015200000001,SG,71,2276,392,896,0.438,157,430,0.365,102,127,0.803,44,296,340,276,55,31,127,114,1043,504,273,25,-224,-348,77,138.8,-495,-356.2,0.4375,0.36511627906976746,0.8031496062992126
2021,Cleveland Cavaliers,Southern California,Evan Mobley,210.82,97.52228,PF,69,2331,422,830,0.508,23,92,0.25,167,252,0.663,143,427,570,174,56,115,133,147,1034,408,69,85,28,-138,82,233.4,-28,205.4,0.5084337349397591,0.25,0.6626984126984127
2021,Utah Jazz,,Rudy Gobert,215.9,117.026736,C,66,2120,362,508,0.713,0,4,0.0,303,439,0.69,241,727,968,72,45,137,119,176,1027,146,4,136,432,-12,167,342.95,587,929.95,0.7125984251968503,0.0,0.6902050113895216
2021,Washington Wizards,Georgia,Kentavious Caldwell-Pope,195.58,92.532768,SG,77,2329,361,829,0.435,159,408,0.39,137,154,0.89,41,220,261,145,83,26,97,139,1018,468,249,17,-214,-270,120,110.8,-364,-253.2,0.43546441495778043,0.3897058823529412,0.8896103896103896
2021,Cleveland Cavaliers,UCLA,Kevin Love,203.2,113.851592,C,74,1665,327,761,0.43,187,477,0.392,166,198,0.838,87,449,536,160,26,18,98,101,1007,434,290,32,-214,-309,134,163.7,-389,-225.3,0.4296977660972405,0.3920335429769392,0.8383838383838383
2021,Phoenix Suns,Arizona,Deandre Ayton,210.82,113.398,C,58,1713,442,697,0.634,7,19,0.368,106,142,0.746,149,444,593,84,40,40,91,142,997,255,12,36,374,-15,70,193.9,429,622.9,0.6341463414634146,0.3684210526315789,0.7464788732394366
2021,Boston Celtics,Colorado,Derrick White,193.04,86.18248,SG,75,2199,337,800,0.421,115,369,0.312,203,235,0.864,38,223,261,366,64,58,119,172,992,463,254,32,-252,-417,171,159.15,-498,-338.85,0.42125,0.3116531165311653,0.8638297872340426
2021,Boston Celtics,Colorado,Derrick White,193.04,86.18248,SG,75,2199,337,800,0.421,115,369,0.312,203,235,0.864,38,223,261,366,64,58,119,172,992,463,254,32,-252,-417,171,159.15,-498,-338.85,0.42125,0.3116531165311653,0.8638297872340426
2021,Boston Celtics,Colorado,Derrick White,193.04,86.18248,SG,75,2199,337,800,0.421,115,369,0.312,203,235,0.864,38,223,261,366,64,58,119,172,992,463,254,32,-252,-417,171,159.15,-498,-338.85,0.42125,0.3116531165311653,0.8638297872340426
2021,Boston Celtics,Colorado,Derrick White,193.04,86.18248,SG,75,2199,337,800,0.421,115,369,0.312,203,235,0.864,38,223,261,366,64,58,119,172,992,463,254,32,-252,-417,171,159.15,-498,-338.85,0.42125,0.3116531165311653,0.8638297872340426
2021,Boston Celtics,Colorado,Derrick White,193.04,86.18248,SG,75,2199,337,800,0.421,115,369,0.312,203,235,0.864,38,223,261,366,64,58,119,172,992,463,254,32,-252,-417,171,159.15,-498,-338.85,0.42125,0.3116531165311653,0.8638297872340426
2021,Boston Celtics,Colorado,Derrick White,193.04,86.18248,SG,75,2199,337,800,0.421,115,369,0.312,203,235,0.864,38,223,261,366,64,58,119,172,992,463,254,32,-252,-417,171,159.15,-498,-338.85,0.42125,0.3116531165311653,0.8638297872340426
2021,Boston Celtics,Colorado,Derrick White,193.04,86.18248,SG,75,2199,337,800,0.421,115,369,0.312,203,235,0.864,38,223,261,366,64,58,119,172,992,463,254,32,-252,-417,171,159.15,-498,-338.85,0.42125,0.3116531165311653,0.8638297872340426
2021,Boston Celtics,Colorado,Derrick White,193.04,86.18248,SG,75,2199,337,800,0.421,115,369,0.312,203,235,0.864,38,223,261,366,64,58,119,172,992,463,254,32,-252,-417,171,159.15,-498,-338.85,0.42125,0.3116531165311653,0.8638297872340426
2021,Boston Celtics,Colorado,Derrick White,193.04,86.18248,SG,75,2199,337,800,0.421,115,369,0.312,203,235,0.864,38,223,261,366,64,58,119,172,992,463,254,32,-252,-417,171,159.15,-498,-338.85,0.42125,0.3116531165311653,0.8638297872340426
2021,Portland Trail Blazers,,Anfernee Simons,190.5,82.10015200000001,SG,57,1681,353,797,0.443,179,442,0.405,103,116,0.888,26,125,151,221,30,6,115,110,988,444,263,13,-182,-252,90,54.5,-344,-289.5,0.44291091593475534,0.40497737556561086,0.8879310344827587
2021,Cleveland Cavaliers,Michigan,Caris LeVert,198.12,92.98636,SG,58,1780,379,854,0.444,82,256,0.32,146,193,0.756,43,171,214,248,51,23,108,131,986,475,174,47,-192,-276,99,102.7,-369,-266.3,0.44379391100702575,0.3203125,0.7564766839378239
2021,Cleveland Cavaliers,Michigan,Caris LeVert,198.12,92.98636,SG,58,1780,379,854,0.444,82,256,0.32,146,193,0.756,43,171,214,248,51,23,108,131,986,475,174,47,-192,-276,99,102.7,-369,-266.3,0.44379391100702575,0.3203125,0.7564766839378239
2021,Cleveland Cavaliers,Michigan,Caris LeVert,198.12,92.98636,SG,58,1780,379,854,0.444,82,256,0.32,146,193,0.756,43,171,214,248,51,23,108,131,986,475,174,47,-192,-276,99,102.7,-369,-266.3,0.44379391100702575,0.3203125,0.7564766839378239
2021,Cleveland Cavaliers,Michigan,Caris LeVert,198.12,92.98636,SG,58,1780,379,854,0.444,82,256,0.32,146,193,0.756,43,171,214,248,51,23,108,131,986,475,174,47,-192,-276,99,102.7,-369,-266.3,0.44379391100702575,0.3203125,0.7564766839378239
2021,Cleveland Cavaliers,Michigan,Caris LeVert,198.12,92.98636,SG,58,1780,379,854,0.444,82,256,0.32,146,193,0.756,43,171,214,248,51,23,108,131,986,475,174,47,-192,-276,99,102.7,-369,-266.3,0.44379391100702575,0.3203125,0.7564766839378239
2021,Cleveland Cavaliers,Michigan,Caris LeVert,198.12,92.98636,SG,58,1780,379,854,0.444,82,256,0.32,146,193,0.756,43,171,214,248,51,23,108,131,986,475,174,47,-192,-276,99,102.7,-369,-266.3,0.44379391100702575,0.3203125,0.7564766839378239
2021,Cleveland Cavaliers,Michigan,Caris LeVert,198.12,92.98636,SG,58,1780,379,854,0.444,82,256,0.32,146,193,0.756,43,171,214,248,51,23,108,131,986,475,174,47,-192,-276,99,102.7,-369,-266.3,0.44379391100702575,0.3203125,0.7564766839378239
2021,Cleveland Cavaliers,Michigan,Caris LeVert,198.12,92.98636,SG,58,1780,379,854,0.444,82,256,0.32,146,193,0.756,43,171,214,248,51,23,108,131,986,475,174,47,-192,-276,99,102.7,-369,-266.3,0.44379391100702575,0.3203125,0.7564766839378239
2021,Cleveland Cavaliers,Michigan,Caris LeVert,198.12,92.98636,SG,58,1780,379,854,0.444,82,256,0.32,146,193,0.756,43,171,214,248,51,23,108,131,986,475,174,47,-192,-276,99,102.7,-369,-266.3,0.44379391100702575,0.3203125,0.7564766839378239
2021,Utah Jazz,Ohio State,Mike Conley,185.42,79.3786,PG,72,2058,344,791,0.435,169,414,0.408,129,162,0.796,47,170,217,385,96,21,123,142,986,447,245,33,-206,-228,96,152.15,-338,-185.85,0.43489254108723135,0.4082125603864734,0.7962962962962963
2021,Brooklyn Nets,Duke,Seth Curry,187.96,83.91452,SG,64,2134,360,739,0.487,158,374,0.422,82,94,0.872,21,179,200,230,53,14,109,148,960,379,216,12,-38,-174,70,84.35,-142,-57.650000000000006,0.4871447902571042,0.42245989304812837,0.8723404255319149
2021,Brooklyn Nets,Duke,Seth Curry,187.96,83.91452,SG,64,2134,360,739,0.487,158,374,0.422,82,94,0.872,21,179,200,230,53,14,109,148,960,379,216,12,-38,-174,70,84.35,-142,-57.650000000000006,0.4871447902571042,0.42245989304812837,0.8723404255319149
2021,Brooklyn Nets,Duke,Seth Curry,187.96,83.91452,SG,64,2134,360,739,0.487,158,374,0.422,82,94,0.872,21,179,200,230,53,14,109,148,960,379,216,12,-38,-174,70,84.35,-142,-57.650000000000006,0.4871447902571042,0.42245989304812837,0.8723404255319149
2021,Brooklyn Nets,Duke,Seth Curry,187.96,83.91452,SG,64,2134,360,739,0.487,158,374,0.422,82,94,0.872,21,179,200,230,53,14,109,148,960,379,216,12,-38,-174,70,84.35,-142,-57.650000000000006,0.4871447902571042,0.42245989304812837,0.8723404255319149
2021,Brooklyn Nets,Duke,Seth Curry,187.96,83.91452,SG,64,2134,360,739,0.487,158,374,0.422,82,94,0.872,21,179,200,230,53,14,109,148,960,379,216,12,-38,-174,70,84.35,-142,-57.650000000000006,0.4871447902571042,0.42245989304812837,0.8723404255319149
2021,Brooklyn Nets,Duke,Seth Curry,187.96,83.91452,SG,64,2134,360,739,0.487,158,374,0.422,82,94,0.872,21,179,200,230,53,14,109,148,960,379,216,12,-38,-174,70,84.35,-142,-57.650000000000006,0.4871447902571042,0.42245989304812837,0.8723404255319149
2021,Brooklyn Nets,Duke,Seth Curry,187.96,83.91452,SG,64,2134,360,739,0.487,158,374,0.422,82,94,0.872,21,179,200,230,53,14,109,148,960,379,216,12,-38,-174,70,84.35,-142,-57.650000000000006,0.4871447902571042,0.42245989304812837,0.8723404255319149
2021,Brooklyn Nets,Duke,Seth Curry,187.96,83.91452,SG,64,2134,360,739,0.487,158,374,0.422,82,94,0.872,21,179,200,230,53,14,109,148,960,379,216,12,-38,-174,70,84.35,-142,-57.650000000000006,0.4871447902571042,0.42245989304812837,0.8723404255319149
2021,Brooklyn Nets,Duke,Seth Curry,187.96,83.91452,SG,64,2134,360,739,0.487,158,374,0.422,82,94,0.872,21,179,200,230,53,14,109,148,960,379,216,12,-38,-174,70,84.35,-142,-57.650000000000006,0.4871447902571042,0.42245989304812837,0.8723404255319149
2021,Phoenix Suns,Wake Forest,Chris Paul,182.88,79.3786,PG,65,2139,363,736,0.493,63,199,0.317,169,202,0.837,22,261,283,702,121,20,153,134,958,373,136,33,-20,-219,136,239.05,-103,136.05,0.49320652173913043,0.3165829145728643,0.8366336633663366
2021,Minnesota Timberwolves,Florida State,Malik Beasley,193.04,84.821704,SG,79,1976,332,850,0.391,240,637,0.377,49,60,0.817,26,201,227,116,43,12,43,88,953,518,397,11,-372,-471,38,93.85,-805,-711.15,0.3905882352941176,0.37676609105180536,0.8166666666666667
2021,Houston Rockets,Southern California,Kevin Porter Jr.,193.04,92.079176,PG,61,1907,335,808,0.415,155,413,0.375,124,193,0.642,43,224,267,376,69,22,192,156,949,473,258,69,-276,-309,55,113.2,-530,-416.8,0.4146039603960396,0.37530266343825663,0.6424870466321243
2021,Denver Nuggets,Iowa State,Monte Morris,187.96,83.007336,PG,75,2239,374,773,0.484,124,314,0.395,73,84,0.869,27,199,226,333,56,14,78,92,945,399,190,11,-50,-198,62,137.9,-186,-48.099999999999994,0.48382923673997413,0.39490445859872614,0.8690476190476191
2021,New York Knicks,Colorado,Alec Burks,198.12,97.068688,SG,81,2318,285,728,0.391,157,389,0.404,217,264,0.822,47,350,397,239,85,26,91,215,944,443,232,47,-316,-225,170,170.0,-371,-201.0,0.3914835164835165,0.40359897172236503,0.821969696969697
2021,Charlotte Hornets,Louisville,Montrezl Harrell,200.66,108.86208,C,71,1640,358,555,0.645,4,17,0.235,212,296,0.716,149,282,431,145,29,43,72,137,932,197,13,84,322,-27,128,174.4,423,597.4,0.645045045045045,0.23529411764705882,0.7162162162162162
2021,Charlotte Hornets,Louisville,Montrezl Harrell,200.66,108.86208,C,71,1640,358,555,0.645,4,17,0.235,212,296,0.716,149,282,431,145,29,43,72,137,932,197,13,84,322,-27,128,174.4,423,597.4,0.645045045045045,0.23529411764705882,0.7162162162162162
2021,Charlotte Hornets,Louisville,Montrezl Harrell,200.66,108.86208,C,71,1640,358,555,0.645,4,17,0.235,212,296,0.716,149,282,431,145,29,43,72,137,932,197,13,84,322,-27,128,174.4,423,597.4,0.645045045045045,0.23529411764705882,0.7162162162162162
2021,Charlotte Hornets,Louisville,Montrezl Harrell,200.66,108.86208,C,71,1640,358,555,0.645,4,17,0.235,212,296,0.716,149,282,431,145,29,43,72,137,932,197,13,84,322,-27,128,174.4,423,597.4,0.645045045045045,0.23529411764705882,0.7162162162162162
2021,Charlotte Hornets,Louisville,Montrezl Harrell,200.66,108.86208,C,71,1640,358,555,0.645,4,17,0.235,212,296,0.716,149,282,431,145,29,43,72,137,932,197,13,84,322,-27,128,174.4,423,597.4,0.645045045045045,0.23529411764705882,0.7162162162162162
2021,Charlotte Hornets,Louisville,Montrezl Harrell,200.66,108.86208,C,71,1640,358,555,0.645,4,17,0.235,212,296,0.716,149,282,431,145,29,43,72,137,932,197,13,84,322,-27,128,174.4,423,597.4,0.645045045045045,0.23529411764705882,0.7162162162162162
2021,Charlotte Hornets,Louisville,Montrezl Harrell,200.66,108.86208,C,71,1640,358,555,0.645,4,17,0.235,212,296,0.716,149,282,431,145,29,43,72,137,932,197,13,84,322,-27,128,174.4,423,597.4,0.645045045045045,0.23529411764705882,0.7162162162162162
2021,Charlotte Hornets,Louisville,Montrezl Harrell,200.66,108.86208,C,71,1640,358,555,0.645,4,17,0.235,212,296,0.716,149,282,431,145,29,43,72,137,932,197,13,84,322,-27,128,174.4,423,597.4,0.645045045045045,0.23529411764705882,0.7162162162162162
2021,Charlotte Hornets,Louisville,Montrezl Harrell,200.66,108.86208,C,71,1640,358,555,0.645,4,17,0.235,212,296,0.716,149,282,431,145,29,43,72,137,932,197,13,84,322,-27,128,174.4,423,597.4,0.645045045045045,0.23529411764705882,0.7162162162162162
2021,Orlando Magic,Duke,Wendell Carter Jr.,208.28,122.46984,PF,62,1852,359,684,0.525,70,214,0.327,143,207,0.691,139,509,648,171,36,43,117,169,931,325,144,64,68,-222,79,212.05,-75,137.05,0.5248538011695907,0.32710280373831774,0.6908212560386473
2021,Washington Wizards,Florida,Bradley Beal,193.04,93.893544,SG,40,1439,348,771,0.451,63,210,0.3,169,203,0.833,38,151,189,265,36,15,135,95,928,423,147,34,-150,-252,135,76.25,-267,-190.75,0.45136186770428016,0.3,0.8325123152709359
2021,Los Angeles Lakers,Kentucky,Anthony Davis,208.28,114.758776,C,40,1404,370,695,0.532,13,70,0.186,174,244,0.713,106,288,394,122,49,90,82,97,927,325,57,70,90,-132,104,179.15,62,241.15,0.5323741007194245,0.18571428571428572,0.7131147540983607
2021,Brooklyn Nets,St.Mary's College of California,Patty Mills,182.88,81.64656,SG,81,2346,324,794,0.408,227,568,0.4,48,59,0.814,18,138,156,183,51,17,73,112,923,470,341,11,-292,-342,37,81.15,-597,-515.85,0.4080604534005038,0.3996478873239437,0.8135593220338984
2021,Los Angeles Lakers,Syracuse,Carmelo Anthony,200.66,107.954896,PF,69,1793,319,723,0.441,149,397,0.375,132,159,0.83,62,226,288,68,47,52,59,166,919,404,248,27,-170,-297,105,116.2,-362,-245.8,0.4412171507607192,0.37531486146095716,0.8301886792452831
2021,Houston Rockets,Ohio State,Jae'Sean Tate,193.04,104.32616,PF,78,2056,363,729,0.498,63,202,0.312,130,184,0.707,135,285,420,222,72,41,139,286,919,366,139,54,-6,-228,76,166.95,-158,8.949999999999989,0.49794238683127573,0.3118811881188119,0.7065217391304348
2021,Dallas Mavericks,Colorado,Spencer Dinwiddie,198.12,97.52228,PG,67,1981,306,735,0.416,112,330,0.339,195,252,0.774,45,234,279,346,44,13,104,150,919,429,218,57,-246,-318,138,136.5,-426,-289.5,0.4163265306122449,0.3393939393939394,0.7738095238095238
2021,Dallas Mavericks,Colorado,Spencer Dinwiddie,198.12,97.52228,PG,67,1981,306,735,0.416,112,330,0.339,195,252,0.774,45,234,279,346,44,13,104,150,919,429,218,57,-246,-318,138,136.5,-426,-289.5,0.4163265306122449,0.3393939393939394,0.7738095238095238
2021,Dallas Mavericks,Colorado,Spencer Dinwiddie,198.12,97.52228,PG,67,1981,306,735,0.416,112,330,0.339,195,252,0.774,45,234,279,346,44,13,104,150,919,429,218,57,-246,-318,138,136.5,-426,-289.5,0.4163265306122449,0.3393939393939394,0.7738095238095238
2021,Dallas Mavericks,Colorado,Spencer Dinwiddie,198.12,97.52228,PG,67,1981,306,735,0.416,112,330,0.339,195,252,0.774,45,234,279,346,44,13,104,150,919,429,218,57,-246,-318,138,136.5,-426,-289.5,0.4163265306122449,0.3393939393939394,0.7738095238095238
2021,Dallas Mavericks,Colorado,Spencer Dinwiddie,198.12,97.52228,PG,67,1981,306,735,0.416,112,330,0.339,195,252,0.774,45,234,279,346,44,13,104,150,919,429,218,57,-246,-318,138,136.5,-426,-289.5,0.4163265306122449,0.3393939393939394,0.7738095238095238
2021,Dallas Mavericks,Colorado,Spencer Dinwiddie,198.12,97.52228,PG,67,1981,306,735,0.416,112,330,0.339,195,252,0.774,45,234,279,346,44,13,104,150,919,429,218,57,-246,-318,138,136.5,-426,-289.5,0.4163265306122449,0.3393939393939394,0.7738095238095238
2021,Dallas Mavericks,Colorado,Spencer Dinwiddie,198.12,97.52228,PG,67,1981,306,735,0.416,112,330,0.339,195,252,0.774,45,234,279,346,44,13,104,150,919,429,218,57,-246,-318,138,136.5,-426,-289.5,0.4163265306122449,0.3393939393939394,0.7738095238095238
2021,Dallas Mavericks,Colorado,Spencer Dinwiddie,198.12,97.52228,PG,67,1981,306,735,0.416,112,330,0.339,195,252,0.774,45,234,279,346,44,13,104,150,919,429,218,57,-246,-318,138,136.5,-426,-289.5,0.4163265306122449,0.3393939393939394,0.7738095238095238
2021,Dallas Mavericks,Colorado,Spencer Dinwiddie,198.12,97.52228,PG,67,1981,306,735,0.416,112,330,0.339,195,252,0.774,45,234,279,346,44,13,104,150,919,429,218,57,-246,-318,138,136.5,-426,-289.5,0.4163265306122449,0.3393939393939394,0.7738095238095238
2021,San Antonio Spurs,Utah,Jakob Poeltl,215.9,111.13004,C,68,1970,410,663,0.618,1,1,1.0,94,190,0.495,262,372,634,189,45,118,109,212,915,253,0,96,314,3,-2,287.65,315,602.65,0.6184012066365008,1.0,0.49473684210526314
2021,Cleveland Cavaliers,Texas-Austin,Jarrett Allen,208.28,110.222856,C,56,1810,369,545,0.677,1,10,0.1,165,233,0.708,192,410,602,92,44,75,94,97,904,176,9,68,386,-24,97,229.15,459,688.15,0.6770642201834862,0.1,0.7081545064377682
2021,Detroit Pistons,Syracuse,Jerami Grant,203.2,95.25432,PF,47,1500,298,699,0.426,91,254,0.358,217,259,0.838,28,163,191,111,44,49,85,107,904,401,163,42,-206,-216,175,81.15,-247,-165.85,0.4263233190271817,0.35826771653543305,0.8378378378378378
2021,New Orleans Pelicans,Kansas,Devonte' Graham,185.42,88.45044,PG,76,2162,296,815,0.363,192,563,0.341,118,140,0.843,37,140,177,316,71,12,105,95,902,519,371,22,-446,-537,96,116.75,-887,-770.25,0.36319018404907977,0.3410301953818828,0.8428571428571429
2021,Cleveland Cavaliers,Arizona,Lauri Markkanen,210.82,108.86208,SF,61,1878,313,703,0.445,136,380,0.358,138,159,0.868,59,286,345,81,45,30,54,130,900,390,244,21,-154,-324,117,125.25,-361,-235.75,0.44523470839260315,0.35789473684210527,0.8679245283018868
2021,Atlanta Hawks,Maryland,Kevin Huerter,200.66,89.811216,SF,74,2188,345,760,0.454,160,411,0.389,42,52,0.808,32,222,254,203,55,26,91,185,892,415,251,10,-140,-273,32,108.0,-381,-273.0,0.45394736842105265,0.38929440389294406,0.8076923076923077
2021,New York Knicks,Kentucky,Immanuel Quickley,190.5,86.18248,PG,78,1802,284,724,0.392,137,396,0.346,177,201,0.881,31,216,247,275,54,3,99,167,882,440,259,24,-312,-366,153,108.9,-525,-416.1,0.39226519337016574,0.34595959595959597,0.8805970149253731
2021,Dallas Mavericks,Florida,Dorian Finney-Smith,200.66,99.79024,PF,80,2644,326,692,0.471,172,435,0.395,56,83,0.675,122,253,375,150,88,39,80,183,880,366,263,27,-80,-273,29,176.1,-324,-147.9,0.47109826589595377,0.3954022988505747,0.6746987951807228
2021,Oklahoma City Thunder,Arizona State,Luguentz Dort,190.5,97.52228,SG,51,1665,293,726,0.404,130,391,0.332,161,191,0.843,38,174,212,88,46,18,88,149,877,433,261,30,-280,-393,131,65.05,-542,-476.95,0.4035812672176309,0.33248081841432225,0.8429319371727748
2021,Atlanta Hawks,Wake Forest,John Collins,205.74,102.511792,PF,54,1663,339,644,0.526,64,176,0.364,134,169,0.793,93,329,422,98,33,56,60,164,876,305,112,35,68,-144,99,159.55,23,182.55,0.5263975155279503,0.36363636363636365,0.7928994082840237
2021,San Antonio Spurs,Florida State,Devin Vassell,195.58,90.7184,SF,71,1937,326,764,0.427,137,380,0.361,83,99,0.838,44,262,306,136,76,41,58,143,872,438,243,16,-224,-318,67,143.85,-475,-331.15,0.42670157068062825,0.3605263157894737,0.8383838383838383
2021,Los Angeles Clippers,Florida State,Terance Mann,195.58,97.52228,SF,81,2317,334,690,0.484,76,208,0.365,128,164,0.78,104,321,425,209,55,21,84,178,872,356,132,36,-44,-168,92,171.6,-120,51.599999999999994,0.48405797101449277,0.36538461538461536,0.7804878048780488
2021,Miami Heat,Michigan,Duncan Robinson,200.66,97.52228,SG,79,2043,290,726,0.399,232,624,0.372,51,61,0.836,24,179,203,129,42,14,60,201,863,436,392,10,-292,-480,41,76.95,-731,-654.05,0.39944903581267216,0.3717948717948718,0.8360655737704918
2021,Sacramento Kings,Baylor,Davion Mitchell,182.88,91.625584,PG,75,2076,352,843,0.418,101,320,0.316,56,85,0.659,33,133,166,313,55,24,114,141,861,491,219,29,-278,-354,27,103.45,-605,-501.55,0.41755634638196915,0.315625,0.6588235294117647
2021,Boston Celtics,Oklahoma State,Marcus Smart,193.04,99.79024,PG,71,2296,300,718,0.418,119,360,0.331,142,179,0.793,42,228,270,417,119,18,159,160,861,418,241,37,-236,-366,105,163.25,-497,-333.75,0.4178272980501393,0.33055555555555555,0.7932960893854749
2021,Los Angeles Clippers,UCLA,Norman Powell,190.5,97.52228,SF,45,1458,279,605,0.461,106,253,0.419,189,233,0.811,20,125,145,96,42,21,69,106,853,326,147,44,-94,-123,145,56.95,-72,-15.049999999999997,0.46115702479338844,0.4189723320158103,0.8111587982832618
2021,Los Angeles Clippers,UCLA,Norman Powell,190.5,97.52228,SF,45,1458,279,605,0.461,106,253,0.419,189,233,0.811,20,125,145,96,42,21,69,106,853,326,147,44,-94,-123,145,56.95,-72,-15.049999999999997,0.46115702479338844,0.4189723320158103,0.8111587982832618
2021,Los Angeles Clippers,UCLA,Norman Powell,190.5,97.52228,SF,45,1458,279,605,0.461,106,253,0.419,189,233,0.811,20,125,145,96,42,21,69,106,853,326,147,44,-94,-123,145,56.95,-72,-15.049999999999997,0.46115702479338844,0.4189723320158103,0.8111587982832618
2021,Los Angeles Clippers,UCLA,Norman Powell,190.5,97.52228,SF,45,1458,279,605,0.461,106,253,0.419,189,233,0.811,20,125,145,96,42,21,69,106,853,326,147,44,-94,-123,145,56.95,-72,-15.049999999999997,0.46115702479338844,0.4189723320158103,0.8111587982832618
2021,Los Angeles Clippers,UCLA,Norman Powell,190.5,97.52228,SF,45,1458,279,605,0.461,106,253,0.419,189,233,0.811,20,125,145,96,42,21,69,106,853,326,147,44,-94,-123,145,56.95,-72,-15.049999999999997,0.46115702479338844,0.4189723320158103,0.8111587982832618
2021,Los Angeles Clippers,UCLA,Norman Powell,190.5,97.52228,SF,45,1458,279,605,0.461,106,253,0.419,189,233,0.811,20,125,145,96,42,21,69,106,853,326,147,44,-94,-123,145,56.95,-72,-15.049999999999997,0.46115702479338844,0.4189723320158103,0.8111587982832618
2021,Los Angeles Clippers,UCLA,Norman Powell,190.5,97.52228,SG,45,1458,279,605,0.461,106,253,0.419,189,233,0.811,20,125,145,96,42,21,69,106,853,326,147,44,-94,-123,145,56.95,-72,-15.049999999999997,0.46115702479338844,0.4189723320158103,0.8111587982832618
2021,Los Angeles Clippers,UCLA,Norman Powell,190.5,97.52228,SG,45,1458,279,605,0.461,106,253,0.419,189,233,0.811,20,125,145,96,42,21,69,106,853,326,147,44,-94,-123,145,56.95,-72,-15.049999999999997,0.46115702479338844,0.4189723320158103,0.8111587982832618
2021,Los Angeles Clippers,UCLA,Norman Powell,190.5,97.52228,SG,45,1458,279,605,0.461,106,253,0.419,189,233,0.811,20,125,145,96,42,21,69,106,853,326,147,44,-94,-123,145,56.95,-72,-15.049999999999997,0.46115702479338844,0.4189723320158103,0.8111587982832618
2021,San Antonio Spurs,Miami,Lonnie Walker IV,193.04,92.532768,SG,70,1612,311,764,0.407,111,353,0.314,116,148,0.784,18,163,181,152,44,19,71,98,849,453,242,32,-284,-393,84,78.85,-593,-514.15,0.40706806282722513,0.31444759206798867,0.7837837837837838
2021,Miami Heat,Villanova,Kyle Lowry,182.88,88.904032,PG,63,2133,276,627,0.44,144,382,0.377,148,174,0.851,33,249,282,474,67,17,168,177,844,351,238,26,-150,-282,122,146.4,-310,-163.6,0.44019138755980863,0.3769633507853403,0.8505747126436781
2021,Los Angeles Clippers,Duke,Luke Kennard,195.58,93.439952,SG,70,1919,287,639,0.449,190,423,0.449,69,77,0.896,20,209,229,146,42,6,60,101,833,352,233,8,-130,-129,61,87.7,-198,-110.3,0.4491392801251956,0.4491725768321513,0.8961038961038961
2021,Phoenix Suns,North Carolina,Cameron Johnson,203.2,95.25432,PF,66,1730,279,607,0.46,166,391,0.425,98,114,0.86,42,231,273,99,57,16,47,113,822,328,225,16,-98,-177,82,110.85,-193,-82.15,0.4596375617792422,0.42455242966751916,0.8596491228070176
2021,Toronto Raptors,Indiana,OG Anunoby,200.66,105.233344,SF,48,1728,309,697,0.443,115,317,0.363,89,118,0.754,74,190,264,125,71,25,80,131,822,388,202,29,-158,-261,60,117.2,-359,-241.8,0.4433285509325681,0.3627760252365931,0.7542372881355932
2021,Atlanta Hawks,,Clint Capela,208.28,116.119552,C,74,2042,370,604,0.613,0,1,0.0,80,169,0.473,279,598,877,92,55,93,44,166,820,234,1,89,272,-3,-9,355.7,260,615.7,0.6125827814569537,0.0,0.47337278106508873
2021,Portland Trail Blazers,Villanova,Josh Hart,195.58,97.52228,SG,54,1791,287,569,0.504,73,213,0.343,160,211,0.758,62,326,388,224,61,13,114,150,807,282,140,51,10,-201,109,141.0,-82,59.0,0.5043936731107206,0.3427230046948357,0.7582938388625592
2021,Portland Trail Blazers,Villanova,Josh Hart,195.58,97.52228,SG,54,1791,287,569,0.504,73,213,0.343,160,211,0.758,62,326,388,224,61,13,114,150,807,282,140,51,10,-201,109,141.0,-82,59.0,0.5043936731107206,0.3427230046948357,0.7582938388625592
2021,Portland Trail Blazers,Villanova,Josh Hart,195.58,97.52228,SG,54,1791,287,569,0.504,73,213,0.343,160,211,0.758,62,326,388,224,61,13,114,150,807,282,140,51,10,-201,109,141.0,-82,59.0,0.5043936731107206,0.3427230046948357,0.7582938388625592
2021,Portland Trail Blazers,Villanova,Josh Hart,195.58,97.52228,SG,54,1791,287,569,0.504,73,213,0.343,160,211,0.758,62,326,388,224,61,13,114,150,807,282,140,51,10,-201,109,141.0,-82,59.0,0.5043936731107206,0.3427230046948357,0.7582938388625592
2021,Portland Trail Blazers,Villanova,Josh Hart,195.58,97.52228,SG,54,1791,287,569,0.504,73,213,0.343,160,211,0.758,62,326,388,224,61,13,114,150,807,282,140,51,10,-201,109,141.0,-82,59.0,0.5043936731107206,0.3427230046948357,0.7582938388625592
2021,Portland Trail Blazers,Villanova,Josh Hart,195.58,97.52228,SG,54,1791,287,569,0.504,73,213,0.343,160,211,0.758,62,326,388,224,61,13,114,150,807,282,140,51,10,-201,109,141.0,-82,59.0,0.5043936731107206,0.3427230046948357,0.7582938388625592
2021,Portland Trail Blazers,Villanova,Josh Hart,195.58,97.52228,SG,54,1791,287,569,0.504,73,213,0.343,160,211,0.758,62,326,388,224,61,13,114,150,807,282,140,51,10,-201,109,141.0,-82,59.0,0.5043936731107206,0.3427230046948357,0.7582938388625592
2021,Portland Trail Blazers,Villanova,Josh Hart,195.58,97.52228,SG,54,1791,287,569,0.504,73,213,0.343,160,211,0.758,62,326,388,224,61,13,114,150,807,282,140,51,10,-201,109,141.0,-82,59.0,0.5043936731107206,0.3427230046948357,0.7582938388625592
2021,Portland Trail Blazers,Villanova,Josh Hart,195.58,97.52228,SG,54,1791,287,569,0.504,73,213,0.343,160,211,0.758,62,326,388,224,61,13,114,150,807,282,140,51,10,-201,109,141.0,-82,59.0,0.5043936731107206,0.3427230046948357,0.7582938388625592
2021,Brooklyn Nets,Duke,Kyrie Irving,187.96,88.45044,PG,29,1092,289,616,0.469,100,239,0.418,118,129,0.915,16,111,127,167,41,17,73,81,796,327,139,11,-76,-117,107,65.95,-86,-20.049999999999997,0.46915584415584416,0.41841004184100417,0.9147286821705426
2021,Memphis Grizzlies,Southern California,De'Anthony Melton,187.96,90.7184,SG,73,1657,281,695,0.404,139,372,0.374,90,120,0.75,64,264,328,194,104,39,112,128,791,414,233,30,-266,-282,60,155.6,-488,-332.4,0.40431654676258993,0.3736559139784946,0.75
2021,Sacramento Kings,Kentucky,Trey Lyles,205.74,106.140528,PF,75,1536,262,562,0.466,67,209,0.321,195,243,0.802,89,290,379,88,29,32,73,123,786,300,142,48,-76,-225,147,126.85,-154,-27.150000000000006,0.46619217081850534,0.32057416267942584,0.8024691358024691
2021,Sacramento Kings,Kentucky,Trey Lyles,205.74,106.140528,PF,75,1536,262,562,0.466,67,209,0.321,195,243,0.802,89,290,379,88,29,32,73,123,786,300,142,48,-76,-225,147,126.85,-154,-27.150000000000006,0.46619217081850534,0.32057416267942584,0.8024691358024691
2021,Sacramento Kings,Kentucky,Trey Lyles,205.74,106.140528,PF,75,1536,262,562,0.466,67,209,0.321,195,243,0.802,89,290,379,88,29,32,73,123,786,300,142,48,-76,-225,147,126.85,-154,-27.150000000000006,0.46619217081850534,0.32057416267942584,0.8024691358024691
2021,Sacramento Kings,Kentucky,Trey Lyles,205.74,106.140528,PF,75,1536,262,562,0.466,67,209,0.321,195,243,0.802,89,290,379,88,29,32,73,123,786,300,142,48,-76,-225,147,126.85,-154,-27.150000000000006,0.46619217081850534,0.32057416267942584,0.8024691358024691
2021,Sacramento Kings,Kentucky,Trey Lyles,205.74,106.140528,PF,75,1536,262,562,0.466,67,209,0.321,195,243,0.802,89,290,379,88,29,32,73,123,786,300,142,48,-76,-225,147,126.85,-154,-27.150000000000006,0.46619217081850534,0.32057416267942584,0.8024691358024691
2021,Sacramento Kings,Kentucky,Trey Lyles,205.74,106.140528,PF,75,1536,262,562,0.466,67,209,0.321,195,243,0.802,89,290,379,88,29,32,73,123,786,300,142,48,-76,-225,147,126.85,-154,-27.150000000000006,0.46619217081850534,0.32057416267942584,0.8024691358024691
2021,Sacramento Kings,Kentucky,Trey Lyles,205.74,106.140528,PF,75,1536,262,562,0.466,67,209,0.321,195,243,0.802,89,290,379,88,29,32,73,123,786,300,142,48,-76,-225,147,126.85,-154,-27.150000000000006,0.46619217081850534,0.32057416267942584,0.8024691358024691
2021,Sacramento Kings,Kentucky,Trey Lyles,205.74,106.140528,PF,75,1536,262,562,0.466,67,209,0.321,195,243,0.802,89,290,379,88,29,32,73,123,786,300,142,48,-76,-225,147,126.85,-154,-27.150000000000006,0.46619217081850534,0.32057416267942584,0.8024691358024691
2021,Sacramento Kings,Kentucky,Trey Lyles,205.74,106.140528,PF,75,1536,262,562,0.466,67,209,0.321,195,243,0.802,89,290,379,88,29,32,73,123,786,300,142,48,-76,-225,147,126.85,-154,-27.150000000000006,0.46619217081850534,0.32057416267942584,0.8024691358024691
2021,Los Angeles Clippers,,Ivica Zubac,213.36,108.86208,C,76,1852,310,495,0.626,0,0,0.0,165,227,0.727,217,427,644,120,36,77,114,203,785,185,0,62,250,0,103,234.6,353,587.6,0.6262626262626263,,0.7268722466960352
2021,Charlotte Hornets,Butler,Gordon Hayward,200.66,102.0582,SF,49,1564,283,617,0.459,86,220,0.391,126,149,0.846,38,186,224,177,47,22,81,85,778,334,134,23,-102,-144,103,99.5,-143,-43.5,0.4586709886547812,0.39090909090909093,0.8456375838926175
2021,Chicago Bulls,North Carolina,Coby White,193.04,88.45044,PG,61,1675,279,644,0.433,136,353,0.385,78,91,0.857,17,165,182,176,29,11,70,137,772,365,217,13,-172,-243,65,71.9,-350,-278.1,0.4332298136645963,0.38526912181303113,0.8571428571428571
2021,Denver Nuggets,Georgetown,Jeff Green,203.2,106.59412,PF,75,1849,277,529,0.524,53,168,0.315,165,198,0.833,41,190,231,96,28,27,71,151,772,252,115,33,50,-186,132,76.45,-4,72.45,0.5236294896030246,0.31547619047619047,0.8333333333333334
2021,Atlanta Hawks,,Danilo Gallinari,208.28,107.047712,PF,66,1672,259,597,0.434,112,294,0.381,141,156,0.904,35,273,308,101,28,12,38,93,771,338,182,15,-158,-210,126,107.35,-242,-134.65,0.4338358458961474,0.38095238095238093,0.9038461538461539
2021,Houston Rockets,Indiana,Eric Gordon,190.5,97.52228,SG,57,1670,268,564,0.475,124,301,0.412,105,135,0.778,15,98,113,154,28,18,107,63,765,296,177,30,-56,-159,75,36.85,-140,-103.15,0.475177304964539,0.4119601328903654,0.7777777777777778
2021,Orlando Magic,Texas-Austin,Mo Bamba,213.36,104.779752,C,71,1824,296,617,0.48,107,281,0.381,57,73,0.781,148,424,572,85,38,118,77,182,756,321,174,16,-50,-201,41,231.65,-210,21.650000000000006,0.47974068071312803,0.3807829181494662,0.7808219178082192
2021,Toronto Raptors,Oregon,Chris Boucher,205.74,90.7184,SF,80,1690,268,577,0.464,68,229,0.297,150,193,0.777,179,315,494,25,49,75,42,174,754,309,161,43,-82,-279,107,206.8,-254,-47.19999999999999,0.464471403812825,0.29694323144104806,0.7772020725388601
2021,Los Angeles Clippers,Fresno State,Paul George,203.2,99.79024,PF,31,1077,268,636,0.421,91,257,0.354,127,148,0.858,12,201,213,176,67,13,126,74,754,368,166,21,-200,-225,106,73.55,-319,-245.45,0.42138364779874216,0.3540856031128405,0.8581081081081081
2021,Sacramento Kings,Washington,Justin Holiday,198.12,81.64656,SF,74,2057,261,662,0.394,177,482,0.367,50,62,0.806,29,161,190,128,57,33,70,154,749,401,305,12,-280,-384,38,89.05,-626,-536.95,0.3942598187311178,0.36721991701244816,0.8064516129032258
2021,Sacramento Kings,Washington,Justin Holiday,198.12,81.64656,SF,74,2057,261,662,0.394,177,482,0.367,50,62,0.806,29,161,190,128,57,33,70,154,749,401,305,12,-280,-384,38,89.05,-626,-536.95,0.3942598187311178,0.36721991701244816,0.8064516129032258
2021,Sacramento Kings,Washington,Justin Holiday,198.12,81.64656,SF,74,2057,261,662,0.394,177,482,0.367,50,62,0.806,29,161,190,128,57,33,70,154,749,401,305,12,-280,-384,38,89.05,-626,-536.95,0.3942598187311178,0.36721991701244816,0.8064516129032258
2021,Sacramento Kings,Washington,Justin Holiday,198.12,81.64656,SF,74,2057,261,662,0.394,177,482,0.367,50,62,0.806,29,161,190,128,57,33,70,154,749,401,305,12,-280,-384,38,89.05,-626,-536.95,0.3942598187311178,0.36721991701244816,0.8064516129032258
2021,Sacramento Kings,Washington,Justin Holiday,198.12,81.64656,SF,74,2057,261,662,0.394,177,482,0.367,50,62,0.806,29,161,190,128,57,33,70,154,749,401,305,12,-280,-384,38,89.05,-626,-536.95,0.3942598187311178,0.36721991701244816,0.8064516129032258
2021,Sacramento Kings,Washington,Justin Holiday,198.12,81.64656,SF,74,2057,261,662,0.394,177,482,0.367,50,62,0.806,29,161,190,128,57,33,70,154,749,401,305,12,-280,-384,38,89.05,-626,-536.95,0.3942598187311178,0.36721991701244816,0.8064516129032258
2021,Sacramento Kings,Washington,Justin Holiday,198.12,81.64656,SG,74,2057,261,662,0.394,177,482,0.367,50,62,0.806,29,161,190,128,57,33,70,154,749,401,305,12,-280,-384,38,89.05,-626,-536.95,0.3942598187311178,0.36721991701244816,0.8064516129032258
2021,Sacramento Kings,Washington,Justin Holiday,198.12,81.64656,SG,74,2057,261,662,0.394,177,482,0.367,50,62,0.806,29,161,190,128,57,33,70,154,749,401,305,12,-280,-384,38,89.05,-626,-536.95,0.3942598187311178,0.36721991701244816,0.8064516129032258
2021,Sacramento Kings,Washington,Justin Holiday,198.12,81.64656,SG,74,2057,261,662,0.394,177,482,0.367,50,62,0.806,29,161,190,128,57,33,70,154,749,401,305,12,-280,-384,38,89.05,-626,-536.95,0.3942598187311178,0.36721991701244816,0.8064516129032258
2021,Oklahoma City Thunder,,Darius Bazley,203.2,94.347136,PF,69,1924,274,649,0.422,80,269,0.297,117,170,0.688,71,365,436,97,58,70,90,68,745,375,189,53,-202,-327,64,166.6,-465,-298.4,0.4221879815100154,0.29739776951672864,0.6882352941176471
2021,New Orleans Pelicans,Alabama,Herbert Jones,200.66,93.439952,PF,78,2335,274,576,0.476,57,169,0.337,137,163,0.84,98,198,296,167,130,60,100,238,742,302,112,26,-56,-165,111,173.35,-110,63.349999999999994,0.4756944444444444,0.33727810650887574,0.8404907975460123
2021,Milwaukee Bucks,Duke,Grayson Allen,193.04,89.811216,SG,66,1805,255,569,0.448,159,389,0.409,64,74,0.865,32,190,222,100,46,18,43,96,733,314,230,10,-118,-213,54,94.2,-277,-182.8,0.44815465729349735,0.4087403598971722,0.8648648648648649
2021,Miami Heat,DePaul,Max Strus,195.58,97.52228,SF,68,1587,249,564,0.441,181,442,0.41,42,53,0.792,24,178,202,92,28,16,57,116,721,315,261,11,-132,-240,31,67.2,-341,-273.8,0.44148936170212766,0.4095022624434389,0.7924528301886793
2021,Indiana Pacers,Oregon,Chris Duarte,195.58,86.18248,SG,55,1541,268,621,0.432,94,255,0.369,90,112,0.804,41,185,226,114,56,10,90,95,720,353,161,22,-170,-201,68,78.5,-303,-224.5,0.43156199677938806,0.3686274509803922,0.8035714285714286
2021,Dallas Mavericks,Stanford,Dwight Powell,208.28,108.86208,C,82,1798,269,401,0.671,13,37,0.351,166,212,0.783,173,231,404,97,37,39,64,220,717,132,24,46,274,-33,120,163.5,361,524.5,0.6708229426433915,0.35135135135135137,0.7830188679245284
2021,Cleveland Cavaliers,,Cedi Osman,200.66,104.32616,SF,66,1462,247,572,0.432,128,359,0.357,87,131,0.664,25,121,146,135,52,10,67,127,709,325,231,44,-156,-309,43,67.65,-422,-354.35,0.4318181818181818,0.3565459610027855,0.6641221374045801
2021,Atlanta Hawks,Virginia,De'Andre Hunter,203.2,100.243832,SF,53,1577,254,575,0.442,74,195,0.379,127,166,0.765,26,150,176,68,36,21,69,155,709,321,121,39,-134,-141,88,53.75,-187,-133.25,0.44173913043478263,0.37948717948717947,0.7650602409638554
2021,Boston Celtics,Florida,Al Horford,205.74,108.86208,C,69,2005,266,569,0.467,89,265,0.336,80,95,0.842,108,422,530,232,49,92,65,130,701,303,176,15,-74,-261,65,249.0,-270,-21.0,0.46748681898066785,0.33584905660377357,0.8421052631578947
2021,Philadelphia 76ers,Iowa State,Georges Niang,200.66,104.32616,PF,76,1736,246,563,0.437,156,387,0.403,52,59,0.881,25,178,203,102,30,13,59,190,700,317,231,7,-142,-225,45,65.0,-322,-257.0,0.4369449378330373,0.40310077519379844,0.8813559322033898
2021,Denver Nuggets,Virginia Commonwealth,Bones Hyland,187.96,76.657048,SG,69,1310,230,571,0.403,131,358,0.366,107,125,0.856,14,174,188,191,41,20,86,153,698,341,227,18,-222,-288,89,78.1,-421,-342.9,0.4028021015761821,0.3659217877094972,0.856
2021,Portland Trail Blazers,Weber State,Damian Lillard,187.96,88.45044,PG,29,1056,222,552,0.402,92,284,0.324,159,181,0.878,13,107,120,212,17,11,83,37,695,330,192,22,-216,-300,137,56.9,-379,-322.1,0.40217391304347827,0.323943661971831,0.8784530386740331
2021,Utah Jazz,Virginia Tech,Nickeil Alexander-Walker,195.58,92.98636,SG,65,1466,253,680,0.372,105,338,0.311,81,109,0.743,37,150,187,156,46,23,93,103,692,427,233,28,-348,-384,53,77.85,-679,-601.15,0.3720588235294118,0.3106508875739645,0.7431192660550459
2021,Utah Jazz,Virginia Tech,Nickeil Alexander-Walker,195.58,92.98636,SG,65,1466,253,680,0.372,105,338,0.311,81,109,0.743,37,150,187,156,46,23,93,103,692,427,233,28,-348,-384,53,77.85,-679,-601.15,0.3720588235294118,0.3106508875739645,0.7431192660550459
2021,Utah Jazz,Virginia Tech,Nickeil Alexander-Walker,195.58,92.98636,SG,65,1466,253,680,0.372,105,338,0.311,81,109,0.743,37,150,187,156,46,23,93,103,692,427,233,28,-348,-384,53,77.85,-679,-601.15,0.3720588235294118,0.3106508875739645,0.7431192660550459
2021,Utah Jazz,Virginia Tech,Nickeil Alexander-Walker,195.58,92.98636,SG,65,1466,253,680,0.372,105,338,0.311,81,109,0.743,37,150,187,156,46,23,93,103,692,427,233,28,-348,-384,53,77.85,-679,-601.15,0.3720588235294118,0.3106508875739645,0.7431192660550459
2021,Utah Jazz,Virginia Tech,Nickeil Alexander-Walker,195.58,92.98636,SG,65,1466,253,680,0.372,105,338,0.311,81,109,0.743,37,150,187,156,46,23,93,103,692,427,233,28,-348,-384,53,77.85,-679,-601.15,0.3720588235294118,0.3106508875739645,0.7431192660550459
2021,Utah Jazz,Virginia Tech,Nickeil Alexander-Walker,195.58,92.98636,SG,65,1466,253,680,0.372,105,338,0.311,81,109,0.743,37,150,187,156,46,23,93,103,692,427,233,28,-348,-384,53,77.85,-679,-601.15,0.3720588235294118,0.3106508875739645,0.7431192660550459
2021,Utah Jazz,Virginia Tech,Nickeil Alexander-Walker,195.58,92.98636,SG,65,1466,253,680,0.372,105,338,0.311,81,109,0.743,37,150,187,156,46,23,93,103,692,427,233,28,-348,-384,53,77.85,-679,-601.15,0.3720588235294118,0.3106508875739645,0.7431192660550459
2021,Utah Jazz,Virginia Tech,Nickeil Alexander-Walker,195.58,92.98636,SG,65,1466,253,680,0.372,105,338,0.311,81,109,0.743,37,150,187,156,46,23,93,103,692,427,233,28,-348,-384,53,77.85,-679,-601.15,0.3720588235294118,0.3106508875739645,0.7431192660550459
2021,Utah Jazz,Virginia Tech,Nickeil Alexander-Walker,195.58,92.98636,SG,65,1466,253,680,0.372,105,338,0.311,81,109,0.743,37,150,187,156,46,23,93,103,692,427,233,28,-348,-384,53,77.85,-679,-601.15,0.3720588235294118,0.3106508875739645,0.7431192660550459
2021,Indiana Pacers,Virginia,Malcolm Brogdon,195.58,103.872568,PG,36,1206,243,543,0.448,58,186,0.312,143,167,0.856,33,152,185,212,30,14,77,71,687,300,128,24,-114,-210,119,87.45,-205,-117.55,0.44751381215469616,0.3118279569892473,0.8562874251497006
2021,Washington Wizards,,Deni Avdija,205.74,95.25432,SF,82,1984,250,579,0.432,82,259,0.317,103,136,0.757,52,373,425,167,59,44,87,190,685,329,177,33,-158,-285,70,159.5,-373,-213.5,0.4317789291882556,0.3166023166023166,0.7573529411764706
2021,Phoenix Suns,Nevada-Reno,JaVale McGee,213.36,122.46984,C,74,1172,288,458,0.629,2,9,0.222,102,146,0.699,163,333,496,42,22,81,98,181,680,170,7,44,236,-15,58,168.7,279,447.7,0.62882096069869,0.2222222222222222,0.6986301369863014
2021,Chicago Bulls,Illinois,Ayo Dosunmu,193.04,90.7184,SG,77,2110,278,535,0.52,70,186,0.376,53,78,0.679,27,187,214,256,60,29,108,182,679,257,116,25,42,-138,28,105.65,-68,37.650000000000006,0.5196261682242991,0.3763440860215054,0.6794871794871795
2021,Orlando Magic,Michigan State,Gary Harris,193.04,95.25432,SG,61,1730,240,553,0.434,116,302,0.384,83,95,0.874,36,86,122,108,59,9,61,112,679,313,186,12,-146,-210,71,64.4,-285,-220.6,0.43399638336347196,0.3841059602649007,0.8736842105263158
2021,Washington Wizards,Arkansas,Daniel Gafford,205.74,106.140528,C,72,1444,285,411,0.693,0,1,0.0,107,153,0.699,155,252,407,68,30,99,65,170,677,126,1,46,318,-3,61,181.0,376,557.0,0.6934306569343066,0.0,0.6993464052287581
2021,Oklahoma City Thunder,,Josh Giddey,203.2,92.98636,SF,54,1700,281,670,0.419,56,213,0.263,56,79,0.709,98,323,421,345,51,20,171,88,674,389,157,23,-216,-303,33,161.6,-486,-324.4,0.41940298507462687,0.26291079812206575,0.7088607594936709
2021,Charlotte Hornets,Kentucky,P.J. Washington,200.66,104.32616,C,65,1768,250,532,0.47,110,301,0.365,58,81,0.716,82,255,337,147,57,61,82,152,668,282,191,23,-64,-243,35,151.9,-272,-120.1,0.4699248120300752,0.3654485049833887,0.7160493827160493
2021,Memphis Grizzlies,Gonzaga,Brandon Clarke,203.2,97.52228,PF,64,1246,288,447,0.644,5,22,0.227,85,130,0.654,135,207,342,86,39,68,34,122,666,159,17,45,258,-36,40,171.15,262,433.15,0.6442953020134228,0.22727272727272727,0.6538461538461539
2021,San Antonio Spurs,Tennessee,Josh Richardson,195.58,90.7184,SG,65,1600,234,534,0.438,102,246,0.415,96,108,0.889,42,143,185,115,56,29,66,116,666,300,144,12,-132,-126,84,89.2,-174,-84.8,0.43820224719101125,0.4146341463414634,0.8888888888888888
2021,San Antonio Spurs,Tennessee,Josh Richardson,195.58,90.7184,SG,65,1600,234,534,0.438,102,246,0.415,96,108,0.889,42,143,185,115,56,29,66,116,666,300,144,12,-132,-126,84,89.2,-174,-84.8,0.43820224719101125,0.4146341463414634,0.8888888888888888
2021,San Antonio Spurs,Tennessee,Josh Richardson,195.58,90.7184,SG,65,1600,234,534,0.438,102,246,0.415,96,108,0.889,42,143,185,115,56,29,66,116,666,300,144,12,-132,-126,84,89.2,-174,-84.8,0.43820224719101125,0.4146341463414634,0.8888888888888888
2021,San Antonio Spurs,Tennessee,Josh Richardson,195.58,90.7184,SG,65,1600,234,534,0.438,102,246,0.415,96,108,0.889,42,143,185,115,56,29,66,116,666,300,144,12,-132,-126,84,89.2,-174,-84.8,0.43820224719101125,0.4146341463414634,0.8888888888888888
2021,San Antonio Spurs,Tennessee,Josh Richardson,195.58,90.7184,SG,65,1600,234,534,0.438,102,246,0.415,96,108,0.889,42,143,185,115,56,29,66,116,666,300,144,12,-132,-126,84,89.2,-174,-84.8,0.43820224719101125,0.4146341463414634,0.8888888888888888
2021,San Antonio Spurs,Tennessee,Josh Richardson,195.58,90.7184,SG,65,1600,234,534,0.438,102,246,0.415,96,108,0.889,42,143,185,115,56,29,66,116,666,300,144,12,-132,-126,84,89.2,-174,-84.8,0.43820224719101125,0.4146341463414634,0.8888888888888888
2021,San Antonio Spurs,Tennessee,Josh Richardson,195.58,90.7184,SG,65,1600,234,534,0.438,102,246,0.415,96,108,0.889,42,143,185,115,56,29,66,116,666,300,144,12,-132,-126,84,89.2,-174,-84.8,0.43820224719101125,0.4146341463414634,0.8888888888888888
2021,San Antonio Spurs,Tennessee,Josh Richardson,195.58,90.7184,SG,65,1600,234,534,0.438,102,246,0.415,96,108,0.889,42,143,185,115,56,29,66,116,666,300,144,12,-132,-126,84,89.2,-174,-84.8,0.43820224719101125,0.4146341463414634,0.8888888888888888
2021,San Antonio Spurs,Tennessee,Josh Richardson,195.58,90.7184,SG,65,1600,234,534,0.438,102,246,0.415,96,108,0.889,42,143,185,115,56,29,66,116,666,300,144,12,-132,-126,84,89.2,-174,-84.8,0.43820224719101125,0.4146341463414634,0.8888888888888888
2021,Toronto Raptors,Memphis,Precious Achiuwa,203.2,102.0582,C,73,1725,265,603,0.439,56,156,0.359,78,131,0.595,146,327,473,82,37,41,84,151,664,338,100,53,-146,-132,25,164.7,-253,-88.30000000000001,0.439469320066335,0.358974358974359,0.5954198473282443
2021,Denver Nuggets,Michigan State,Bryn Forbes,187.96,92.98636,SG,75,1286,231,539,0.429,122,295,0.414,79,87,0.908,10,83,93,75,25,5,56,95,663,308,173,8,-154,-153,71,26.75,-236,-209.25,0.42857142857142855,0.4135593220338983,0.9080459770114943
2021,Denver Nuggets,Michigan State,Bryn Forbes,187.96,92.98636,SG,75,1286,231,539,0.429,122,295,0.414,79,87,0.908,10,83,93,75,25,5,56,95,663,308,173,8,-154,-153,71,26.75,-236,-209.25,0.42857142857142855,0.4135593220338983,0.9080459770114943
2021,Denver Nuggets,Michigan State,Bryn Forbes,187.96,92.98636,SG,75,1286,231,539,0.429,122,295,0.414,79,87,0.908,10,83,93,75,25,5,56,95,663,308,173,8,-154,-153,71,26.75,-236,-209.25,0.42857142857142855,0.4135593220338983,0.9080459770114943
2021,Denver Nuggets,Michigan State,Bryn Forbes,187.96,92.98636,SG,75,1286,231,539,0.429,122,295,0.414,79,87,0.908,10,83,93,75,25,5,56,95,663,308,173,8,-154,-153,71,26.75,-236,-209.25,0.42857142857142855,0.4135593220338983,0.9080459770114943
2021,Denver Nuggets,Michigan State,Bryn Forbes,187.96,92.98636,SG,75,1286,231,539,0.429,122,295,0.414,79,87,0.908,10,83,93,75,25,5,56,95,663,308,173,8,-154,-153,71,26.75,-236,-209.25,0.42857142857142855,0.4135593220338983,0.9080459770114943
2021,Denver Nuggets,Michigan State,Bryn Forbes,187.96,92.98636,SG,75,1286,231,539,0.429,122,295,0.414,79,87,0.908,10,83,93,75,25,5,56,95,663,308,173,8,-154,-153,71,26.75,-236,-209.25,0.42857142857142855,0.4135593220338983,0.9080459770114943
2021,Denver Nuggets,Michigan State,Bryn Forbes,187.96,92.98636,SG,75,1286,231,539,0.429,122,295,0.414,79,87,0.908,10,83,93,75,25,5,56,95,663,308,173,8,-154,-153,71,26.75,-236,-209.25,0.42857142857142855,0.4135593220338983,0.9080459770114943
2021,Denver Nuggets,Michigan State,Bryn Forbes,187.96,92.98636,SG,75,1286,231,539,0.429,122,295,0.414,79,87,0.908,10,83,93,75,25,5,56,95,663,308,173,8,-154,-153,71,26.75,-236,-209.25,0.42857142857142855,0.4135593220338983,0.9080459770114943
2021,Denver Nuggets,Michigan State,Bryn Forbes,187.96,92.98636,SG,75,1286,231,539,0.429,122,295,0.414,79,87,0.908,10,83,93,75,25,5,56,95,663,308,173,8,-154,-153,71,26.75,-236,-209.25,0.42857142857142855,0.4135593220338983,0.9080459770114943
2021,Portland Trail Blazers,Kansas,Ben McLemore,190.5,88.45044,SG,64,1285,216,539,0.401,151,417,0.362,72,88,0.818,12,91,103,59,38,10,55,103,655,323,266,16,-214,-345,56,34.85,-503,-468.15,0.4007421150278293,0.36211031175059955,0.8181818181818182
2021,New Orleans Pelicans,Texas-Austin,Jaxson Hayes,210.82,99.79024,C,70,1398,245,398,0.616,20,57,0.351,144,188,0.766,115,200,315,43,33,55,54,155,654,153,37,44,184,-51,100,127.5,233,360.5,0.6155778894472361,0.3508771929824561,0.7659574468085106
2021,Golden State Warriors,,Jonathan Kuminga,200.66,102.0582,SF,70,1185,236,460,0.513,50,149,0.336,130,190,0.684,54,180,234,64,31,22,74,146,652,224,99,60,24,-147,70,70.2,-53,17.200000000000003,0.5130434782608696,0.33557046979865773,0.6842105263157895
2021,Golden State Warriors,Washington State,Klay Thompson,198.12,99.79024,SG,32,941,246,573,0.429,114,296,0.385,46,51,0.902,15,110,125,88,16,17,43,54,652,327,182,5,-162,-204,41,49.3,-325,-275.7,0.4293193717277487,0.38513513513513514,0.9019607843137255
2021,Houston Rockets,Lipscomb,Garrison Mathews,195.58,97.52228,SG,65,1712,184,461,0.399,139,386,0.36,143,180,0.794,32,158,190,64,57,24,41,168,650,277,247,37,-186,-324,106,83.1,-404,-320.9,0.39913232104121477,0.3601036269430052,0.7944444444444444
2021,New York Knicks,Dayton,Obi Toppin,205.74,99.79024,PF,72,1230,251,473,0.531,52,169,0.308,94,124,0.758,69,199,268,77,25,33,56,102,648,222,117,30,58,-195,64,99.4,-73,26.400000000000006,0.5306553911205074,0.3076923076923077,0.7580645161290323
2021,Brooklyn Nets,Miami,Bruce Brown,193.04,91.625584,SF,72,1774,256,506,0.506,38,94,0.404,97,128,0.758,100,245,345,148,77,52,56,176,647,250,56,31,12,-54,66,175.95,24,199.95,0.5059288537549407,0.40425531914893614,0.7578125
2021,Minnesota Timberwolves,Washington,Jaden McDaniels,205.74,83.91452,PF,70,1803,255,554,0.46,80,252,0.317,57,71,0.803,76,217,293,79,52,54,75,224,647,299,172,14,-88,-276,43,116.3,-321,-204.7,0.4602888086642599,0.31746031746031744,0.8028169014084507
2021,Milwaukee Bucks,Notre Dame,Pat Connaughton,195.58,94.800728,SF,65,1691,227,496,0.458,146,370,0.395,45,54,0.833,45,228,273,82,59,15,35,86,645,269,224,9,-84,-234,36,115.2,-282,-166.8,0.4576612903225806,0.3945945945945946,0.8333333333333334
2021,Minnesota Timberwolves,Louisiana State,Naz Reid,205.74,119.748288,C,77,1215,233,476,0.489,57,166,0.343,114,149,0.765,102,199,301,71,40,71,82,172,637,243,109,35,-20,-156,79,124.4,-97,27.400000000000006,0.4894957983193277,0.3433734939759036,0.7651006711409396
2021,Detroit Pistons,Kentucky,Hamidou Diallo,195.58,91.625584,SG,58,1269,261,526,0.496,23,93,0.247,91,140,0.65,69,208,277,73,71,17,58,143,636,265,70,49,-8,-141,42,112.6,-107,5.599999999999994,0.49619771863117873,0.24731182795698925,0.65
2021,Washington Wizards,Gonzaga,Corey Kispert,198.12,101.604608,SF,77,1801,234,514,0.455,112,320,0.35,54,62,0.871,53,156,209,85,35,22,50,93,634,280,208,8,-92,-288,46,85.6,-334,-248.4,0.45525291828793774,0.35,0.8709677419354839
2021,Phoenix Suns,Marquette,Jae Crowder,198.12,106.59412,PF,67,1886,217,544,0.399,127,365,0.348,71,90,0.789,30,324,354,124,95,30,55,173,632,327,238,19,-220,-333,52,153.35,-501,-347.65,0.39889705882352944,0.34794520547945207,0.7888888888888889
2021,Memphis Grizzlies,Duke,Tyus Jones,182.88,88.904032,PG,73,1549,249,552,0.451,80,205,0.39,54,66,0.818,17,159,176,324,66,2,46,32,632,303,125,12,-108,-135,42,138.65,-201,-62.349999999999994,0.45108695652173914,0.3902439024390244,0.8181818181818182
2021,Orlando Magic,Washington,Terrence Ross,198.12,93.439952,SG,63,1448,220,554,0.397,77,264,0.292,112,130,0.862,20,141,161,116,28,12,75,68,629,334,187,18,-228,-330,94,53.35,-464,-410.65,0.3971119133574007,0.2916666666666667,0.8615384615384616
2021,Phoenix Suns,Murray State,Cameron Payne,185.42,83.007336,PG,58,1278,240,587,0.409,71,211,0.336,75,89,0.843,24,151,175,282,40,17,103,119,626,347,140,14,-214,-207,61,91.3,-360,-268.7,0.4088586030664395,0.33649289099526064,0.8426966292134831
2021,Oklahoma City Thunder,Florida,Tre Mann,190.5,80.73937600000001,PG,60,1367,231,588,0.393,98,272,0.36,65,82,0.793,25,146,171,91,47,12,71,102,625,357,174,17,-252,-228,48,60.65,-432,-371.35,0.39285714285714285,0.3602941176470588,0.7926829268292683
2021,Los Angeles Clippers,Minnesota,Amir Coffey,200.66,95.25432,SG,69,1567,211,466,0.453,96,254,0.378,101,117,0.863,26,171,197,124,38,15,45,87,619,255,158,16,-88,-186,85,86.4,-189,-102.6,0.45278969957081544,0.3779527559055118,0.8632478632478633
2021,Indiana Pacers,Syracuse,Oshae Brissett,200.66,95.25432,SF,67,1564,208,506,0.411,83,237,0.35,114,164,0.695,108,250,358,72,44,29,54,116,613,298,154,50,-180,-213,64,138.2,-329,-190.8,0.41106719367588934,0.350210970464135,0.6951219512195121
2021,New York Knicks,Western Kentucky,Mitchell Robinson,213.36,108.86208,C,72,1848,261,343,0.761,0,0,0.0,88,181,0.486,295,322,617,38,58,133,60,195,610,82,0,93,358,0,-5,293.25,353,646.25,0.760932944606414,,0.4861878453038674
2021,Brooklyn Nets,Texas-Austin,LaMarcus Aldridge,210.82,113.398,C,47,1050,252,458,0.55,14,46,0.304,89,102,0.873,73,185,258,42,14,47,44,78,607,206,32,13,92,-54,76,97.85,114,211.85,0.5502183406113537,0.30434782608695654,0.8725490196078431
2021,Orlando Magic,Auburn,Chuma Okeke,198.12,103.872568,PF,70,1749,216,575,0.376,118,371,0.318,55,65,0.846,47,300,347,118,97,42,57,95,605,359,253,10,-286,-405,45,164.25,-646,-481.75,0.37565217391304345,0.31805929919137466,0.8461538461538461
2021,Los Angeles Clippers,Tennessee State,Robert Covington,200.66,94.800728,PF,71,1940,209,498,0.42,128,339,0.378,58,69,0.841,59,332,391,92,103,91,75,190,604,289,211,11,-160,-249,47,185.5,-362,-176.5,0.41967871485943775,0.3775811209439528,0.8405797101449275
2021,Los Angeles Clippers,Tennessee State,Robert Covington,200.66,94.800728,PF,71,1940,209,498,0.42,128,339,0.378,58,69,0.841,59,332,391,92,103,91,75,190,604,289,211,11,-160,-249,47,185.5,-362,-176.5,0.41967871485943775,0.3775811209439528,0.8405797101449275
2021,Los Angeles Clippers,Tennessee State,Robert Covington,200.66,94.800728,PF,71,1940,209,498,0.42,128,339,0.378,58,69,0.841,59,332,391,92,103,91,75,190,604,289,211,11,-160,-249,47,185.5,-362,-176.5,0.41967871485943775,0.3775811209439528,0.8405797101449275
2021,Los Angeles Clippers,Tennessee State,Robert Covington,200.66,94.800728,PF,71,1940,209,498,0.42,128,339,0.378,58,69,0.841,59,332,391,92,103,91,75,190,604,289,211,11,-160,-249,47,185.5,-362,-176.5,0.41967871485943775,0.3775811209439528,0.8405797101449275
2021,Los Angeles Clippers,Tennessee State,Robert Covington,200.66,94.800728,PF,71,1940,209,498,0.42,128,339,0.378,58,69,0.841,59,332,391,92,103,91,75,190,604,289,211,11,-160,-249,47,185.5,-362,-176.5,0.41967871485943775,0.3775811209439528,0.8405797101449275
2021,Los Angeles Clippers,Tennessee State,Robert Covington,200.66,94.800728,PF,71,1940,209,498,0.42,128,339,0.378,58,69,0.841,59,332,391,92,103,91,75,190,604,289,211,11,-160,-249,47,185.5,-362,-176.5,0.41967871485943775,0.3775811209439528,0.8405797101449275
2021,Los Angeles Clippers,Tennessee State,Robert Covington,200.66,94.800728,PF,71,1940,209,498,0.42,128,339,0.378,58,69,0.841,59,332,391,92,103,91,75,190,604,289,211,11,-160,-249,47,185.5,-362,-176.5,0.41967871485943775,0.3775811209439528,0.8405797101449275
2021,Los Angeles Clippers,Tennessee State,Robert Covington,200.66,94.800728,PF,71,1940,209,498,0.42,128,339,0.378,58,69,0.841,59,332,391,92,103,91,75,190,604,289,211,11,-160,-249,47,185.5,-362,-176.5,0.41967871485943775,0.3775811209439528,0.8405797101449275
2021,Los Angeles Clippers,Tennessee State,Robert Covington,200.66,94.800728,PF,71,1940,209,498,0.42,128,339,0.378,58,69,0.841,59,332,391,92,103,91,75,190,604,289,211,11,-160,-249,47,185.5,-362,-176.5,0.41967871485943775,0.3775811209439528,0.8405797101449275
2021,Boston Celtics,Tennessee,Grant Williams,198.12,107.047712,PF,77,1875,205,432,0.475,106,258,0.411,86,95,0.905,64,210,274,78,38,57,62,186,602,227,152,9,-44,-138,77,111.2,-105,6.200000000000003,0.47453703703703703,0.4108527131782946,0.9052631578947369
2021,Dallas Mavericks,Michigan,Tim Hardaway Jr.,195.58,92.98636,SG,42,1245,209,530,0.394,102,304,0.336,78,103,0.757,13,143,156,92,38,6,34,74,598,321,202,25,-224,-300,53,66.55,-471,-404.45,0.39433962264150946,0.3355263157894737,0.7572815533980582
2021,Los Angeles Lakers,Iowa State,Talen Horton-Tucker,193.04,106.140528,SG,60,1511,224,538,0.416,49,182,0.269,100,125,0.8,37,156,193,159,59,29,82,148,597,314,133,25,-180,-252,75,92.85,-357,-264.15,0.4163568773234201,0.2692307692307692,0.8
2021,Miami Heat,California-Santa Barbara,Gabe Vincent,190.5,90.7184,PG,68,1589,214,513,0.417,119,323,0.368,44,54,0.815,22,104,126,210,62,12,98,158,591,299,204,10,-170,-255,34,69.6,-391,-321.4,0.4171539961013645,0.3684210526315789,0.8148148148148148
2021,Memphis Grizzlies,Oregon,Dillon Brooks,200.66,102.0582,SF,32,885,227,526,0.432,46,149,0.309,90,106,0.849,29,73,102,88,36,8,50,105,590,299,103,16,-144,-171,74,46.5,-241,-194.5,0.43155893536121676,0.3087248322147651,0.8490566037735849
2021,Detroit Pistons,Washington,Isaiah Stewart,203.2,113.398,C,71,1816,250,490,0.51,15,46,0.326,74,103,0.718,226,391,617,82,22,78,85,211,589,240,31,29,20,-48,45,228.2,17,245.2,0.5102040816326531,0.32608695652173914,0.7184466019417476
2021,Cleveland Cavaliers,Auburn,Isaac Okoro,195.58,102.0582,SF,67,1981,207,431,0.48,55,157,0.35,119,155,0.768,72,129,201,121,56,22,58,164,588,224,102,36,-34,-141,83,100.3,-92,8.299999999999997,0.4802784222737819,0.3503184713375796,0.7677419354838709
2021,Houston Rockets,Arizona State,Josh Christopher,190.5,97.52228,SG,74,1334,224,500,0.448,56,189,0.296,83,113,0.735,52,134,186,150,65,13,114,97,587,276,133,30,-104,-231,53,74.15,-282,-207.85,0.448,0.2962962962962963,0.7345132743362832
2021,Brooklyn Nets,Connecticut,Andre Drummond,208.28,126.552168,C,73,1437,247,433,0.57,0,3,0.0,86,164,0.524,229,451,680,131,78,68,115,192,580,186,3,78,122,-9,8,265.9,121,386.9,0.5704387990762124,0.0,0.524390243902439
2021,Brooklyn Nets,Connecticut,Andre Drummond,208.28,126.552168,C,73,1437,247,433,0.57,0,3,0.0,86,164,0.524,229,451,680,131,78,68,115,192,580,186,3,78,122,-9,8,265.9,121,386.9,0.5704387990762124,0.0,0.524390243902439
2021,Brooklyn Nets,Connecticut,Andre Drummond,208.28,126.552168,C,73,1437,247,433,0.57,0,3,0.0,86,164,0.524,229,451,680,131,78,68,115,192,580,186,3,78,122,-9,8,265.9,121,386.9,0.5704387990762124,0.0,0.524390243902439
2021,Brooklyn Nets,Connecticut,Andre Drummond,208.28,126.552168,C,73,1437,247,433,0.57,0,3,0.0,86,164,0.524,229,451,680,131,78,68,115,192,580,186,3,78,122,-9,8,265.9,121,386.9,0.5704387990762124,0.0,0.524390243902439
2021,Brooklyn Nets,Connecticut,Andre Drummond,208.28,126.552168,C,73,1437,247,433,0.57,0,3,0.0,86,164,0.524,229,451,680,131,78,68,115,192,580,186,3,78,122,-9,8,265.9,121,386.9,0.5704387990762124,0.0,0.524390243902439
2021,Brooklyn Nets,Connecticut,Andre Drummond,208.28,126.552168,C,73,1437,247,433,0.57,0,3,0.0,86,164,0.524,229,451,680,131,78,68,115,192,580,186,3,78,122,-9,8,265.9,121,386.9,0.5704387990762124,0.0,0.524390243902439
2021,Brooklyn Nets,Connecticut,Andre Drummond,208.28,126.552168,C,73,1437,247,433,0.57,0,3,0.0,86,164,0.524,229,451,680,131,78,68,115,192,580,186,3,78,122,-9,8,265.9,121,386.9,0.5704387990762124,0.0,0.524390243902439
2021,Brooklyn Nets,Connecticut,Andre Drummond,208.28,126.552168,C,73,1437,247,433,0.57,0,3,0.0,86,164,0.524,229,451,680,131,78,68,115,192,580,186,3,78,122,-9,8,265.9,121,386.9,0.5704387990762124,0.0,0.524390243902439
2021,Brooklyn Nets,Connecticut,Andre Drummond,208.28,126.552168,C,73,1437,247,433,0.57,0,3,0.0,86,164,0.524,229,451,680,131,78,68,115,192,580,186,3,78,122,-9,8,265.9,121,386.9,0.5704387990762124,0.0,0.524390243902439
2021,San Antonio Spurs,Creighton,Doug McDermott,200.66,102.0582,PF,51,1223,215,465,0.462,108,256,0.422,40,51,0.784,18,97,115,64,13,6,43,79,578,250,148,11,-70,-120,29,33.3,-161,-127.7,0.46236559139784944,0.421875,0.7843137254901961
2021,Phoenix Suns,Wichita State,Landry Shamet,193.04,86.18248,SG,69,1437,191,485,0.394,123,334,0.368,68,81,0.84,16,110,126,108,28,9,41,92,573,294,211,13,-206,-264,55,55.9,-415,-359.1,0.3938144329896907,0.36826347305389223,0.8395061728395061
2021,Brooklyn Nets,Louisiana State,Cam Thomas,190.5,95.25432,SG,67,1176,218,503,0.433,47,174,0.27,87,105,0.829,16,145,161,78,33,8,55,66,570,285,127,18,-134,-240,69,53.45,-305,-251.55,0.43339960238568587,0.27011494252873564,0.8285714285714286
2021,Utah Jazz,Baylor,Royce O'Neale,195.58,102.511792,SF,77,2406,203,444,0.457,119,306,0.389,45,56,0.804,64,304,368,191,86,32,79,183,570,241,187,11,-76,-204,34,166.1,-246,-79.9,0.4572072072072072,0.3888888888888889,0.8035714285714286
2021,Orlando Magic,Gonzaga,Jalen Suggs,195.58,92.98636,PG,48,1307,198,548,0.361,42,196,0.214,126,163,0.773,26,145,171,209,59,19,143,142,564,350,154,37,-304,-336,89,61.9,-551,-489.1,0.3613138686131387,0.21428571428571427,0.7730061349693251
2021,Orlando Magic,Michigan,Moritz Wagner,210.82,111.13004,C,63,960,197,396,0.497,66,201,0.328,104,129,0.806,42,190,232,87,20,13,56,123,564,199,135,25,-4,-207,79,72.6,-132,-59.400000000000006,0.49747474747474746,0.3283582089552239,0.8062015503875969
2021,Los Angeles Clippers,,Isaiah Hartenstein,213.36,113.398,C,68,1216,229,366,0.626,14,30,0.467,91,132,0.689,117,215,332,160,50,77,84,167,563,137,16,41,184,-6,50,165.4,228,393.4,0.6256830601092896,0.4666666666666667,0.6893939393939394
2021,Detroit Pistons,Duke,Frank Jackson,190.5,92.98636,PG,53,1164,194,483,0.402,86,279,0.308,86,104,0.827,19,68,87,55,27,9,38,89,560,289,193,18,-190,-321,68,34.8,-443,-408.2,0.40165631469979296,0.30824372759856633,0.8269230769230769
2021,Miami Heat,Nevada-Reno,Caleb Martin,195.58,92.98636,SF,60,1372,208,410,0.507,64,155,0.413,71,93,0.763,70,160,230,64,58,30,52,104,551,202,91,22,12,-81,49,103.8,-20,83.8,0.5073170731707317,0.4129032258064516,0.7634408602150538
2021,Portland Trail Blazers,Oregon State,Drew Eubanks,205.74,111.13004,C,71,1245,221,371,0.596,5,23,0.217,99,130,0.762,130,252,382,85,31,40,81,122,546,150,18,31,142,-39,68,138.15,171,309.15,0.5956873315363881,0.21739130434782608,0.7615384615384615
2021,Portland Trail Blazers,Oregon State,Drew Eubanks,205.74,111.13004,C,71,1245,221,371,0.596,5,23,0.217,99,130,0.762,130,252,382,85,31,40,81,122,546,150,18,31,142,-39,68,138.15,171,309.15,0.5956873315363881,0.21739130434782608,0.7615384615384615
2021,Portland Trail Blazers,Oregon State,Drew Eubanks,205.74,111.13004,C,71,1245,221,371,0.596,5,23,0.217,99,130,0.762,130,252,382,85,31,40,81,122,546,150,18,31,142,-39,68,138.15,171,309.15,0.5956873315363881,0.21739130434782608,0.7615384615384615
2021,Portland Trail Blazers,Oregon State,Drew Eubanks,205.74,111.13004,C,71,1245,221,371,0.596,5,23,0.217,99,130,0.762,130,252,382,85,31,40,81,122,546,150,18,31,142,-39,68,138.15,171,309.15,0.5956873315363881,0.21739130434782608,0.7615384615384615
2021,Portland Trail Blazers,Oregon State,Drew Eubanks,205.74,111.13004,C,71,1245,221,371,0.596,5,23,0.217,99,130,0.762,130,252,382,85,31,40,81,122,546,150,18,31,142,-39,68,138.15,171,309.15,0.5956873315363881,0.21739130434782608,0.7615384615384615
2021,Portland Trail Blazers,Oregon State,Drew Eubanks,205.74,111.13004,C,71,1245,221,371,0.596,5,23,0.217,99,130,0.762,130,252,382,85,31,40,81,122,546,150,18,31,142,-39,68,138.15,171,309.15,0.5956873315363881,0.21739130434782608,0.7615384615384615
2021,Portland Trail Blazers,Oregon State,Drew Eubanks,205.74,111.13004,C,71,1245,221,371,0.596,5,23,0.217,99,130,0.762,130,252,382,85,31,40,81,122,546,150,18,31,142,-39,68,138.15,171,309.15,0.5956873315363881,0.21739130434782608,0.7615384615384615
2021,Portland Trail Blazers,Oregon State,Drew Eubanks,205.74,111.13004,C,71,1245,221,371,0.596,5,23,0.217,99,130,0.762,130,252,382,85,31,40,81,122,546,150,18,31,142,-39,68,138.15,171,309.15,0.5956873315363881,0.21739130434782608,0.7615384615384615
2021,Portland Trail Blazers,Oregon State,Drew Eubanks,205.74,111.13004,C,71,1245,221,371,0.596,5,23,0.217,99,130,0.762,130,252,382,85,31,40,81,122,546,150,18,31,142,-39,68,138.15,171,309.15,0.5956873315363881,0.21739130434782608,0.7615384615384615
2021,Charlotte Hornets,Nevada-Reno,Cody Martin,198.12,92.98636,SF,71,1866,204,423,0.482,61,159,0.384,75,107,0.701,82,203,285,179,88,32,61,116,544,219,98,32,-30,-111,43,160.2,-98,62.19999999999999,0.48226950354609927,0.3836477987421384,0.7009345794392523
2021,Detroit Pistons,Duke,Marvin Bagley III,210.82,106.59412,PF,48,1146,225,446,0.504,23,97,0.237,67,101,0.663,105,233,338,36,22,18,39,93,540,221,74,34,8,-153,33,115.6,-112,3.5999999999999943,0.5044843049327354,0.23711340206185566,0.6633663366336634
2021,Detroit Pistons,Duke,Marvin Bagley III,210.82,106.59412,PF,48,1146,225,446,0.504,23,97,0.237,67,101,0.663,105,233,338,36,22,18,39,93,540,221,74,34,8,-153,33,115.6,-112,3.5999999999999943,0.5044843049327354,0.23711340206185566,0.6633663366336634
2021,Detroit Pistons,Duke,Marvin Bagley III,210.82,106.59412,PF,48,1146,225,446,0.504,23,97,0.237,67,101,0.663,105,233,338,36,22,18,39,93,540,221,74,34,8,-153,33,115.6,-112,3.5999999999999943,0.5044843049327354,0.23711340206185566,0.6633663366336634
2021,Detroit Pistons,Duke,Marvin Bagley III,210.82,106.59412,PF,48,1146,225,446,0.504,23,97,0.237,67,101,0.663,105,233,338,36,22,18,39,93,540,221,74,34,8,-153,33,115.6,-112,3.5999999999999943,0.5044843049327354,0.23711340206185566,0.6633663366336634
2021,Detroit Pistons,Duke,Marvin Bagley III,210.82,106.59412,PF,48,1146,225,446,0.504,23,97,0.237,67,101,0.663,105,233,338,36,22,18,39,93,540,221,74,34,8,-153,33,115.6,-112,3.5999999999999943,0.5044843049327354,0.23711340206185566,0.6633663366336634
2021,Detroit Pistons,Duke,Marvin Bagley III,210.82,106.59412,PF,48,1146,225,446,0.504,23,97,0.237,67,101,0.663,105,233,338,36,22,18,39,93,540,221,74,34,8,-153,33,115.6,-112,3.5999999999999943,0.5044843049327354,0.23711340206185566,0.6633663366336634
2021,Detroit Pistons,Duke,Marvin Bagley III,210.82,106.59412,PF,48,1146,225,446,0.504,23,97,0.237,67,101,0.663,105,233,338,36,22,18,39,93,540,221,74,34,8,-153,33,115.6,-112,3.5999999999999943,0.5044843049327354,0.23711340206185566,0.6633663366336634
2021,Detroit Pistons,Duke,Marvin Bagley III,210.82,106.59412,PF,48,1146,225,446,0.504,23,97,0.237,67,101,0.663,105,233,338,36,22,18,39,93,540,221,74,34,8,-153,33,115.6,-112,3.5999999999999943,0.5044843049327354,0.23711340206185566,0.6633663366336634
2021,Detroit Pistons,Duke,Marvin Bagley III,210.82,106.59412,PF,48,1146,225,446,0.504,23,97,0.237,67,101,0.663,105,233,338,36,22,18,39,93,540,221,74,34,8,-153,33,115.6,-112,3.5999999999999943,0.5044843049327354,0.23711340206185566,0.6633663366336634
2021,Indiana Pacers,Texas-Austin,Myles Turner,210.82,113.398,C,42,1235,200,393,0.509,61,183,0.333,79,105,0.752,65,232,297,44,28,118,54,119,540,193,122,26,14,-183,53,141.55,-116,25.55000000000001,0.5089058524173028,0.3333333333333333,0.7523809523809524
2021,Miami Heat,Texas-Austin,P.J. Tucker,195.58,111.13004,PF,71,1981,207,428,0.484,80,193,0.415,45,61,0.738,100,287,387,149,58,15,66,161,539,221,113,16,-28,-99,29,154.45,-98,56.44999999999999,0.48364485981308414,0.41450777202072536,0.7377049180327869
2021,Sacramento Kings,Southern California,Chimezie Metu,205.74,102.0582,C,60,1279,203,449,0.452,57,186,0.306,71,91,0.78,34,301,335,60,51,32,61,93,534,246,129,20,-86,-216,51,113.6,-251,-137.4,0.4521158129175947,0.3064516129032258,0.7802197802197802
2021,Portland Trail Blazers,Kentucky,Eric Bledsoe,185.42,97.068688,PG,54,1361,197,468,0.421,51,163,0.313,89,117,0.761,28,154,182,225,69,19,116,85,534,271,112,28,-148,-183,61,90.5,-270,-179.5,0.42094017094017094,0.3128834355828221,0.7606837606837606
2021,Utah Jazz,Marshall,Hassan Whiteside,213.36,120.20188,C,65,1162,215,330,0.652,0,0,0.0,104,167,0.623,166,328,494,26,22,103,53,179,534,115,0,63,200,0,41,198.55,241,439.55,0.6515151515151515,,0.6227544910179641
2021,Minnesota Timberwolves,Arkansas,Patrick Beverley,185.42,81.64656,PG,58,1476,177,436,0.406,83,242,0.343,96,133,0.722,62,178,240,268,67,52,73,174,533,259,159,37,-164,-228,59,156.8,-333,-176.2,0.4059633027522936,0.34297520661157027,0.7218045112781954
2021,Memphis Grizzlies,Pittsburgh,Steven Adams,210.82,120.20188,C,76,1999,210,384,0.547,0,1,0.0,108,199,0.543,349,411,760,256,65,60,115,153,528,174,1,91,72,-3,17,338.6,86,424.6,0.546875,0.0,0.542713567839196
2021,Minnesota Timberwolves,Washington,Jaylen Nowell,193.04,91.171992,SG,62,975,196,413,0.475,63,160,0.394,72,92,0.783,22,101,123,130,27,10,36,73,527,217,97,20,-42,-102,52,65.6,-92,-26.400000000000006,0.4745762711864407,0.39375,0.782608695652174
2021,Washington Wizards,,Raul Neto,187.96,81.64656,PG,70,1372,204,441,0.463,35,120,0.292,83,108,0.769,13,121,134,217,55,3,79,104,526,237,85,25,-66,-150,58,75.3,-158,-82.7,0.46258503401360546,0.2916666666666667,0.7685185185185185
2021,Detroit Pistons,Texas-Austin,Cory Joseph,190.5,90.7184,PG,65,1600,178,400,0.445,65,157,0.414,100,113,0.885,29,145,174,237,42,17,85,147,521,222,92,13,-88,-81,87,89.65,-82,7.650000000000006,0.445,0.4140127388535032,0.8849557522123894
2021,Memphis Grizzlies,UCLA,Kyle Anderson,205.74,104.32616,PF,69,1484,209,469,0.446,36,109,0.33,67,105,0.638,69,299,368,183,77,45,71,108,521,260,73,38,-102,-111,29,175.1,-184,-8.900000000000006,0.44562899786780386,0.3302752293577982,0.638095238095238
2021,Phoenix Suns,South Carolina Upstate,Torrey Craig,200.66,100.243832,SF,78,1596,200,441,0.454,77,234,0.329,39,52,0.75,86,224,310,91,46,36,67,151,516,241,157,13,-82,-240,26,121.7,-296,-174.3,0.45351473922902497,0.32905982905982906,0.75
2021,Phoenix Suns,South Carolina Upstate,Torrey Craig,200.66,100.243832,SF,78,1596,200,441,0.454,77,234,0.329,39,52,0.75,86,224,310,91,46,36,67,151,516,241,157,13,-82,-240,26,121.7,-296,-174.3,0.45351473922902497,0.32905982905982906,0.75
2021,Phoenix Suns,South Carolina Upstate,Torrey Craig,200.66,100.243832,SF,78,1596,200,441,0.454,77,234,0.329,39,52,0.75,86,224,310,91,46,36,67,151,516,241,157,13,-82,-240,26,121.7,-296,-174.3,0.45351473922902497,0.32905982905982906,0.75
2021,Phoenix Suns,South Carolina Upstate,Torrey Craig,200.66,100.243832,SF,78,1596,200,441,0.454,77,234,0.329,39,52,0.75,86,224,310,91,46,36,67,151,516,241,157,13,-82,-240,26,121.7,-296,-174.3,0.45351473922902497,0.32905982905982906,0.75
2021,Phoenix Suns,South Carolina Upstate,Torrey Craig,200.66,100.243832,SF,78,1596,200,441,0.454,77,234,0.329,39,52,0.75,86,224,310,91,46,36,67,151,516,241,157,13,-82,-240,26,121.7,-296,-174.3,0.45351473922902497,0.32905982905982906,0.75
2021,Phoenix Suns,South Carolina Upstate,Torrey Craig,200.66,100.243832,SF,78,1596,200,441,0.454,77,234,0.329,39,52,0.75,86,224,310,91,46,36,67,151,516,241,157,13,-82,-240,26,121.7,-296,-174.3,0.45351473922902497,0.32905982905982906,0.75
2021,Phoenix Suns,South Carolina Upstate,Torrey Craig,200.66,100.243832,SF,78,1596,200,441,0.454,77,234,0.329,39,52,0.75,86,224,310,91,46,36,67,151,516,241,157,13,-82,-240,26,121.7,-296,-174.3,0.45351473922902497,0.32905982905982906,0.75
2021,Phoenix Suns,South Carolina Upstate,Torrey Craig,200.66,100.243832,SF,78,1596,200,441,0.454,77,234,0.329,39,52,0.75,86,224,310,91,46,36,67,151,516,241,157,13,-82,-240,26,121.7,-296,-174.3,0.45351473922902497,0.32905982905982906,0.75
2021,Phoenix Suns,South Carolina Upstate,Torrey Craig,200.66,100.243832,SF,78,1596,200,441,0.454,77,234,0.329,39,52,0.75,86,224,310,91,46,36,67,151,516,241,157,13,-82,-240,26,121.7,-296,-174.3,0.45351473922902497,0.32905982905982906,0.75
2021,Golden State Warriors,Georgetown,Otto Porter Jr.,203.2,89.811216,PF,63,1396,193,416,0.464,80,216,0.37,49,61,0.803,86,276,362,94,68,29,37,83,515,223,136,12,-60,-168,37,161.35,-191,-29.650000000000006,0.4639423076923077,0.37037037037037035,0.8032786885245902
2021,Minnesota Timberwolves,Kentucky,Jarred Vanderbilt,205.74,97.068688,PF,74,1881,212,361,0.587,2,14,0.143,86,131,0.656,215,409,624,94,99,46,73,181,512,149,12,45,126,-30,41,260.2,137,397.2,0.5872576177285319,0.14285714285714285,0.6564885496183206
2021,Philadelphia 76ers,,Furkan Korkmaz,200.66,91.625584,SG,67,1414,182,470,0.387,77,266,0.289,68,84,0.81,22,153,175,127,33,9,48,58,509,288,189,16,-212,-336,52,75.1,-496,-420.9,0.3872340425531915,0.2894736842105263,0.8095238095238095
2021,Golden State Warriors,Oregon State,Gary Payton II,190.5,88.45044,SG,71,1248,212,344,0.616,43,120,0.358,35,58,0.603,72,175,247,64,96,22,40,131,502,132,77,23,160,-102,12,128.2,70,198.2,0.6162790697674418,0.35833333333333334,0.603448275862069
2021,Minnesota Timberwolves,Baylor,Taurean Prince,198.12,98.883056,PF,69,1177,177,390,0.454,86,229,0.376,62,82,0.756,26,148,174,68,47,23,53,116,502,213,143,20,-72,-171,42,69.7,-201,-131.3,0.45384615384615384,0.37554585152838427,0.7560975609756098
2021,Memphis Grizzlies,Stanford,Ziaire Williams,205.74,83.91452,SF,62,1346,191,424,0.45,76,242,0.314,43,55,0.782,26,103,129,65,35,12,41,113,501,233,166,12,-84,-270,31,52.35,-323,-270.65,0.45047169811320753,0.3140495867768595,0.7818181818181819
2021,New York Knicks,Duke,Cam Reddish,203.2,98.429464,SF,49,1012,165,408,0.404,66,184,0.359,101,112,0.902,25,80,105,48,47,15,57,60,497,243,118,11,-156,-156,90,44.0,-222,-178.0,0.40441176470588236,0.358695652173913,0.9017857142857143
2021,New York Knicks,Duke,Cam Reddish,203.2,98.429464,SF,49,1012,165,408,0.404,66,184,0.359,101,112,0.902,25,80,105,48,47,15,57,60,497,243,118,11,-156,-156,90,44.0,-222,-178.0,0.40441176470588236,0.358695652173913,0.9017857142857143
2021,New York Knicks,Duke,Cam Reddish,203.2,98.429464,SF,49,1012,165,408,0.404,66,184,0.359,101,112,0.902,25,80,105,48,47,15,57,60,497,243,118,11,-156,-156,90,44.0,-222,-178.0,0.40441176470588236,0.358695652173913,0.9017857142857143
2021,New York Knicks,Duke,Cam Reddish,203.2,98.429464,SF,49,1012,165,408,0.404,66,184,0.359,101,112,0.902,25,80,105,48,47,15,57,60,497,243,118,11,-156,-156,90,44.0,-222,-178.0,0.40441176470588236,0.358695652173913,0.9017857142857143
2021,New York Knicks,Duke,Cam Reddish,203.2,98.429464,SF,49,1012,165,408,0.404,66,184,0.359,101,112,0.902,25,80,105,48,47,15,57,60,497,243,118,11,-156,-156,90,44.0,-222,-178.0,0.40441176470588236,0.358695652173913,0.9017857142857143
2021,New York Knicks,Duke,Cam Reddish,203.2,98.429464,SF,49,1012,165,408,0.404,66,184,0.359,101,112,0.902,25,80,105,48,47,15,57,60,497,243,118,11,-156,-156,90,44.0,-222,-178.0,0.40441176470588236,0.358695652173913,0.9017857142857143
2021,New York Knicks,Duke,Cam Reddish,203.2,98.429464,SF,49,1012,165,408,0.404,66,184,0.359,101,112,0.902,25,80,105,48,47,15,57,60,497,243,118,11,-156,-156,90,44.0,-222,-178.0,0.40441176470588236,0.358695652173913,0.9017857142857143
2021,New York Knicks,Duke,Cam Reddish,203.2,98.429464,SF,49,1012,165,408,0.404,66,184,0.359,101,112,0.902,25,80,105,48,47,15,57,60,497,243,118,11,-156,-156,90,44.0,-222,-178.0,0.40441176470588236,0.358695652173913,0.9017857142857143
2021,New York Knicks,Duke,Cam Reddish,203.2,98.429464,SF,49,1012,165,408,0.404,66,184,0.359,101,112,0.902,25,80,105,48,47,15,57,60,497,243,118,11,-156,-156,90,44.0,-222,-178.0,0.40441176470588236,0.358695652173913,0.9017857142857143
2021,Golden State Warriors,UCLA,Kevon Looney,205.74,100.697424,C,82,1732,208,364,0.571,0,1,0.0,75,125,0.6,208,388,596,165,50,52,67,215,491,156,1,50,104,-3,25,249.0,126,375.0,0.5714285714285714,0.0,0.6
2021,Los Angeles Clippers,,Nicolas Batum,203.2,104.32616,PF,59,1463,179,387,0.463,108,270,0.4,25,38,0.658,29,225,254,100,58,42,40,80,491,208,162,13,-58,-162,12,121.75,-208,-86.25,0.4625322997416021,0.4,0.6578947368421053
2021,Orlando Magic,,R.J. Hampton,193.04,79.3786,SG,64,1402,175,457,0.383,64,183,0.35,75,117,0.641,23,171,194,158,42,13,87,101,489,282,119,42,-214,-165,33,72.7,-346,-273.3,0.38293216630196936,0.34972677595628415,0.6410256410256411
2021,Milwaukee Bucks,Louisville,Jordan Nwora,203.2,102.0582,SF,62,1185,186,462,0.403,79,227,0.348,36,43,0.837,37,184,221,59,25,17,57,78,487,276,148,7,-180,-207,29,67.85,-358,-290.15,0.4025974025974026,0.34801762114537443,0.8372093023255814
2021,Charlotte Hornets,Duke,Mason Plumlee,210.82,115.212368,C,73,1793,205,320,0.641,0,2,0.0,67,171,0.392,176,389,565,226,61,52,100,224,477,115,2,104,180,-6,-37,237.05,137,374.05,0.640625,0.0,0.391812865497076
2021,Washington Wizards,Gonzaga,Rui Hachimura,203.2,104.32616,PF,42,944,187,381,0.491,55,123,0.447,46,66,0.697,25,135,160,48,23,9,33,53,475,194,68,20,-14,-39,26,55.1,-27,28.1,0.49081364829396323,0.44715447154471544,0.696969696969697
2021,Indiana Pacers,Ohio State,Duane Washington Jr.,190.5,89.357624,PG,48,968,173,427,0.405,81,215,0.377,46,61,0.754,4,79,83,85,26,3,57,66,473,254,134,15,-162,-159,31,25.7,-290,-264.3,0.405152224824356,0.3767441860465116,0.7540983606557377
2021,Indiana Pacers,Maryland,Jalen Smith,208.28,97.52228,PF,51,924,176,350,0.503,40,122,0.328,78,102,0.765,101,206,307,24,15,41,42,96,470,174,82,24,4,-126,54,110.2,-68,42.2,0.5028571428571429,0.32786885245901637,0.7647058823529411
2021,Indiana Pacers,Maryland,Jalen Smith,208.28,97.52228,PF,51,924,176,350,0.503,40,122,0.328,78,102,0.765,101,206,307,24,15,41,42,96,470,174,82,24,4,-126,54,110.2,-68,42.2,0.5028571428571429,0.32786885245901637,0.7647058823529411
2021,Indiana Pacers,Maryland,Jalen Smith,208.28,97.52228,PF,51,924,176,350,0.503,40,122,0.328,78,102,0.765,101,206,307,24,15,41,42,96,470,174,82,24,4,-126,54,110.2,-68,42.2,0.5028571428571429,0.32786885245901637,0.7647058823529411
2021,Indiana Pacers,Maryland,Jalen Smith,208.28,97.52228,PF,51,924,176,350,0.503,40,122,0.328,78,102,0.765,101,206,307,24,15,41,42,96,470,174,82,24,4,-126,54,110.2,-68,42.2,0.5028571428571429,0.32786885245901637,0.7647058823529411
2021,Indiana Pacers,Maryland,Jalen Smith,208.28,97.52228,PF,51,924,176,350,0.503,40,122,0.328,78,102,0.765,101,206,307,24,15,41,42,96,470,174,82,24,4,-126,54,110.2,-68,42.2,0.5028571428571429,0.32786885245901637,0.7647058823529411
2021,Indiana Pacers,Maryland,Jalen Smith,208.28,97.52228,PF,51,924,176,350,0.503,40,122,0.328,78,102,0.765,101,206,307,24,15,41,42,96,470,174,82,24,4,-126,54,110.2,-68,42.2,0.5028571428571429,0.32786885245901637,0.7647058823529411
2021,Indiana Pacers,Maryland,Jalen Smith,208.28,97.52228,PF,51,924,176,350,0.503,40,122,0.328,78,102,0.765,101,206,307,24,15,41,42,96,470,174,82,24,4,-126,54,110.2,-68,42.2,0.5028571428571429,0.32786885245901637,0.7647058823529411
2021,Indiana Pacers,Maryland,Jalen Smith,208.28,97.52228,PF,51,924,176,350,0.503,40,122,0.328,78,102,0.765,101,206,307,24,15,41,42,96,470,174,82,24,4,-126,54,110.2,-68,42.2,0.5028571428571429,0.32786885245901637,0.7647058823529411
2021,Indiana Pacers,Maryland,Jalen Smith,208.28,97.52228,PF,51,924,176,350,0.503,40,122,0.328,78,102,0.765,101,206,307,24,15,41,42,96,470,174,82,24,4,-126,54,110.2,-68,42.2,0.5028571428571429,0.32786885245901637,0.7647058823529411
2021,Chicago Bulls,Radford,Javonte Green,195.58,92.98636,SF,65,1519,176,325,0.542,36,101,0.356,80,96,0.833,91,185,276,60,67,32,30,132,468,149,65,16,54,-87,64,134.65,31,165.65,0.5415384615384615,0.3564356435643564,0.8333333333333334
2021,Sacramento Kings,Bowling Green,Richaun Holmes,208.28,106.59412,C,45,1074,198,300,0.66,2,5,0.4,70,90,0.778,93,224,317,48,17,41,56,128,468,102,3,20,192,-3,50,109.1,239,348.1,0.66,0.4,0.7777777777777778
2021,Golden State Warriors,Drexel,Damion Lee,195.58,95.25432,SG,63,1257,169,383,0.441,63,187,0.337,66,75,0.88,27,176,203,63,39,6,38,95,467,214,124,9,-90,-183,57,72.0,-216,-144.0,0.4412532637075718,0.33689839572192515,0.88
2021,Chicago Bulls,UCLA,Lonzo Ball,198.12,86.18248,PG,35,1212,162,383,0.423,110,260,0.423,21,28,0.75,35,155,190,178,64,31,82,85,455,221,150,7,-118,-120,14,103.0,-224,-121.0,0.42297650130548303,0.4230769230769231,0.75
2021,Sacramento Kings,Vanderbilt,Damian Jones,210.82,111.13004,C,56,1017,175,266,0.658,10,29,0.345,94,131,0.718,75,171,246,69,26,47,59,130,454,91,19,37,168,-27,57,98.0,198,296.0,0.6578947368421053,0.3448275862068966,0.7175572519083969
2021,Oklahoma City Thunder,Nebraska-Lincoln,Isaiah Roby,203.2,104.32616,PF,45,948,166,323,0.514,44,99,0.444,78,116,0.672,75,142,217,71,36,34,43,109,454,157,55,38,18,-33,40,98.8,25,123.8,0.5139318885448917,0.4444444444444444,0.6724137931034483
2021,Detroit Pistons,,Killian Hayes,195.58,88.45044,PG,66,1647,176,459,0.383,44,167,0.263,57,74,0.77,36,174,210,277,78,35,111,183,453,283,123,17,-214,-237,40,122.6,-411,-288.4,0.38344226579520696,0.2634730538922156,0.7702702702702703
2021,Philadelphia 76ers,Southern Methodist,Shake Milton,195.58,92.98636,SG,55,1179,173,403,0.429,43,133,0.323,61,73,0.836,30,112,142,139,28,17,44,99,450,230,90,12,-114,-141,49,73.3,-206,-132.7,0.4292803970223325,0.3233082706766917,0.8356164383561644
2021,Utah Jazz,Connecticut,Rudy Gay,203.2,113.398,PF,55,1038,157,379,0.414,70,203,0.345,62,79,0.785,55,187,242,56,25,19,47,95,446,222,133,17,-130,-189,45,82.0,-274,-192.0,0.41424802110817943,0.3448275862068966,0.7848101265822784
2021,Indiana Pacers,,Ricky Rubio,187.96,86.18248,PG,34,970,149,411,0.363,59,174,0.339,88,103,0.854,15,126,141,225,49,7,90,75,445,262,115,15,-226,-168,73,74.5,-321,-246.5,0.36253041362530414,0.3390804597701149,0.8543689320388349
2021,Los Angeles Lakers,Oklahoma,Austin Reaves,195.58,89.357624,SG,61,1418,146,318,0.459,53,167,0.317,99,118,0.839,45,148,193,110,29,20,40,87,444,172,114,19,-52,-183,80,87.15,-155,-67.85,0.4591194968553459,0.31736526946107785,0.8389830508474576
2021,Boston Celtics,Oregon,Payton Pritchard,185.42,88.45044,PG,71,1001,160,373,0.429,101,245,0.412,21,21,1.0,32,102,134,139,25,6,41,61,442,213,144,0,-106,-129,21,68.2,-214,-145.8,0.4289544235924933,0.4122448979591837,1.0
2021,Golden State Warriors,,Nemanja Bjelica,205.74,106.140528,C,71,1142,160,342,0.468,54,149,0.362,59,81,0.728,62,232,294,159,41,26,87,128,433,182,95,22,-44,-123,37,112.35,-130,-17.650000000000006,0.4678362573099415,0.3624161073825503,0.7283950617283951
2021,Denver Nuggets,Alabama,JaMychal Green,203.2,102.965384,PF,67,1085,159,327,0.486,33,124,0.266,81,93,0.871,81,200,281,59,43,26,57,158,432,168,91,12,-18,-174,69,103.35,-123,-19.650000000000006,0.48623853211009177,0.2661290322580645,0.8709677419354839
2021,New York Knicks,Connecticut,Kemba Walker,182.88,83.46092800000001,PG,37,948,149,370,0.403,73,199,0.367,60,71,0.845,14,97,111,131,26,7,48,37,431,221,126,11,-144,-159,49,54.65,-254,-199.35,0.4027027027027027,0.36683417085427134,0.8450704225352113
2021,Denver Nuggets,Kentucky,DeMarcus Cousins,208.28,122.46984,C,48,717,149,324,0.46,37,122,0.303,95,125,0.76,74,196,270,71,35,21,85,139,430,175,85,30,-52,-144,65,82.3,-131,-48.7,0.45987654320987653,0.30327868852459017,0.76
2021,Denver Nuggets,Kentucky,DeMarcus Cousins,208.28,122.46984,C,48,717,149,324,0.46,37,122,0.303,95,125,0.76,74,196,270,71,35,21,85,139,430,175,85,30,-52,-144,65,82.3,-131,-48.7,0.45987654320987653,0.30327868852459017,0.76
2021,Denver Nuggets,Kentucky,DeMarcus Cousins,208.28,122.46984,C,48,717,149,324,0.46,37,122,0.303,95,125,0.76,74,196,270,71,35,21,85,139,430,175,85,30,-52,-144,65,82.3,-131,-48.7,0.45987654320987653,0.30327868852459017,0.76
2021,Denver Nuggets,Kentucky,DeMarcus Cousins,208.28,122.46984,C,48,717,149,324,0.46,37,122,0.303,95,125,0.76,74,196,270,71,35,21,85,139,430,175,85,30,-52,-144,65,82.3,-131,-48.7,0.45987654320987653,0.30327868852459017,0.76
2021,Denver Nuggets,Kentucky,DeMarcus Cousins,208.28,122.46984,C,48,717,149,324,0.46,37,122,0.303,95,125,0.76,74,196,270,71,35,21,85,139,430,175,85,30,-52,-144,65,82.3,-131,-48.7,0.45987654320987653,0.30327868852459017,0.76
2021,Denver Nuggets,Kentucky,DeMarcus Cousins,208.28,122.46984,C,48,717,149,324,0.46,37,122,0.303,95,125,0.76,74,196,270,71,35,21,85,139,430,175,85,30,-52,-144,65,82.3,-131,-48.7,0.45987654320987653,0.30327868852459017,0.76
2021,Denver Nuggets,Kentucky,DeMarcus Cousins,208.28,122.46984,C,48,717,149,324,0.46,37,122,0.303,95,125,0.76,74,196,270,71,35,21,85,139,430,175,85,30,-52,-144,65,82.3,-131,-48.7,0.45987654320987653,0.30327868852459017,0.76
2021,Denver Nuggets,Kentucky,DeMarcus Cousins,208.28,122.46984,C,48,717,149,324,0.46,37,122,0.303,95,125,0.76,74,196,270,71,35,21,85,139,430,175,85,30,-52,-144,65,82.3,-131,-48.7,0.45987654320987653,0.30327868852459017,0.76
2021,Denver Nuggets,Kentucky,DeMarcus Cousins,208.28,122.46984,C,48,717,149,324,0.46,37,122,0.303,95,125,0.76,74,196,270,71,35,21,85,139,430,175,85,30,-52,-144,65,82.3,-131,-48.7,0.45987654320987653,0.30327868852459017,0.76
2021,Miami Heat,Southern California,Dewayne Dedmon,213.36,111.13004,C,67,1065,164,290,0.566,19,47,0.404,75,100,0.75,105,281,386,47,24,42,70,174,422,126,28,25,76,-27,50,123.8,99,222.8,0.5655172413793104,0.40425531914893614,0.75
2021,Oklahoma City Thunder,Maryland,Aaron Wiggins,193.04,86.18248,SG,50,1209,156,337,0.463,42,138,0.304,62,85,0.729,51,127,178,68,30,10,54,93,416,181,96,23,-50,-162,39,62.6,-173,-110.4,0.4629080118694362,0.30434782608695654,0.7294117647058823
2021,San Antonio Spurs,Duke,Tre Jones,185.42,83.91452,PG,69,1148,166,339,0.49,10,51,0.196,71,91,0.78,29,126,155,233,42,7,46,78,413,173,41,20,-14,-93,51,101.85,-56,45.849999999999994,0.4896755162241888,0.19607843137254902,0.7802197802197802
2021,Dallas Mavericks,,Maxi Kleber,208.28,108.86208,PF,59,1450,141,354,0.398,83,255,0.325,46,65,0.708,70,280,350,68,30,58,47,137,411,213,172,19,-144,-267,27,135.65,-384,-248.35,0.3983050847457627,0.3254901960784314,0.7076923076923077
2021,Washington Wizards,Wake Forest,Ish Smith,182.88,79.3786,PG,65,1126,185,430,0.43,25,67,0.373,15,24,0.625,25,115,140,244,47,23,78,78,410,245,42,9,-120,-51,6,94.35,-165,-70.65,0.43023255813953487,0.373134328358209,0.625
2021,Washington Wizards,Wake Forest,Ish Smith,182.88,79.3786,PG,65,1126,185,430,0.43,25,67,0.373,15,24,0.625,25,115,140,244,47,23,78,78,410,245,42,9,-120,-51,6,94.35,-165,-70.65,0.43023255813953487,0.373134328358209,0.625
2021,Washington Wizards,Wake Forest,Ish Smith,182.88,79.3786,PG,65,1126,185,430,0.43,25,67,0.373,15,24,0.625,25,115,140,244,47,23,78,78,410,245,42,9,-120,-51,6,94.35,-165,-70.65,0.43023255813953487,0.373134328358209,0.625
2021,Washington Wizards,Wake Forest,Ish Smith,182.88,79.3786,PG,65,1126,185,430,0.43,25,67,0.373,15,24,0.625,25,115,140,244,47,23,78,78,410,245,42,9,-120,-51,6,94.35,-165,-70.65,0.43023255813953487,0.373134328358209,0.625
2021,Washington Wizards,Wake Forest,Ish Smith,182.88,79.3786,PG,65,1126,185,430,0.43,25,67,0.373,15,24,0.625,25,115,140,244,47,23,78,78,410,245,42,9,-120,-51,6,94.35,-165,-70.65,0.43023255813953487,0.373134328358209,0.625
2021,Washington Wizards,Wake Forest,Ish Smith,182.88,79.3786,PG,65,1126,185,430,0.43,25,67,0.373,15,24,0.625,25,115,140,244,47,23,78,78,410,245,42,9,-120,-51,6,94.35,-165,-70.65,0.43023255813953487,0.373134328358209,0.625
2021,Washington Wizards,Wake Forest,Ish Smith,182.88,79.3786,PG,65,1126,185,430,0.43,25,67,0.373,15,24,0.625,25,115,140,244,47,23,78,78,410,245,42,9,-120,-51,6,94.35,-165,-70.65,0.43023255813953487,0.373134328358209,0.625
2021,Washington Wizards,Wake Forest,Ish Smith,182.88,79.3786,PG,65,1126,185,430,0.43,25,67,0.373,15,24,0.625,25,115,140,244,47,23,78,78,410,245,42,9,-120,-51,6,94.35,-165,-70.65,0.43023255813953487,0.373134328358209,0.625
2021,Washington Wizards,Wake Forest,Ish Smith,182.88,79.3786,PG,65,1126,185,430,0.43,25,67,0.373,15,24,0.625,25,115,140,244,47,23,78,78,410,245,42,9,-120,-51,6,94.35,-165,-70.65,0.43023255813953487,0.373134328358209,0.625
2021,Sacramento Kings,Connecticut,Jeremy Lamb,195.58,81.64656,SF,56,936,133,347,0.383,55,170,0.324,89,106,0.84,26,128,154,81,31,22,37,59,410,214,115,17,-162,-180,72,70.3,-270,-199.7,0.38328530259365995,0.3235294117647059,0.839622641509434
2021,Sacramento Kings,Connecticut,Jeremy Lamb,195.58,81.64656,SF,56,936,133,347,0.383,55,170,0.324,89,106,0.84,26,128,154,81,31,22,37,59,410,214,115,17,-162,-180,72,70.3,-270,-199.7,0.38328530259365995,0.3235294117647059,0.839622641509434
2021,Sacramento Kings,Connecticut,Jeremy Lamb,195.58,81.64656,SF,56,936,133,347,0.383,55,170,0.324,89,106,0.84,26,128,154,81,31,22,37,59,410,214,115,17,-162,-180,72,70.3,-270,-199.7,0.38328530259365995,0.3235294117647059,0.839622641509434
2021,Sacramento Kings,Connecticut,Jeremy Lamb,195.58,81.64656,SF,56,936,133,347,0.383,55,170,0.324,89,106,0.84,26,128,154,81,31,22,37,59,410,214,115,17,-162,-180,72,70.3,-270,-199.7,0.38328530259365995,0.3235294117647059,0.839622641509434
2021,Sacramento Kings,Connecticut,Jeremy Lamb,195.58,81.64656,SF,56,936,133,347,0.383,55,170,0.324,89,106,0.84,26,128,154,81,31,22,37,59,410,214,115,17,-162,-180,72,70.3,-270,-199.7,0.38328530259365995,0.3235294117647059,0.839622641509434
2021,Sacramento Kings,Connecticut,Jeremy Lamb,195.58,81.64656,SF,56,936,133,347,0.383,55,170,0.324,89,106,0.84,26,128,154,81,31,22,37,59,410,214,115,17,-162,-180,72,70.3,-270,-199.7,0.38328530259365995,0.3235294117647059,0.839622641509434
2021,Sacramento Kings,Connecticut,Jeremy Lamb,195.58,81.64656,SG,56,936,133,347,0.383,55,170,0.324,89,106,0.84,26,128,154,81,31,22,37,59,410,214,115,17,-162,-180,72,70.3,-270,-199.7,0.38328530259365995,0.3235294117647059,0.839622641509434
2021,Sacramento Kings,Connecticut,Jeremy Lamb,195.58,81.64656,SG,56,936,133,347,0.383,55,170,0.324,89,106,0.84,26,128,154,81,31,22,37,59,410,214,115,17,-162,-180,72,70.3,-270,-199.7,0.38328530259365995,0.3235294117647059,0.839622641509434
2021,Sacramento Kings,Connecticut,Jeremy Lamb,195.58,81.64656,SG,56,936,133,347,0.383,55,170,0.324,89,106,0.84,26,128,154,81,31,22,37,59,410,214,115,17,-162,-180,72,70.3,-270,-199.7,0.38328530259365995,0.3235294117647059,0.839622641509434
2021,Portland Trail Blazers,North Carolina,Nassir Little,195.58,99.79024,SF,42,1088,145,315,0.46,51,154,0.331,69,94,0.734,58,178,236,54,25,36,40,82,410,170,103,25,-50,-156,44,93.4,-162,-68.6,0.4603174603174603,0.33116883116883117,0.7340425531914894
2021,Brooklyn Nets,Georgia,Nic Claxton,210.82,97.52228,C,47,974,178,264,0.674,0,0,0.0,54,93,0.581,91,173,264,43,24,51,38,110,410,86,0,39,184,0,15,112.5,199,311.5,0.6742424242424242,,0.5806451612903226
2021,Denver Nuggets,Duke,Austin Rivers,193.04,90.7184,SG,67,1480,146,350,0.417,79,231,0.342,32,44,0.727,19,95,114,90,51,6,54,121,403,204,152,12,-116,-219,20,51.2,-315,-263.8,0.41714285714285715,0.341991341991342,0.7272727272727273
2021,Phoenix Suns,UCLA,Aaron Holiday,182.88,83.91452,PG,63,1021,151,338,0.447,39,103,0.379,59,68,0.868,24,98,122,153,42,9,67,92,400,187,64,9,-72,-75,50,62.15,-97,-34.85,0.4467455621301775,0.3786407766990291,0.8676470588235294
2021,Phoenix Suns,UCLA,Aaron Holiday,182.88,83.91452,PG,63,1021,151,338,0.447,39,103,0.379,59,68,0.868,24,98,122,153,42,9,67,92,400,187,64,9,-72,-75,50,62.15,-97,-34.85,0.4467455621301775,0.3786407766990291,0.8676470588235294
2021,Phoenix Suns,UCLA,Aaron Holiday,182.88,83.91452,PG,63,1021,151,338,0.447,39,103,0.379,59,68,0.868,24,98,122,153,42,9,67,92,400,187,64,9,-72,-75,50,62.15,-97,-34.85,0.4467455621301775,0.3786407766990291,0.8676470588235294
2021,Phoenix Suns,UCLA,Aaron Holiday,182.88,83.91452,PG,63,1021,151,338,0.447,39,103,0.379,59,68,0.868,24,98,122,153,42,9,67,92,400,187,64,9,-72,-75,50,62.15,-97,-34.85,0.4467455621301775,0.3786407766990291,0.8676470588235294
2021,Phoenix Suns,UCLA,Aaron Holiday,182.88,83.91452,PG,63,1021,151,338,0.447,39,103,0.379,59,68,0.868,24,98,122,153,42,9,67,92,400,187,64,9,-72,-75,50,62.15,-97,-34.85,0.4467455621301775,0.3786407766990291,0.8676470588235294
2021,Phoenix Suns,UCLA,Aaron Holiday,182.88,83.91452,PG,63,1021,151,338,0.447,39,103,0.379,59,68,0.868,24,98,122,153,42,9,67,92,400,187,64,9,-72,-75,50,62.15,-97,-34.85,0.4467455621301775,0.3786407766990291,0.8676470588235294
2021,Phoenix Suns,UCLA,Aaron Holiday,182.88,83.91452,PG,63,1021,151,338,0.447,39,103,0.379,59,68,0.868,24,98,122,153,42,9,67,92,400,187,64,9,-72,-75,50,62.15,-97,-34.85,0.4467455621301775,0.3786407766990291,0.8676470588235294
2021,Phoenix Suns,UCLA,Aaron Holiday,182.88,83.91452,PG,63,1021,151,338,0.447,39,103,0.379,59,68,0.868,24,98,122,153,42,9,67,92,400,187,64,9,-72,-75,50,62.15,-97,-34.85,0.4467455621301775,0.3786407766990291,0.8676470588235294
2021,Phoenix Suns,UCLA,Aaron Holiday,182.88,83.91452,PG,63,1021,151,338,0.447,39,103,0.379,59,68,0.868,24,98,122,153,42,9,67,92,400,187,64,9,-72,-75,50,62.15,-97,-34.85,0.4467455621301775,0.3786407766990291,0.8676470588235294
2021,Los Angeles Lakers,Texas-Austin,Avery Bradley,190.5,81.64656,SG,62,1406,148,350,0.423,82,210,0.39,16,18,0.889,31,105,136,47,53,9,38,118,394,202,128,2,-108,-138,14,59.6,-232,-172.4,0.4228571428571429,0.3904761904761905,0.8888888888888888
2021,Atlanta Hawks,Southern California,Onyeka Okongwu,203.2,108.86208,C,48,992,156,226,0.69,0,0,0.0,80,110,0.727,115,168,283,53,31,60,44,149,392,70,0,30,172,0,50,128.8,222,350.8,0.6902654867256637,,0.7272727272727273
2021,Boston Celtics,,Daniel Theis,205.74,111.13004,C,47,977,151,291,0.519,33,107,0.308,49,72,0.681,59,169,228,41,20,31,46,111,384,140,74,23,22,-123,26,78.95,-75,3.950000000000003,0.5189003436426117,0.308411214953271,0.6805555555555556
2021,Boston Celtics,,Daniel Theis,205.74,111.13004,C,47,977,151,291,0.519,33,107,0.308,49,72,0.681,59,169,228,41,20,31,46,111,384,140,74,23,22,-123,26,78.95,-75,3.950000000000003,0.5189003436426117,0.308411214953271,0.6805555555555556
2021,Boston Celtics,,Daniel Theis,205.74,111.13004,C,47,977,151,291,0.519,33,107,0.308,49,72,0.681,59,169,228,41,20,31,46,111,384,140,74,23,22,-123,26,78.95,-75,3.950000000000003,0.5189003436426117,0.308411214953271,0.6805555555555556
2021,Boston Celtics,,Daniel Theis,205.74,111.13004,C,47,977,151,291,0.519,33,107,0.308,49,72,0.681,59,169,228,41,20,31,46,111,384,140,74,23,22,-123,26,78.95,-75,3.950000000000003,0.5189003436426117,0.308411214953271,0.6805555555555556
2021,Boston Celtics,,Daniel Theis,205.74,111.13004,C,47,977,151,291,0.519,33,107,0.308,49,72,0.681,59,169,228,41,20,31,46,111,384,140,74,23,22,-123,26,78.95,-75,3.950000000000003,0.5189003436426117,0.308411214953271,0.6805555555555556
2021,Boston Celtics,,Daniel Theis,205.74,111.13004,C,47,977,151,291,0.519,33,107,0.308,49,72,0.681,59,169,228,41,20,31,46,111,384,140,74,23,22,-123,26,78.95,-75,3.950000000000003,0.5189003436426117,0.308411214953271,0.6805555555555556
2021,Boston Celtics,,Daniel Theis,205.74,111.13004,C,47,977,151,291,0.519,33,107,0.308,49,72,0.681,59,169,228,41,20,31,46,111,384,140,74,23,22,-123,26,78.95,-75,3.950000000000003,0.5189003436426117,0.308411214953271,0.6805555555555556
2021,Boston Celtics,,Daniel Theis,205.74,111.13004,C,47,977,151,291,0.519,33,107,0.308,49,72,0.681,59,169,228,41,20,31,46,111,384,140,74,23,22,-123,26,78.95,-75,3.950000000000003,0.5189003436426117,0.308411214953271,0.6805555555555556
2021,Boston Celtics,,Daniel Theis,205.74,111.13004,C,47,977,151,291,0.519,33,107,0.308,49,72,0.681,59,169,228,41,20,31,46,111,384,140,74,23,22,-123,26,78.95,-75,3.950000000000003,0.5189003436426117,0.308411214953271,0.6805555555555556
2021,Indiana Pacers,Cincinnati,Lance Stephenson,195.58,95.25432,PG,46,814,147,323,0.455,27,90,0.3,63,80,0.788,12,115,127,165,24,4,72,96,384,176,63,17,-58,-108,46,49.2,-120,-70.8,0.4551083591331269,0.3,0.7875
2021,Indiana Pacers,Cincinnati,Lance Stephenson,195.58,95.25432,PG,46,814,147,323,0.455,27,90,0.3,63,80,0.788,12,115,127,165,24,4,72,96,384,176,63,17,-58,-108,46,49.2,-120,-70.8,0.4551083591331269,0.3,0.7875
2021,Indiana Pacers,Cincinnati,Lance Stephenson,195.58,95.25432,PG,46,814,147,323,0.455,27,90,0.3,63,80,0.788,12,115,127,165,24,4,72,96,384,176,63,17,-58,-108,46,49.2,-120,-70.8,0.4551083591331269,0.3,0.7875
2021,Indiana Pacers,Cincinnati,Lance Stephenson,195.58,95.25432,SG,46,814,147,323,0.455,27,90,0.3,63,80,0.788,12,115,127,165,24,4,72,96,384,176,63,17,-58,-108,46,49.2,-120,-70.8,0.4551083591331269,0.3,0.7875
2021,Indiana Pacers,Cincinnati,Lance Stephenson,195.58,95.25432,SG,46,814,147,323,0.455,27,90,0.3,63,80,0.788,12,115,127,165,24,4,72,96,384,176,63,17,-58,-108,46,49.2,-120,-70.8,0.4551083591331269,0.3,0.7875
2021,Indiana Pacers,Cincinnati,Lance Stephenson,195.58,95.25432,SG,46,814,147,323,0.455,27,90,0.3,63,80,0.788,12,115,127,165,24,4,72,96,384,176,63,17,-58,-108,46,49.2,-120,-70.8,0.4551083591331269,0.3,0.7875
2021,Indiana Pacers,Cincinnati,Lance Stephenson,195.58,95.25432,PG,46,814,147,323,0.455,27,90,0.3,63,80,0.788,12,115,127,165,24,4,72,96,384,176,63,17,-58,-108,46,49.2,-120,-70.8,0.4551083591331269,0.3,0.7875
2021,Indiana Pacers,Cincinnati,Lance Stephenson,195.58,95.25432,PG,46,814,147,323,0.455,27,90,0.3,63,80,0.788,12,115,127,165,24,4,72,96,384,176,63,17,-58,-108,46,49.2,-120,-70.8,0.4551083591331269,0.3,0.7875
2021,Indiana Pacers,Cincinnati,Lance Stephenson,195.58,95.25432,PG,46,814,147,323,0.455,27,90,0.3,63,80,0.788,12,115,127,165,24,4,72,96,384,176,63,17,-58,-108,46,49.2,-120,-70.8,0.4551083591331269,0.3,0.7875
2021,Cleveland Cavaliers,Penn State,Lamar Stevens,198.12,104.32616,PF,63,1015,156,319,0.489,18,65,0.277,53,75,0.707,47,117,164,44,31,18,41,106,383,163,47,22,-14,-87,31,62.45,-70,-7.549999999999997,0.4890282131661442,0.27692307692307694,0.7066666666666667
2021,Sacramento Kings,Villanova,Donte DiVincenzo,193.04,92.079176,SG,42,1005,118,336,0.351,74,218,0.339,70,83,0.843,40,130,170,118,48,8,72,69,380,218,144,13,-200,-210,57,70.55,-353,-282.45,0.35119047619047616,0.3394495412844037,0.8433734939759037
2021,Sacramento Kings,Villanova,Donte DiVincenzo,193.04,92.079176,SG,42,1005,118,336,0.351,74,218,0.339,70,83,0.843,40,130,170,118,48,8,72,69,380,218,144,13,-200,-210,57,70.55,-353,-282.45,0.35119047619047616,0.3394495412844037,0.8433734939759037
2021,Sacramento Kings,Villanova,Donte DiVincenzo,193.04,92.079176,SG,42,1005,118,336,0.351,74,218,0.339,70,83,0.843,40,130,170,118,48,8,72,69,380,218,144,13,-200,-210,57,70.55,-353,-282.45,0.35119047619047616,0.3394495412844037,0.8433734939759037
2021,Sacramento Kings,Villanova,Donte DiVincenzo,193.04,92.079176,SG,42,1005,118,336,0.351,74,218,0.339,70,83,0.843,40,130,170,118,48,8,72,69,380,218,144,13,-200,-210,57,70.55,-353,-282.45,0.35119047619047616,0.3394495412844037,0.8433734939759037
2021,Sacramento Kings,Villanova,Donte DiVincenzo,193.04,92.079176,SG,42,1005,118,336,0.351,74,218,0.339,70,83,0.843,40,130,170,118,48,8,72,69,380,218,144,13,-200,-210,57,70.55,-353,-282.45,0.35119047619047616,0.3394495412844037,0.8433734939759037
2021,Sacramento Kings,Villanova,Donte DiVincenzo,193.04,92.079176,SG,42,1005,118,336,0.351,74,218,0.339,70,83,0.843,40,130,170,118,48,8,72,69,380,218,144,13,-200,-210,57,70.55,-353,-282.45,0.35119047619047616,0.3394495412844037,0.8433734939759037
2021,Sacramento Kings,Villanova,Donte DiVincenzo,193.04,92.079176,SG,42,1005,118,336,0.351,74,218,0.339,70,83,0.843,40,130,170,118,48,8,72,69,380,218,144,13,-200,-210,57,70.55,-353,-282.45,0.35119047619047616,0.3394495412844037,0.8433734939759037
2021,Sacramento Kings,Villanova,Donte DiVincenzo,193.04,92.079176,SG,42,1005,118,336,0.351,74,218,0.339,70,83,0.843,40,130,170,118,48,8,72,69,380,218,144,13,-200,-210,57,70.55,-353,-282.45,0.35119047619047616,0.3394495412844037,0.8433734939759037
2021,Sacramento Kings,Villanova,Donte DiVincenzo,193.04,92.079176,SG,42,1005,118,336,0.351,74,218,0.339,70,83,0.843,40,130,170,118,48,8,72,69,380,218,144,13,-200,-210,57,70.55,-353,-282.45,0.35119047619047616,0.3394495412844037,0.8433734939759037
2021,Philadelphia 76ers,Washington,Matisse Thybulle,195.58,91.171992,SG,66,1685,150,300,0.5,45,144,0.313,34,43,0.791,42,109,151,75,115,71,39,158,379,150,99,9,0,-162,25,132.6,-137,-4.400000000000006,0.5,0.3125,0.7906976744186046
2021,Los Angeles Lakers,,Dwight Howard,208.28,120.20188,C,60,971,134,219,0.612,8,15,0.533,96,146,0.658,118,238,356,35,34,36,47,115,372,85,7,50,98,3,46,133.0,147,280.0,0.6118721461187214,0.5333333333333333,0.6575342465753424
2021,Philadelphia 76ers,North Carolina,Danny Green,198.12,97.52228,SF,62,1353,126,320,0.394,103,271,0.38,11,14,0.786,32,125,157,64,60,37,45,105,366,194,168,3,-136,-195,8,84.0,-323,-239.0,0.39375,0.3800738007380074,0.7857142857142857
2021,Oklahoma City Thunder,Villanova,Jeremiah Robinson-Earl,203.2,109.769264,C,49,1087,134,324,0.414,58,165,0.352,40,54,0.741,75,199,274,49,29,15,39,75,366,190,107,14,-112,-147,26,98.25,-233,-134.75,0.41358024691358025,0.3515151515151515,0.7407407407407407
2021,Detroit Pistons,Gonzaga,Kelly Olynyk,210.82,108.86208,C,40,764,128,286,0.448,40,119,0.336,69,89,0.775,54,123,177,111,31,19,58,100,365,158,79,20,-60,-117,49,76.5,-128,-51.5,0.44755244755244755,0.33613445378151263,0.7752808988764045
2021,Milwaukee Bucks,,Serge Ibaka,208.28,106.59412,C,54,878,148,296,0.5,37,99,0.374,32,44,0.727,62,188,250,49,11,33,43,102,365,148,62,12,0,-75,20,85.65,-55,30.650000000000006,0.5,0.37373737373737376,0.7272727272727273
2021,Milwaukee Bucks,,Serge Ibaka,208.28,106.59412,C,54,878,148,296,0.5,37,99,0.374,32,44,0.727,62,188,250,49,11,33,43,102,365,148,62,12,0,-75,20,85.65,-55,30.650000000000006,0.5,0.37373737373737376,0.7272727272727273
2021,Milwaukee Bucks,,Serge Ibaka,208.28,106.59412,C,54,878,148,296,0.5,37,99,0.374,32,44,0.727,62,188,250,49,11,33,43,102,365,148,62,12,0,-75,20,85.65,-55,30.650000000000006,0.5,0.37373737373737376,0.7272727272727273
2021,Milwaukee Bucks,,Serge Ibaka,208.28,106.59412,C,54,878,148,296,0.5,37,99,0.374,32,44,0.727,62,188,250,49,11,33,43,102,365,148,62,12,0,-75,20,85.65,-55,30.650000000000006,0.5,0.37373737373737376,0.7272727272727273
2021,Milwaukee Bucks,,Serge Ibaka,208.28,106.59412,C,54,878,148,296,0.5,37,99,0.374,32,44,0.727,62,188,250,49,11,33,43,102,365,148,62,12,0,-75,20,85.65,-55,30.650000000000006,0.5,0.37373737373737376,0.7272727272727273
2021,Milwaukee Bucks,,Serge Ibaka,208.28,106.59412,C,54,878,148,296,0.5,37,99,0.374,32,44,0.727,62,188,250,49,11,33,43,102,365,148,62,12,0,-75,20,85.65,-55,30.650000000000006,0.5,0.37373737373737376,0.7272727272727273
2021,Milwaukee Bucks,,Serge Ibaka,208.28,106.59412,C,54,878,148,296,0.5,37,99,0.374,32,44,0.727,62,188,250,49,11,33,43,102,365,148,62,12,0,-75,20,85.65,-55,30.650000000000006,0.5,0.37373737373737376,0.7272727272727273
2021,Milwaukee Bucks,,Serge Ibaka,208.28,106.59412,C,54,878,148,296,0.5,37,99,0.374,32,44,0.727,62,188,250,49,11,33,43,102,365,148,62,12,0,-75,20,85.65,-55,30.650000000000006,0.5,0.37373737373737376,0.7272727272727273
2021,Milwaukee Bucks,,Serge Ibaka,208.28,106.59412,C,54,878,148,296,0.5,37,99,0.374,32,44,0.727,62,188,250,49,11,33,43,102,365,148,62,12,0,-75,20,85.65,-55,30.650000000000006,0.5,0.37373737373737376,0.7272727272727273
2021,Portland Trail Blazers,Louisiana State,Trendon Watford,203.2,107.501304,SF,48,869,142,267,0.532,9,38,0.237,71,94,0.755,57,142,199,81,25,28,44,116,364,125,29,23,34,-60,48,82.95,22,104.95,0.5318352059925093,0.23684210526315788,0.7553191489361702
2021,Oklahoma City Thunder,TCU,Kenrich Williams,198.12,95.25432,SF,49,1072,146,317,0.461,41,121,0.339,30,55,0.545,75,145,220,108,44,10,46,81,363,171,80,25,-50,-117,5,100.7,-162,-61.3,0.4605678233438486,0.33884297520661155,0.5454545454545454
2021,Brooklyn Nets,Oklahoma,Blake Griffin,205.74,113.398,C,56,958,133,313,0.425,38,145,0.262,55,76,0.724,60,168,228,105,27,14,31,95,359,180,107,21,-94,-207,34,98.5,-267,-168.5,0.4249201277955272,0.2620689655172414,0.7236842105263158
2021,Atlanta Hawks,,Lou Williams,187.96,79.3786,PG,56,799,125,320,0.391,37,102,0.363,67,78,0.859,16,71,87,105,28,3,43,48,354,195,65,11,-140,-84,56,43.6,-168,-124.4,0.390625,0.3627450980392157,0.8589743589743589
2021,Indiana Pacers,,Goga Bitadze,213.36,113.398,C,50,729,131,252,0.52,23,80,0.288,64,94,0.681,79,98,177,55,21,42,46,107,349,121,57,30,20,-102,34,80.9,-48,32.900000000000006,0.5198412698412699,0.2875,0.6808510638297872
2021,Memphis Grizzlies,Indiana-Purdue Fort Wayne,John Konchar,195.58,95.25432,SG,72,1292,135,262,0.515,52,126,0.413,27,49,0.551,87,242,329,109,45,22,29,90,349,127,74,22,16,-66,5,145.75,-45,100.75,0.5152671755725191,0.4126984126984127,0.5510204081632653
2021,Golden State Warriors,Michigan State,Draymond Green,198.12,104.32616,PF,46,1329,135,257,0.525,16,54,0.296,60,91,0.659,45,291,336,320,61,50,139,136,346,122,38,31,26,-66,29,154.45,-11,143.45,0.5252918287937743,0.2962962962962963,0.6593406593406593
2021,Oklahoma City Thunder,Bucknell,Mike Muscala,208.28,108.86208,C,43,593,113,248,0.456,70,163,0.429,48,57,0.842,21,108,129,22,18,26,14,58,344,135,93,9,-44,-69,39,55.1,-74,-18.9,0.45564516129032256,0.4294478527607362,0.8421052631578947
2021,Chicago Bulls,Texas-Austin,Tristan Thompson,205.74,115.212368,PF,57,896,141,267,0.528,1,3,0.333,61,116,0.526,120,168,288,34,23,21,45,98,344,126,2,55,30,-3,6,105.1,33,138.1,0.5280898876404494,0.3333333333333333,0.5258620689655172
2021,Chicago Bulls,Texas-Austin,Tristan Thompson,205.74,115.212368,PF,57,896,141,267,0.528,1,3,0.333,61,116,0.526,120,168,288,34,23,21,45,98,344,126,2,55,30,-3,6,105.1,33,138.1,0.5280898876404494,0.3333333333333333,0.5258620689655172
2021,Chicago Bulls,Texas-Austin,Tristan Thompson,205.74,115.212368,PF,57,896,141,267,0.528,1,3,0.333,61,116,0.526,120,168,288,34,23,21,45,98,344,126,2,55,30,-3,6,105.1,33,138.1,0.5280898876404494,0.3333333333333333,0.5258620689655172
2021,Chicago Bulls,Texas-Austin,Tristan Thompson,205.74,115.212368,PF,57,896,141,267,0.528,1,3,0.333,61,116,0.526,120,168,288,34,23,21,45,98,344,126,2,55,30,-3,6,105.1,33,138.1,0.5280898876404494,0.3333333333333333,0.5258620689655172
2021,Chicago Bulls,Texas-Austin,Tristan Thompson,205.74,115.212368,PF,57,896,141,267,0.528,1,3,0.333,61,116,0.526,120,168,288,34,23,21,45,98,344,126,2,55,30,-3,6,105.1,33,138.1,0.5280898876404494,0.3333333333333333,0.5258620689655172
2021,Chicago Bulls,Texas-Austin,Tristan Thompson,205.74,115.212368,PF,57,896,141,267,0.528,1,3,0.333,61,116,0.526,120,168,288,34,23,21,45,98,344,126,2,55,30,-3,6,105.1,33,138.1,0.5280898876404494,0.3333333333333333,0.5258620689655172
2021,Chicago Bulls,Texas-Austin,Tristan Thompson,205.74,115.212368,PF,57,896,141,267,0.528,1,3,0.333,61,116,0.526,120,168,288,34,23,21,45,98,344,126,2,55,30,-3,6,105.1,33,138.1,0.5280898876404494,0.3333333333333333,0.5258620689655172
2021,Chicago Bulls,Texas-Austin,Tristan Thompson,205.74,115.212368,PF,57,896,141,267,0.528,1,3,0.333,61,116,0.526,120,168,288,34,23,21,45,98,344,126,2,55,30,-3,6,105.1,33,138.1,0.5280898876404494,0.3333333333333333,0.5258620689655172
2021,Chicago Bulls,Texas-Austin,Tristan Thompson,205.74,115.212368,PF,57,896,141,267,0.528,1,3,0.333,61,116,0.526,120,168,288,34,23,21,45,98,344,126,2,55,30,-3,6,105.1,33,138.1,0.5280898876404494,0.3333333333333333,0.5258620689655172
2021,Chicago Bulls,Texas-Austin,Tristan Thompson,205.74,115.212368,PF,57,896,141,267,0.528,1,3,0.333,61,116,0.526,120,168,288,34,23,21,45,98,344,126,2,55,30,-3,6,105.1,33,138.1,0.5280898876404494,0.3333333333333333,0.5258620689655172
2021,Chicago Bulls,Texas-Austin,Tristan Thompson,205.74,115.212368,PF,57,896,141,267,0.528,1,3,0.333,61,116,0.526,120,168,288,34,23,21,45,98,344,126,2,55,30,-3,6,105.1,33,138.1,0.5280898876404494,0.3333333333333333,0.5258620689655172
2021,Chicago Bulls,Texas-Austin,Tristan Thompson,205.74,115.212368,PF,57,896,141,267,0.528,1,3,0.333,61,116,0.526,120,168,288,34,23,21,45,98,344,126,2,55,30,-3,6,105.1,33,138.1,0.5280898876404494,0.3333333333333333,0.5258620689655172
2021,Chicago Bulls,Texas-Austin,Tristan Thompson,205.74,115.212368,PF,57,896,141,267,0.528,1,3,0.333,61,116,0.526,120,168,288,34,23,21,45,98,344,126,2,55,30,-3,6,105.1,33,138.1,0.5280898876404494,0.3333333333333333,0.5258620689655172
2021,Chicago Bulls,Texas-Austin,Tristan Thompson,205.74,115.212368,PF,57,896,141,267,0.528,1,3,0.333,61,116,0.526,120,168,288,34,23,21,45,98,344,126,2,55,30,-3,6,105.1,33,138.1,0.5280898876404494,0.3333333333333333,0.5258620689655172
2021,Chicago Bulls,Texas-Austin,Tristan Thompson,205.74,115.212368,PF,57,896,141,267,0.528,1,3,0.333,61,116,0.526,120,168,288,34,23,21,45,98,344,126,2,55,30,-3,6,105.1,33,138.1,0.5280898876404494,0.3333333333333333,0.5258620689655172
2021,Chicago Bulls,Texas-Austin,Tristan Thompson,205.74,115.212368,PF,57,896,141,267,0.528,1,3,0.333,61,116,0.526,120,168,288,34,23,21,45,98,344,126,2,55,30,-3,6,105.1,33,138.1,0.5280898876404494,0.3333333333333333,0.5258620689655172
2021,Atlanta Hawks,Utah,Delon Wright,195.58,83.91452,SG,77,1453,122,269,0.454,44,116,0.379,54,63,0.857,50,170,220,188,93,19,45,56,342,147,72,9,-50,-84,45,145.2,-89,56.19999999999999,0.45353159851301117,0.3793103448275862,0.8571428571428571
2021,Charlotte Hornets,San Diego State,Jalen McDaniels,205.74,92.98636,SF,55,895,123,254,0.484,41,108,0.38,53,72,0.736,37,133,170,58,26,22,36,93,340,131,67,19,-16,-78,34,67.6,-60,7.599999999999994,0.484251968503937,0.37962962962962965,0.7361111111111112
2021,Brooklyn Nets,Wake Forest,James Johnson,200.66,108.86208,PF,62,1191,144,307,0.469,23,85,0.271,29,55,0.527,51,164,215,130,30,34,48,162,340,163,62,26,-38,-117,3,98.9,-152,-53.099999999999994,0.46905537459283386,0.27058823529411763,0.5272727272727272
2021,Oklahoma City Thunder,Virginia,Ty Jerome,195.58,88.45044,SG,48,801,124,328,0.378,54,186,0.29,38,47,0.809,19,59,78,109,30,5,37,73,340,204,132,9,-160,-234,29,46.85,-365,-318.15,0.3780487804878049,0.2903225806451613,0.8085106382978723
2021,Portland Trail Blazers,Washington State,CJ Elleby,198.12,90.7184,SF,58,1174,121,308,0.393,37,126,0.294,60,84,0.714,66,161,227,87,35,19,56,116,339,187,89,24,-132,-156,36,88.2,-252,-163.8,0.39285714285714285,0.29365079365079366,0.7142857142857143
2021,San Antonio Spurs,Ohio State,Keita Bates-Diop,203.2,103.872568,SF,59,957,136,263,0.517,17,55,0.309,46,61,0.754,62,169,231,41,27,14,45,61,335,127,38,15,18,-63,31,78.45,-14,64.45,0.5171102661596958,0.3090909090909091,0.7540983606557377
2021,Utah Jazz,Villanova,Eric Paschall,198.12,115.66596,PF,58,737,114,235,0.485,40,108,0.37,66,86,0.767,30,76,106,36,9,5,27,51,334,121,68,20,-14,-84,46,33.95,-52,-18.049999999999997,0.4851063829787234,0.37037037037037035,0.7674418604651163
2021,Milwaukee Bucks,Indiana-Purdue Indianapolis,George Hill,193.04,85.275296,PG,54,1253,118,275,0.429,41,134,0.306,57,62,0.919,38,117,155,120,42,6,41,70,334,157,93,5,-78,-156,52,78.25,-182,-103.75,0.4290909090909091,0.30597014925373134,0.9193548387096774
2021,New Orleans Pelicans,Virginia,Trey Murphy III,203.2,93.439952,SF,62,864,109,277,0.394,71,186,0.382,45,51,0.882,47,100,147,38,23,7,16,60,334,168,115,6,-118,-132,39,62.0,-211,-149.0,0.3935018050541516,0.3817204301075269,0.8823529411764706
2021,Denver Nuggets,,Facundo Campazzo,177.8,88.45044,PG,65,1184,107,296,0.361,58,193,0.301,60,78,0.769,23,94,117,220,63,23,67,124,332,189,135,18,-164,-231,42,93.3,-353,-259.7,0.3614864864864865,0.3005181347150259,0.7692307692307693
2021,New Orleans Pelicans,Georgia Tech,Jose Alvarado,182.88,81.19296800000001,PG,54,834,131,294,0.446,32,110,0.291,36,53,0.679,25,75,100,152,71,7,40,73,330,163,78,17,-64,-138,19,84.6,-183,-98.4,0.445578231292517,0.2909090909090909,0.6792452830188679
2021,Sacramento Kings,Kansas,Josh Jackson,203.2,93.893544,SF,51,830,120,300,0.4,33,130,0.254,55,77,0.714,21,120,141,54,26,22,47,88,328,180,97,22,-120,-192,33,50.1,-279,-228.9,0.4,0.25384615384615383,0.7142857142857143
2021,Sacramento Kings,Kansas,Josh Jackson,203.2,93.893544,SF,51,830,120,300,0.4,33,130,0.254,55,77,0.714,21,120,141,54,26,22,47,88,328,180,97,22,-120,-192,33,50.1,-279,-228.9,0.4,0.25384615384615383,0.7142857142857143
2021,Sacramento Kings,Kansas,Josh Jackson,203.2,93.893544,SF,51,830,120,300,0.4,33,130,0.254,55,77,0.714,21,120,141,54,26,22,47,88,328,180,97,22,-120,-192,33,50.1,-279,-228.9,0.4,0.25384615384615383,0.7142857142857143
2021,Sacramento Kings,Kansas,Josh Jackson,203.2,93.893544,SF,51,830,120,300,0.4,33,130,0.254,55,77,0.714,21,120,141,54,26,22,47,88,328,180,97,22,-120,-192,33,50.1,-279,-228.9,0.4,0.25384615384615383,0.7142857142857143
2021,Sacramento Kings,Kansas,Josh Jackson,203.2,93.893544,SF,51,830,120,300,0.4,33,130,0.254,55,77,0.714,21,120,141,54,26,22,47,88,328,180,97,22,-120,-192,33,50.1,-279,-228.9,0.4,0.25384615384615383,0.7142857142857143
2021,Sacramento Kings,Kansas,Josh Jackson,203.2,93.893544,SF,51,830,120,300,0.4,33,130,0.254,55,77,0.714,21,120,141,54,26,22,47,88,328,180,97,22,-120,-192,33,50.1,-279,-228.9,0.4,0.25384615384615383,0.7142857142857143
2021,Sacramento Kings,Kansas,Josh Jackson,203.2,93.893544,SF,51,830,120,300,0.4,33,130,0.254,55,77,0.714,21,120,141,54,26,22,47,88,328,180,97,22,-120,-192,33,50.1,-279,-228.9,0.4,0.25384615384615383,0.7142857142857143
2021,Sacramento Kings,Kansas,Josh Jackson,203.2,93.893544,SF,51,830,120,300,0.4,33,130,0.254,55,77,0.714,21,120,141,54,26,22,47,88,328,180,97,22,-120,-192,33,50.1,-279,-228.9,0.4,0.25384615384615383,0.7142857142857143
2021,Sacramento Kings,Kansas,Josh Jackson,203.2,93.893544,SF,51,830,120,300,0.4,33,130,0.254,55,77,0.714,21,120,141,54,26,22,47,88,328,180,97,22,-120,-192,33,50.1,-279,-228.9,0.4,0.25384615384615383,0.7142857142857143
2021,Portland Trail Blazers,,Joe Ingles,203.2,99.79024,SF,45,1122,115,285,0.404,78,225,0.347,17,22,0.773,12,119,131,158,23,5,46,82,325,170,147,5,-110,-207,12,62.15,-305,-242.85,0.40350877192982454,0.3466666666666667,0.7727272727272727
2021,Toronto Raptors,Georgia Tech,Thaddeus Young,203.2,106.59412,PF,52,845,141,272,0.518,17,48,0.354,23,49,0.469,80,128,208,104,54,18,52,81,322,131,31,26,20,-42,-3,103.95,-25,78.95,0.5183823529411765,0.3541666666666667,0.46938775510204084
2021,Toronto Raptors,Georgia Tech,Thaddeus Young,203.2,106.59412,PF,52,845,141,272,0.518,17,48,0.354,23,49,0.469,80,128,208,104,54,18,52,81,322,131,31,26,20,-42,-3,103.95,-25,78.95,0.5183823529411765,0.3541666666666667,0.46938775510204084
2021,Toronto Raptors,Georgia Tech,Thaddeus Young,203.2,106.59412,PF,52,845,141,272,0.518,17,48,0.354,23,49,0.469,80,128,208,104,54,18,52,81,322,131,31,26,20,-42,-3,103.95,-25,78.95,0.5183823529411765,0.3541666666666667,0.46938775510204084
2021,Toronto Raptors,Georgia Tech,Thaddeus Young,203.2,106.59412,PF,52,845,141,272,0.518,17,48,0.354,23,49,0.469,80,128,208,104,54,18,52,81,322,131,31,26,20,-42,-3,103.95,-25,78.95,0.5183823529411765,0.3541666666666667,0.46938775510204084
2021,Toronto Raptors,Georgia Tech,Thaddeus Young,203.2,106.59412,PF,52,845,141,272,0.518,17,48,0.354,23,49,0.469,80,128,208,104,54,18,52,81,322,131,31,26,20,-42,-3,103.95,-25,78.95,0.5183823529411765,0.3541666666666667,0.46938775510204084
2021,Toronto Raptors,Georgia Tech,Thaddeus Young,203.2,106.59412,PF,52,845,141,272,0.518,17,48,0.354,23,49,0.469,80,128,208,104,54,18,52,81,322,131,31,26,20,-42,-3,103.95,-25,78.95,0.5183823529411765,0.3541666666666667,0.46938775510204084
2021,Toronto Raptors,Georgia Tech,Thaddeus Young,203.2,106.59412,PF,52,845,141,272,0.518,17,48,0.354,23,49,0.469,80,128,208,104,54,18,52,81,322,131,31,26,20,-42,-3,103.95,-25,78.95,0.5183823529411765,0.3541666666666667,0.46938775510204084
2021,Toronto Raptors,Georgia Tech,Thaddeus Young,203.2,106.59412,PF,52,845,141,272,0.518,17,48,0.354,23,49,0.469,80,128,208,104,54,18,52,81,322,131,31,26,20,-42,-3,103.95,-25,78.95,0.5183823529411765,0.3541666666666667,0.46938775510204084
2021,Toronto Raptors,Georgia Tech,Thaddeus Young,203.2,106.59412,PF,52,845,141,272,0.518,17,48,0.354,23,49,0.469,80,128,208,104,54,18,52,81,322,131,31,26,20,-42,-3,103.95,-25,78.95,0.5183823529411765,0.3541666666666667,0.46938775510204084
2021,New Orleans Pelicans,Wyoming,Larry Nance Jr.,200.66,111.13004,C,46,1040,129,247,0.522,23,70,0.329,40,57,0.702,72,176,248,81,43,20,37,84,321,118,47,17,22,-72,23,109.05,-27,82.05,0.5222672064777328,0.32857142857142857,0.7017543859649122
2021,New Orleans Pelicans,Wyoming,Larry Nance Jr.,200.66,111.13004,C,46,1040,129,247,0.522,23,70,0.329,40,57,0.702,72,176,248,81,43,20,37,84,321,118,47,17,22,-72,23,109.05,-27,82.05,0.5222672064777328,0.32857142857142857,0.7017543859649122
2021,New Orleans Pelicans,Wyoming,Larry Nance Jr.,200.66,111.13004,C,46,1040,129,247,0.522,23,70,0.329,40,57,0.702,72,176,248,81,43,20,37,84,321,118,47,17,22,-72,23,109.05,-27,82.05,0.5222672064777328,0.32857142857142857,0.7017543859649122
2021,New Orleans Pelicans,Wyoming,Larry Nance Jr.,200.66,111.13004,C,46,1040,129,247,0.522,23,70,0.329,40,57,0.702,72,176,248,81,43,20,37,84,321,118,47,17,22,-72,23,109.05,-27,82.05,0.5222672064777328,0.32857142857142857,0.7017543859649122
2021,New Orleans Pelicans,Wyoming,Larry Nance Jr.,200.66,111.13004,C,46,1040,129,247,0.522,23,70,0.329,40,57,0.702,72,176,248,81,43,20,37,84,321,118,47,17,22,-72,23,109.05,-27,82.05,0.5222672064777328,0.32857142857142857,0.7017543859649122
2021,New Orleans Pelicans,Wyoming,Larry Nance Jr.,200.66,111.13004,C,46,1040,129,247,0.522,23,70,0.329,40,57,0.702,72,176,248,81,43,20,37,84,321,118,47,17,22,-72,23,109.05,-27,82.05,0.5222672064777328,0.32857142857142857,0.7017543859649122
2021,New Orleans Pelicans,Wyoming,Larry Nance Jr.,200.66,111.13004,PF,46,1040,129,247,0.522,23,70,0.329,40,57,0.702,72,176,248,81,43,20,37,84,321,118,47,17,22,-72,23,109.05,-27,82.05,0.5222672064777328,0.32857142857142857,0.7017543859649122
2021,New Orleans Pelicans,Wyoming,Larry Nance Jr.,200.66,111.13004,PF,46,1040,129,247,0.522,23,70,0.329,40,57,0.702,72,176,248,81,43,20,37,84,321,118,47,17,22,-72,23,109.05,-27,82.05,0.5222672064777328,0.32857142857142857,0.7017543859649122
2021,New Orleans Pelicans,Wyoming,Larry Nance Jr.,200.66,111.13004,PF,46,1040,129,247,0.522,23,70,0.329,40,57,0.702,72,176,248,81,43,20,37,84,321,118,47,17,22,-72,23,109.05,-27,82.05,0.5222672064777328,0.32857142857142857,0.7017543859649122
2021,Los Angeles Lakers,Arizona,Stanley Johnson,198.12,109.769264,PF,48,1094,117,251,0.466,33,105,0.314,53,74,0.716,34,121,155,80,43,14,35,109,320,134,72,21,-34,-117,32,72.8,-119,-46.2,0.46613545816733065,0.3142857142857143,0.7162162162162162
2021,Dallas Mavericks,Arizona,Josh Green,195.58,90.7184,SG,67,1039,130,256,0.508,28,78,0.359,31,45,0.689,52,109,161,79,45,14,44,115,319,126,50,14,8,-66,17,74.75,-41,33.75,0.5078125,0.358974358974359,0.6888888888888889
2021,Indiana Pacers,Austin Peay,Terry Taylor,195.58,104.32616,PF,33,714,135,220,0.614,12,38,0.316,36,51,0.706,95,77,172,41,14,8,23,61,318,85,26,15,100,-42,21,73.45,79,152.45,0.6136363636363636,0.3157894736842105,0.7058823529411765
2021,New Orleans Pelicans,Xavier,Naji Marshall,200.66,99.79024,SF,55,736,109,269,0.405,21,105,0.2,74,93,0.796,38,104,142,62,33,8,46,69,313,160,84,19,-102,-189,55,54.55,-236,-181.45,0.4052044609665427,0.2,0.7956989247311828
2021,New York Knicks,Memphis,Derrick Rose,187.96,90.7184,PG,26,636,122,274,0.445,37,92,0.402,30,31,0.968,21,57,78,103,22,12,39,15,311,152,55,1,-60,-54,29,47.25,-85,-37.75,0.44525547445255476,0.40217391304347827,0.967741935483871
2021,Sacramento Kings,Mississippi,Terence Davis,193.04,91.171992,SG,30,536,113,267,0.423,49,149,0.329,36,44,0.818,11,83,94,40,25,11,33,70,311,154,100,8,-82,-153,28,34.25,-207,-172.75,0.4232209737827715,0.3288590604026846,0.8181818181818182
2021,Portland Trail Blazers,Arizona,Brandon Williams,187.96,86.18248,PG,24,640,105,282,0.372,31,106,0.292,68,97,0.701,19,55,74,94,24,10,58,52,309,177,75,29,-144,-132,39,32.15,-237,-204.85,0.3723404255319149,0.29245283018867924,0.7010309278350515
2021,New Orleans Pelicans,Louisiana State,Garrett Temple,195.58,88.45044,SG,59,1098,111,295,0.376,59,185,0.319,28,41,0.683,29,114,143,74,43,23,42,81,309,184,126,13,-146,-201,15,69.45,-332,-262.55,0.376271186440678,0.31891891891891894,0.6829268292682927
2021,Chicago Bulls,Texas A&M,Alex Caruso,195.58,84.368112,SG,41,1147,102,256,0.398,42,126,0.333,58,73,0.795,33,115,148,165,71,15,57,106,304,154,84,15,-104,-126,43,95.7,-187,-91.3,0.3984375,0.3333333333333333,0.7945205479452054
2021,Miami Heat,Georgetown,Omer Yurtseven,210.82,124.7378,C,56,706,130,247,0.526,1,11,0.091,38,61,0.623,85,209,294,49,17,20,41,84,299,117,10,23,26,-27,15,100.8,14,114.8,0.5263157894736842,0.09090909090909091,0.6229508196721312
2021,Golden State Warriors,Marquette,Juan Toscano-Anderson,198.12,94.800728,SF,73,994,115,235,0.489,28,87,0.322,40,70,0.571,28,148,176,127,48,17,68,115,298,120,59,30,-10,-93,10,75.5,-93,-17.5,0.48936170212765956,0.3218390804597701,0.5714285714285714
2021,Indiana Pacers,Kentucky,Isaiah Jackson,208.28,92.98636,C,36,541,116,206,0.563,5,16,0.313,60,88,0.682,60,89,149,10,25,52,40,92,297,90,11,28,52,-18,32,68.65,66,134.65,0.5631067961165048,0.3125,0.6818181818181818
2021,Los Angeles Lakers,Texas-Austin,D.J. Augustin,180.34,83.007336,PG,55,883,94,222,0.423,68,164,0.415,38,43,0.884,11,57,68,107,17,1,56,39,294,128,96,5,-68,-84,33,25.55,-119,-93.45,0.42342342342342343,0.4146341463414634,0.8837209302325582
2021,Los Angeles Lakers,Texas-Austin,D.J. Augustin,180.34,83.007336,PG,55,883,94,222,0.423,68,164,0.415,38,43,0.884,11,57,68,107,17,1,56,39,294,128,96,5,-68,-84,33,25.55,-119,-93.45,0.42342342342342343,0.4146341463414634,0.8837209302325582
2021,Los Angeles Lakers,Texas-Austin,D.J. Augustin,180.34,83.007336,PG,55,883,94,222,0.423,68,164,0.415,38,43,0.884,11,57,68,107,17,1,56,39,294,128,96,5,-68,-84,33,25.55,-119,-93.45,0.42342342342342343,0.4146341463414634,0.8837209302325582
2021,Los Angeles Lakers,Texas-Austin,D.J. Augustin,180.34,83.007336,PG,55,883,94,222,0.423,68,164,0.415,38,43,0.884,11,57,68,107,17,1,56,39,294,128,96,5,-68,-84,33,25.55,-119,-93.45,0.42342342342342343,0.4146341463414634,0.8837209302325582
2021,Los Angeles Lakers,Texas-Austin,D.J. Augustin,180.34,83.007336,PG,55,883,94,222,0.423,68,164,0.415,38,43,0.884,11,57,68,107,17,1,56,39,294,128,96,5,-68,-84,33,25.55,-119,-93.45,0.42342342342342343,0.4146341463414634,0.8837209302325582
2021,Los Angeles Lakers,Texas-Austin,D.J. Augustin,180.34,83.007336,PG,55,883,94,222,0.423,68,164,0.415,38,43,0.884,11,57,68,107,17,1,56,39,294,128,96,5,-68,-84,33,25.55,-119,-93.45,0.42342342342342343,0.4146341463414634,0.8837209302325582
2021,Los Angeles Lakers,Texas-Austin,D.J. Augustin,180.34,83.007336,PG,55,883,94,222,0.423,68,164,0.415,38,43,0.884,11,57,68,107,17,1,56,39,294,128,96,5,-68,-84,33,25.55,-119,-93.45,0.42342342342342343,0.4146341463414634,0.8837209302325582
2021,Los Angeles Lakers,Texas-Austin,D.J. Augustin,180.34,83.007336,PG,55,883,94,222,0.423,68,164,0.415,38,43,0.884,11,57,68,107,17,1,56,39,294,128,96,5,-68,-84,33,25.55,-119,-93.45,0.42342342342342343,0.4146341463414634,0.8837209302325582
2021,Los Angeles Lakers,Texas-Austin,D.J. Augustin,180.34,83.007336,PG,55,883,94,222,0.423,68,164,0.415,38,43,0.884,11,57,68,107,17,1,56,39,294,128,96,5,-68,-84,33,25.55,-119,-93.45,0.42342342342342343,0.4146341463414634,0.8837209302325582
2021,Toronto Raptors,Houston,Armoni Brooks,190.5,88.45044,SG,54,844,98,289,0.339,74,249,0.297,18,21,0.857,20,83,103,62,28,11,27,74,288,191,175,3,-186,-303,15,48.55,-474,-425.45,0.3391003460207612,0.2971887550200803,0.8571428571428571
2021,Toronto Raptors,Houston,Armoni Brooks,190.5,88.45044,SG,54,844,98,289,0.339,74,249,0.297,18,21,0.857,20,83,103,62,28,11,27,74,288,191,175,3,-186,-303,15,48.55,-474,-425.45,0.3391003460207612,0.2971887550200803,0.8571428571428571
2021,Toronto Raptors,Houston,Armoni Brooks,190.5,88.45044,SG,54,844,98,289,0.339,74,249,0.297,18,21,0.857,20,83,103,62,28,11,27,74,288,191,175,3,-186,-303,15,48.55,-474,-425.45,0.3391003460207612,0.2971887550200803,0.8571428571428571
2021,Toronto Raptors,Houston,Armoni Brooks,190.5,88.45044,SG,54,844,98,289,0.339,74,249,0.297,18,21,0.857,20,83,103,62,28,11,27,74,288,191,175,3,-186,-303,15,48.55,-474,-425.45,0.3391003460207612,0.2971887550200803,0.8571428571428571
2021,Toronto Raptors,Houston,Armoni Brooks,190.5,88.45044,SG,54,844,98,289,0.339,74,249,0.297,18,21,0.857,20,83,103,62,28,11,27,74,288,191,175,3,-186,-303,15,48.55,-474,-425.45,0.3391003460207612,0.2971887550200803,0.8571428571428571
2021,Toronto Raptors,Houston,Armoni Brooks,190.5,88.45044,SG,54,844,98,289,0.339,74,249,0.297,18,21,0.857,20,83,103,62,28,11,27,74,288,191,175,3,-186,-303,15,48.55,-474,-425.45,0.3391003460207612,0.2971887550200803,0.8571428571428571
2021,Toronto Raptors,Houston,Armoni Brooks,190.5,88.45044,PG,54,844,98,289,0.339,74,249,0.297,18,21,0.857,20,83,103,62,28,11,27,74,288,191,175,3,-186,-303,15,48.55,-474,-425.45,0.3391003460207612,0.2971887550200803,0.8571428571428571
2021,Toronto Raptors,Houston,Armoni Brooks,190.5,88.45044,PG,54,844,98,289,0.339,74,249,0.297,18,21,0.857,20,83,103,62,28,11,27,74,288,191,175,3,-186,-303,15,48.55,-474,-425.45,0.3391003460207612,0.2971887550200803,0.8571428571428571
2021,Toronto Raptors,Houston,Armoni Brooks,190.5,88.45044,PG,54,844,98,289,0.339,74,249,0.297,18,21,0.857,20,83,103,62,28,11,27,74,288,191,175,3,-186,-303,15,48.55,-474,-425.45,0.3391003460207612,0.2971887550200803,0.8571428571428571
2021,San Antonio Spurs,Alabama,Joshua Primo,193.04,85.728888,SF,50,965,101,270,0.374,42,137,0.307,44,59,0.746,32,81,113,81,20,23,57,79,288,169,95,15,-136,-159,29,45.55,-266,-220.45,0.37407407407407406,0.30656934306569344,0.7457627118644068
2021,Los Angeles Lakers,North Carolina,Wayne Ellington,193.04,93.893544,SG,43,810,98,237,0.414,82,211,0.389,9,11,0.818,10,67,77,30,23,5,19,42,287,139,129,2,-82,-141,7,31.65,-216,-184.35,0.41350210970464135,0.3886255924170616,0.8181818181818182
2021,Chicago Bulls,UNLV,Derrick Jones Jr.,198.12,95.25432,PF,51,899,105,195,0.538,20,61,0.328,56,70,0.8,60,109,169,30,25,33,30,105,286,90,41,14,30,-63,42,73.5,9,82.5,0.5384615384615384,0.32786885245901637,0.8
2021,Milwaukee Bucks,St. Joseph's (PA),DeAndre' Bembry,195.58,95.25432,SF,56,1026,124,221,0.561,15,36,0.417,21,35,0.6,42,121,163,66,49,25,31,113,284,97,21,14,54,-18,7,83.6,43,126.6,0.5610859728506787,0.4166666666666667,0.6
2021,Milwaukee Bucks,St. Joseph's (PA),DeAndre' Bembry,195.58,95.25432,SF,56,1026,124,221,0.561,15,36,0.417,21,35,0.6,42,121,163,66,49,25,31,113,284,97,21,14,54,-18,7,83.6,43,126.6,0.5610859728506787,0.4166666666666667,0.6
2021,Milwaukee Bucks,St. Joseph's (PA),DeAndre' Bembry,195.58,95.25432,SF,56,1026,124,221,0.561,15,36,0.417,21,35,0.6,42,121,163,66,49,25,31,113,284,97,21,14,54,-18,7,83.6,43,126.6,0.5610859728506787,0.4166666666666667,0.6
2021,Milwaukee Bucks,St. Joseph's (PA),DeAndre' Bembry,195.58,95.25432,SF,56,1026,124,221,0.561,15,36,0.417,21,35,0.6,42,121,163,66,49,25,31,113,284,97,21,14,54,-18,7,83.6,43,126.6,0.5610859728506787,0.4166666666666667,0.6
2021,Milwaukee Bucks,St. Joseph's (PA),DeAndre' Bembry,195.58,95.25432,SF,56,1026,124,221,0.561,15,36,0.417,21,35,0.6,42,121,163,66,49,25,31,113,284,97,21,14,54,-18,7,83.6,43,126.6,0.5610859728506787,0.4166666666666667,0.6
2021,Milwaukee Bucks,St. Joseph's (PA),DeAndre' Bembry,195.58,95.25432,SF,56,1026,124,221,0.561,15,36,0.417,21,35,0.6,42,121,163,66,49,25,31,113,284,97,21,14,54,-18,7,83.6,43,126.6,0.5610859728506787,0.4166666666666667,0.6
2021,Milwaukee Bucks,St. Joseph's (PA),DeAndre' Bembry,195.58,95.25432,SF,56,1026,124,221,0.561,15,36,0.417,21,35,0.6,42,121,163,66,49,25,31,113,284,97,21,14,54,-18,7,83.6,43,126.6,0.5610859728506787,0.4166666666666667,0.6
2021,Milwaukee Bucks,St. Joseph's (PA),DeAndre' Bembry,195.58,95.25432,SF,56,1026,124,221,0.561,15,36,0.417,21,35,0.6,42,121,163,66,49,25,31,113,284,97,21,14,54,-18,7,83.6,43,126.6,0.5610859728506787,0.4166666666666667,0.6
2021,Milwaukee Bucks,St. Joseph's (PA),DeAndre' Bembry,195.58,95.25432,SF,56,1026,124,221,0.561,15,36,0.417,21,35,0.6,42,121,163,66,49,25,31,113,284,97,21,14,54,-18,7,83.6,43,126.6,0.5610859728506787,0.4166666666666667,0.6
2021,Brooklyn Nets,Pepperdine,Kessler Edwards,200.66,92.079176,SF,48,987,110,267,0.412,48,136,0.353,16,19,0.842,44,128,172,31,29,24,42,85,284,157,88,3,-94,-120,13,63.0,-201,-138.0,0.41198501872659177,0.35294117647058826,0.8421052631578947
2021,Chicago Bulls,Oregon,Troy Brown Jr.,198.12,97.52228,SF,66,1055,108,258,0.419,47,133,0.353,20,26,0.769,39,164,203,66,36,5,26,62,283,150,86,6,-84,-117,14,81.4,-187,-105.6,0.4186046511627907,0.3533834586466165,0.7692307692307693
2021,Milwaukee Bucks,West Virginia,Jevon Carter,185.42,90.7184,PG,66,905,98,253,0.387,66,170,0.388,15,18,0.833,14,96,110,96,24,14,34,67,277,155,104,3,-114,-114,12,53.65,-216,-162.35,0.38735177865612647,0.38823529411764707,0.8333333333333334
2021,Milwaukee Bucks,West Virginia,Jevon Carter,185.42,90.7184,PG,66,905,98,253,0.387,66,170,0.388,15,18,0.833,14,96,110,96,24,14,34,67,277,155,104,3,-114,-114,12,53.65,-216,-162.35,0.38735177865612647,0.38823529411764707,0.8333333333333334
2021,Milwaukee Bucks,West Virginia,Jevon Carter,185.42,90.7184,PG,66,905,98,253,0.387,66,170,0.388,15,18,0.833,14,96,110,96,24,14,34,67,277,155,104,3,-114,-114,12,53.65,-216,-162.35,0.38735177865612647,0.38823529411764707,0.8333333333333334
2021,Milwaukee Bucks,West Virginia,Jevon Carter,185.42,90.7184,PG,66,905,98,253,0.387,66,170,0.388,15,18,0.833,14,96,110,96,24,14,34,67,277,155,104,3,-114,-114,12,53.65,-216,-162.35,0.38735177865612647,0.38823529411764707,0.8333333333333334
2021,Milwaukee Bucks,West Virginia,Jevon Carter,185.42,90.7184,PG,66,905,98,253,0.387,66,170,0.388,15,18,0.833,14,96,110,96,24,14,34,67,277,155,104,3,-114,-114,12,53.65,-216,-162.35,0.38735177865612647,0.38823529411764707,0.8333333333333334
2021,Milwaukee Bucks,West Virginia,Jevon Carter,185.42,90.7184,PG,66,905,98,253,0.387,66,170,0.388,15,18,0.833,14,96,110,96,24,14,34,67,277,155,104,3,-114,-114,12,53.65,-216,-162.35,0.38735177865612647,0.38823529411764707,0.8333333333333334
2021,Milwaukee Bucks,West Virginia,Jevon Carter,185.42,90.7184,PG,66,905,98,253,0.387,66,170,0.388,15,18,0.833,14,96,110,96,24,14,34,67,277,155,104,3,-114,-114,12,53.65,-216,-162.35,0.38735177865612647,0.38823529411764707,0.8333333333333334
2021,Milwaukee Bucks,West Virginia,Jevon Carter,185.42,90.7184,PG,66,905,98,253,0.387,66,170,0.388,15,18,0.833,14,96,110,96,24,14,34,67,277,155,104,3,-114,-114,12,53.65,-216,-162.35,0.38735177865612647,0.38823529411764707,0.8333333333333334
2021,Milwaukee Bucks,West Virginia,Jevon Carter,185.42,90.7184,PG,66,905,98,253,0.387,66,170,0.388,15,18,0.833,14,96,110,96,24,14,34,67,277,155,104,3,-114,-114,12,53.65,-216,-162.35,0.38735177865612647,0.38823529411764707,0.8333333333333334
2021,New York Knicks,Houston,Quentin Grimes,193.04,95.25432,SG,46,786,95,235,0.404,72,189,0.381,13,19,0.684,24,70,94,44,31,11,28,72,275,140,117,6,-90,-135,7,43.9,-218,-174.1,0.40425531914893614,0.38095238095238093,0.6842105263157895
2021,Portland Trail Blazers,Duke,Justise Winslow,198.12,100.697424,PF,48,775,110,257,0.428,15,66,0.227,39,66,0.591,50,152,202,84,35,25,49,67,274,147,51,27,-74,-108,12,86.15,-170,-83.85,0.4280155642023346,0.22727272727272727,0.5909090909090909
2021,Portland Trail Blazers,Duke,Justise Winslow,198.12,100.697424,PF,48,775,110,257,0.428,15,66,0.227,39,66,0.591,50,152,202,84,35,25,49,67,274,147,51,27,-74,-108,12,86.15,-170,-83.85,0.4280155642023346,0.22727272727272727,0.5909090909090909
2021,Portland Trail Blazers,Duke,Justise Winslow,198.12,100.697424,PF,48,775,110,257,0.428,15,66,0.227,39,66,0.591,50,152,202,84,35,25,49,67,274,147,51,27,-74,-108,12,86.15,-170,-83.85,0.4280155642023346,0.22727272727272727,0.5909090909090909
2021,Portland Trail Blazers,Duke,Justise Winslow,198.12,100.697424,PF,48,775,110,257,0.428,15,66,0.227,39,66,0.591,50,152,202,84,35,25,49,67,274,147,51,27,-74,-108,12,86.15,-170,-83.85,0.4280155642023346,0.22727272727272727,0.5909090909090909
2021,Portland Trail Blazers,Duke,Justise Winslow,198.12,100.697424,PF,48,775,110,257,0.428,15,66,0.227,39,66,0.591,50,152,202,84,35,25,49,67,274,147,51,27,-74,-108,12,86.15,-170,-83.85,0.4280155642023346,0.22727272727272727,0.5909090909090909
2021,Portland Trail Blazers,Duke,Justise Winslow,198.12,100.697424,PF,48,775,110,257,0.428,15,66,0.227,39,66,0.591,50,152,202,84,35,25,49,67,274,147,51,27,-74,-108,12,86.15,-170,-83.85,0.4280155642023346,0.22727272727272727,0.5909090909090909
2021,Portland Trail Blazers,Duke,Justise Winslow,198.12,100.697424,PF,48,775,110,257,0.428,15,66,0.227,39,66,0.591,50,152,202,84,35,25,49,67,274,147,51,27,-74,-108,12,86.15,-170,-83.85,0.4280155642023346,0.22727272727272727,0.5909090909090909
2021,Portland Trail Blazers,Duke,Justise Winslow,198.12,100.697424,PF,48,775,110,257,0.428,15,66,0.227,39,66,0.591,50,152,202,84,35,25,49,67,274,147,51,27,-74,-108,12,86.15,-170,-83.85,0.4280155642023346,0.22727272727272727,0.5909090909090909
2021,Portland Trail Blazers,Duke,Justise Winslow,198.12,100.697424,PF,48,775,110,257,0.428,15,66,0.227,39,66,0.591,50,152,202,84,35,25,49,67,274,147,51,27,-74,-108,12,86.15,-170,-83.85,0.4280155642023346,0.22727272727272727,0.5909090909090909
2021,Detroit Pistons,Kansas State,Rodney McGruder,193.04,92.98636,SG,51,754,98,225,0.436,58,146,0.397,19,26,0.731,31,80,111,48,21,7,24,58,273,127,88,7,-58,-90,12,46.6,-136,-89.4,0.43555555555555553,0.3972602739726027,0.7307692307692307
2021,Denver Nuggets,Arizona,Zeke Nnaji,205.74,108.86208,PF,41,698,96,186,0.516,37,80,0.463,41,65,0.631,56,91,147,17,16,13,23,79,270,90,43,24,12,-18,17,54.05,11,65.05,0.5161290322580645,0.4625,0.6307692307692307
2021,Cleveland Cavaliers,Kansas State,Dean Wade,205.74,103.418976,PF,51,980,99,217,0.456,51,142,0.359,20,30,0.667,31,119,150,52,29,7,16,88,269,118,91,10,-38,-120,10,63.85,-148,-84.15,0.45622119815668205,0.3591549295774648,0.6666666666666666
2021,Portland Trail Blazers,Tennessee,Keon Johnson,193.04,83.91452,SG,37,696,96,272,0.353,34,100,0.34,41,51,0.804,24,57,81,76,28,12,46,69,267,176,66,10,-160,-96,31,38.8,-225,-186.2,0.35294117647058826,0.34,0.803921568627451
2021,Portland Trail Blazers,Tennessee,Keon Johnson,193.04,83.91452,SG,37,696,96,272,0.353,34,100,0.34,41,51,0.804,24,57,81,76,28,12,46,69,267,176,66,10,-160,-96,31,38.8,-225,-186.2,0.35294117647058826,0.34,0.803921568627451
2021,Portland Trail Blazers,Tennessee,Keon Johnson,193.04,83.91452,SG,37,696,96,272,0.353,34,100,0.34,41,51,0.804,24,57,81,76,28,12,46,69,267,176,66,10,-160,-96,31,38.8,-225,-186.2,0.35294117647058826,0.34,0.803921568627451
2021,Portland Trail Blazers,Tennessee,Keon Johnson,193.04,83.91452,SG,37,696,96,272,0.353,34,100,0.34,41,51,0.804,24,57,81,76,28,12,46,69,267,176,66,10,-160,-96,31,38.8,-225,-186.2,0.35294117647058826,0.34,0.803921568627451
2021,Portland Trail Blazers,Tennessee,Keon Johnson,193.04,83.91452,SG,37,696,96,272,0.353,34,100,0.34,41,51,0.804,24,57,81,76,28,12,46,69,267,176,66,10,-160,-96,31,38.8,-225,-186.2,0.35294117647058826,0.34,0.803921568627451
2021,Portland Trail Blazers,Tennessee,Keon Johnson,193.04,83.91452,SG,37,696,96,272,0.353,34,100,0.34,41,51,0.804,24,57,81,76,28,12,46,69,267,176,66,10,-160,-96,31,38.8,-225,-186.2,0.35294117647058826,0.34,0.803921568627451
2021,Portland Trail Blazers,Tennessee,Keon Johnson,193.04,83.91452,SG,37,696,96,272,0.353,34,100,0.34,41,51,0.804,24,57,81,76,28,12,46,69,267,176,66,10,-160,-96,31,38.8,-225,-186.2,0.35294117647058826,0.34,0.803921568627451
2021,Portland Trail Blazers,Tennessee,Keon Johnson,193.04,83.91452,SG,37,696,96,272,0.353,34,100,0.34,41,51,0.804,24,57,81,76,28,12,46,69,267,176,66,10,-160,-96,31,38.8,-225,-186.2,0.35294117647058826,0.34,0.803921568627451
2021,Portland Trail Blazers,Tennessee,Keon Johnson,193.04,83.91452,SG,37,696,96,272,0.353,34,100,0.34,41,51,0.804,24,57,81,76,28,12,46,69,267,176,66,10,-160,-96,31,38.8,-225,-186.2,0.35294117647058826,0.34,0.803921568627451
2021,San Antonio Spurs,,Jock Landale,210.82,115.66596,C,54,589,101,204,0.495,29,89,0.326,34,41,0.829,63,75,138,45,10,14,31,53,265,103,60,7,-4,-93,27,55.35,-70,-14.649999999999999,0.4950980392156863,0.3258426966292135,0.8292682926829268
2021,Toronto Raptors,Kansas,Svi Mykhailiuk,200.66,92.98636,SF,56,716,91,234,0.389,41,134,0.306,32,37,0.865,20,72,92,45,26,4,32,54,255,143,93,5,-104,-156,27,35.55,-233,-197.45,0.3888888888888889,0.30597014925373134,0.8648648648648649
2021,Orlando Magic,Stanford,Robin Lopez,213.36,127.459352,C,36,612,110,199,0.553,2,6,0.333,32,54,0.593,68,58,126,54,2,18,44,67,254,89,4,22,42,-6,10,46.65,46,92.65,0.5527638190954773,0.3333333333333333,0.5925925925925926
2021,Milwaukee Bucks,Marquette,Wesley Matthews,193.04,99.79024,SG,49,1002,87,220,0.395,53,157,0.338,22,28,0.786,30,62,92,36,23,8,18,87,249,133,104,6,-92,-153,16,41.65,-229,-187.35,0.39545454545454545,0.3375796178343949,0.7857142857142857
2021,Utah Jazz,Texas A&M,Danuel House Jr.,198.12,99.79024,SF,42,727,80,198,0.404,44,117,0.376,44,58,0.759,18,93,111,44,21,17,33,51,248,118,73,14,-76,-87,30,43.2,-133,-89.8,0.40404040404040403,0.37606837606837606,0.7586206896551724
2021,Utah Jazz,Texas A&M,Danuel House Jr.,198.12,99.79024,SF,42,727,80,198,0.404,44,117,0.376,44,58,0.759,18,93,111,44,21,17,33,51,248,118,73,14,-76,-87,30,43.2,-133,-89.8,0.40404040404040403,0.37606837606837606,0.7586206896551724
2021,Utah Jazz,Texas A&M,Danuel House Jr.,198.12,99.79024,SF,42,727,80,198,0.404,44,117,0.376,44,58,0.759,18,93,111,44,21,17,33,51,248,118,73,14,-76,-87,30,43.2,-133,-89.8,0.40404040404040403,0.37606837606837606,0.7586206896551724
2021,Utah Jazz,Texas A&M,Danuel House Jr.,198.12,99.79024,SF,42,727,80,198,0.404,44,117,0.376,44,58,0.759,18,93,111,44,21,17,33,51,248,118,73,14,-76,-87,30,43.2,-133,-89.8,0.40404040404040403,0.37606837606837606,0.7586206896551724
2021,Utah Jazz,Texas A&M,Danuel House Jr.,198.12,99.79024,SF,42,727,80,198,0.404,44,117,0.376,44,58,0.759,18,93,111,44,21,17,33,51,248,118,73,14,-76,-87,30,43.2,-133,-89.8,0.40404040404040403,0.37606837606837606,0.7586206896551724
2021,Utah Jazz,Texas A&M,Danuel House Jr.,198.12,99.79024,SF,42,727,80,198,0.404,44,117,0.376,44,58,0.759,18,93,111,44,21,17,33,51,248,118,73,14,-76,-87,30,43.2,-133,-89.8,0.40404040404040403,0.37606837606837606,0.7586206896551724
2021,Utah Jazz,Texas A&M,Danuel House Jr.,198.12,99.79024,SF,42,727,80,198,0.404,44,117,0.376,44,58,0.759,18,93,111,44,21,17,33,51,248,118,73,14,-76,-87,30,43.2,-133,-89.8,0.40404040404040403,0.37606837606837606,0.7586206896551724
2021,Utah Jazz,Texas A&M,Danuel House Jr.,198.12,99.79024,SF,42,727,80,198,0.404,44,117,0.376,44,58,0.759,18,93,111,44,21,17,33,51,248,118,73,14,-76,-87,30,43.2,-133,-89.8,0.40404040404040403,0.37606837606837606,0.7586206896551724
2021,Utah Jazz,Texas A&M,Danuel House Jr.,198.12,99.79024,SF,42,727,80,198,0.404,44,117,0.376,44,58,0.759,18,93,111,44,21,17,33,51,248,118,73,14,-76,-87,30,43.2,-133,-89.8,0.40404040404040403,0.37606837606837606,0.7586206896551724
2021,Utah Jazz,Texas A&M,Danuel House Jr.,198.12,99.79024,SF,42,727,80,198,0.404,44,117,0.376,44,58,0.759,18,93,111,44,21,17,33,51,248,118,73,14,-76,-87,30,43.2,-133,-89.8,0.40404040404040403,0.37606837606837606,0.7586206896551724
2021,Utah Jazz,Texas A&M,Danuel House Jr.,198.12,99.79024,SF,42,727,80,198,0.404,44,117,0.376,44,58,0.759,18,93,111,44,21,17,33,51,248,118,73,14,-76,-87,30,43.2,-133,-89.8,0.40404040404040403,0.37606837606837606,0.7586206896551724
2021,Utah Jazz,Texas A&M,Danuel House Jr.,198.12,99.79024,SF,42,727,80,198,0.404,44,117,0.376,44,58,0.759,18,93,111,44,21,17,33,51,248,118,73,14,-76,-87,30,43.2,-133,-89.8,0.40404040404040403,0.37606837606837606,0.7586206896551724
2021,Utah Jazz,Texas A&M,Danuel House Jr.,198.12,99.79024,SF,42,727,80,198,0.404,44,117,0.376,44,58,0.759,18,93,111,44,21,17,33,51,248,118,73,14,-76,-87,30,43.2,-133,-89.8,0.40404040404040403,0.37606837606837606,0.7586206896551724
2021,Utah Jazz,Texas A&M,Danuel House Jr.,198.12,99.79024,SF,42,727,80,198,0.404,44,117,0.376,44,58,0.759,18,93,111,44,21,17,33,51,248,118,73,14,-76,-87,30,43.2,-133,-89.8,0.40404040404040403,0.37606837606837606,0.7586206896551724
2021,Utah Jazz,Texas A&M,Danuel House Jr.,198.12,99.79024,SF,42,727,80,198,0.404,44,117,0.376,44,58,0.759,18,93,111,44,21,17,33,51,248,118,73,14,-76,-87,30,43.2,-133,-89.8,0.40404040404040403,0.37606837606837606,0.7586206896551724
2021,Utah Jazz,Texas A&M,Danuel House Jr.,198.12,99.79024,SF,42,727,80,198,0.404,44,117,0.376,44,58,0.759,18,93,111,44,21,17,33,51,248,118,73,14,-76,-87,30,43.2,-133,-89.8,0.40404040404040403,0.37606837606837606,0.7586206896551724
2021,Toronto Raptors,UNLV,Khem Birch,205.74,105.68693600000002,C,55,991,97,200,0.485,0,14,0.0,53,71,0.746,122,117,239,56,30,26,29,104,247,103,14,18,-12,-42,35,112.55,-19,93.55,0.485,0.0,0.7464788732394366
2021,Dallas Mavericks,,Frank Ntilikina,193.04,90.7184,SG,58,685,89,223,0.399,38,111,0.342,24,25,0.96,12,67,79,69,27,7,31,61,240,134,73,1,-90,-105,23,38.45,-172,-133.55,0.3991031390134529,0.34234234234234234,0.96
2021,Sacramento Kings,Maryland,Alex Len,213.36,113.398,C,39,620,94,176,0.534,6,21,0.286,41,63,0.651,52,109,161,45,13,25,43,100,235,82,15,22,24,-27,19,57.0,16,73.0,0.5340909090909091,0.2857142857142857,0.6507936507936508
2021,Houston Rockets,Cal Poly,David Nwaba,195.58,99.336648,SF,46,609,85,176,0.483,15,49,0.306,48,67,0.716,41,110,151,35,28,20,21,55,233,91,34,19,-12,-57,29,67.5,-40,27.5,0.48295454545454547,0.30612244897959184,0.7164179104477612
2021,Minnesota Timberwolves,Southern California,Jordan McLaughlin,180.34,83.91452,PG,62,902,88,200,0.44,27,85,0.318,30,40,0.75,22,72,94,180,57,10,38,54,233,112,58,10,-48,-93,20,85.8,-121,-35.2,0.44,0.3176470588235294,0.75
2021,Indiana Pacers,Arizona,T.J. McConnell,185.42,86.18248,PG,27,652,100,208,0.481,10,33,0.303,19,23,0.826,20,70,90,131,29,10,29,53,229,108,23,4,-16,-39,15,62.6,-40,22.6,0.4807692307692308,0.30303030303030304,0.8260869565217391
2021,New York Knicks,Southern California,Taj Gibson,205.74,105.233344,C,52,946,86,166,0.518,15,38,0.395,42,52,0.808,88,141,229,32,22,40,27,137,229,80,23,10,12,-24,32,97.9,20,117.9,0.5180722891566265,0.39473684210526316,0.8076923076923077
2021,Golden State Warriors,Arkansas,Moses Moody,195.58,95.707912,SG,52,607,80,183,0.437,40,110,0.364,28,36,0.778,17,63,80,23,7,10,13,43,228,103,70,8,-46,-90,20,29.85,-116,-86.15,0.4371584699453552,0.36363636363636365,0.7777777777777778
2021,Portland Trail Blazers,Texas-Austin,Greg Brown III,200.66,93.439952,SF,48,640,81,190,0.426,19,61,0.311,44,65,0.677,38,97,135,35,26,24,36,90,225,109,42,21,-56,-69,23,54.5,-102,-47.5,0.4263157894736842,0.3114754098360656,0.676923076923077
2021,San Antonio Spurs,Indiana,Romeo Langford,195.58,97.975872,SG,48,771,83,191,0.435,29,85,0.341,23,42,0.548,30,78,108,21,22,16,16,47,218,108,56,19,-50,-81,4,48.4,-127,-78.6,0.43455497382198954,0.3411764705882353,0.5476190476190477
2021,San Antonio Spurs,Indiana,Romeo Langford,195.58,97.975872,SG,48,771,83,191,0.435,29,85,0.341,23,42,0.548,30,78,108,21,22,16,16,47,218,108,56,19,-50,-81,4,48.4,-127,-78.6,0.43455497382198954,0.3411764705882353,0.5476190476190477
2021,San Antonio Spurs,Indiana,Romeo Langford,195.58,97.975872,SG,48,771,83,191,0.435,29,85,0.341,23,42,0.548,30,78,108,21,22,16,16,47,218,108,56,19,-50,-81,4,48.4,-127,-78.6,0.43455497382198954,0.3411764705882353,0.5476190476190477
2021,San Antonio Spurs,Indiana,Romeo Langford,195.58,97.975872,SG,48,771,83,191,0.435,29,85,0.341,23,42,0.548,30,78,108,21,22,16,16,47,218,108,56,19,-50,-81,4,48.4,-127,-78.6,0.43455497382198954,0.3411764705882353,0.5476190476190477
2021,San Antonio Spurs,Indiana,Romeo Langford,195.58,97.975872,SG,48,771,83,191,0.435,29,85,0.341,23,42,0.548,30,78,108,21,22,16,16,47,218,108,56,19,-50,-81,4,48.4,-127,-78.6,0.43455497382198954,0.3411764705882353,0.5476190476190477
2021,San Antonio Spurs,Indiana,Romeo Langford,195.58,97.975872,SG,48,771,83,191,0.435,29,85,0.341,23,42,0.548,30,78,108,21,22,16,16,47,218,108,56,19,-50,-81,4,48.4,-127,-78.6,0.43455497382198954,0.3411764705882353,0.5476190476190477
2021,San Antonio Spurs,Indiana,Romeo Langford,195.58,97.975872,SG,48,771,83,191,0.435,29,85,0.341,23,42,0.548,30,78,108,21,22,16,16,47,218,108,56,19,-50,-81,4,48.4,-127,-78.6,0.43455497382198954,0.3411764705882353,0.5476190476190477
2021,San Antonio Spurs,Indiana,Romeo Langford,195.58,97.975872,SG,48,771,83,191,0.435,29,85,0.341,23,42,0.548,30,78,108,21,22,16,16,47,218,108,56,19,-50,-81,4,48.4,-127,-78.6,0.43455497382198954,0.3411764705882353,0.5476190476190477
2021,San Antonio Spurs,Indiana,Romeo Langford,195.58,97.975872,SG,48,771,83,191,0.435,29,85,0.341,23,42,0.548,30,78,108,21,22,16,16,47,218,108,56,19,-50,-81,4,48.4,-127,-78.6,0.43455497382198954,0.3411764705882353,0.5476190476190477
2021,San Antonio Spurs,Gonzaga,Zach Collins,210.82,113.398,C,28,502,76,155,0.49,14,41,0.341,52,65,0.8,46,107,153,61,13,23,45,67,218,79,27,13,-6,-39,39,57.15,-6,51.15,0.49032258064516127,0.34146341463414637,0.8
2021,Sacramento Kings,St. John's,Maurice Harkless,200.66,99.79024,SF,47,864,83,181,0.459,31,101,0.307,20,28,0.714,12,100,112,23,29,24,31,77,217,98,70,8,-30,-117,12,43.9,-135,-91.1,0.4585635359116022,0.3069306930693069,0.7142857142857143
2021,Dallas Mavericks,Michigan,Trey Burke,182.88,83.91452,PG,42,441,84,215,0.391,26,82,0.317,20,23,0.87,4,29,33,57,12,0,26,39,214,131,56,3,-94,-90,17,14.55,-167,-152.45,0.39069767441860465,0.3170731707317073,0.8695652173913043
2021,Phoenix Suns,,Bismack Biyombo,203.2,115.66596,C,36,506,86,145,0.593,0,0,0.0,38,71,0.535,63,104,167,23,12,26,25,70,210,59,0,33,54,0,5,66.25,59,125.25,0.593103448275862,,0.5352112676056338
2021,Orlando Magic,Michigan,Ignas Brazdeikis,198.12,100.243832,SF,42,536,81,188,0.431,27,87,0.31,21,32,0.656,23,49,72,37,10,3,17,48,210,107,60,11,-52,-99,10,28.6,-141,-112.4,0.4308510638297872,0.3103448275862069,0.65625
2021,Denver Nuggets,Miami,Davon Reed,195.58,93.439952,SG,48,668,81,161,0.503,37,86,0.43,10,15,0.667,14,94,108,53,24,9,16,63,209,80,49,5,2,-36,5,49.1,-29,20.1,0.5031055900621118,0.43023255813953487,0.6666666666666666
2021,Detroit Pistons,Vanderbilt,Saben Lee,187.96,83.007336,PG,37,604,69,177,0.39,14,60,0.233,56,71,0.789,18,69,87,107,36,12,36,44,208,108,46,15,-78,-96,41,56.8,-133,-76.2,0.3898305084745763,0.23333333333333334,0.7887323943661971
2021,Philadelphia 76ers,Texas A&M,DeAndre Jordan,210.82,120.20188,C,48,622,92,143,0.643,0,0,0.0,22,40,0.55,83,181,264,21,12,35,37,71,206,51,0,18,82,0,4,93.45,86,179.45,0.6433566433566433,,0.55
2021,Philadelphia 76ers,Texas A&M,DeAndre Jordan,210.82,120.20188,C,48,622,92,143,0.643,0,0,0.0,22,40,0.55,83,181,264,21,12,35,37,71,206,51,0,18,82,0,4,93.45,86,179.45,0.6433566433566433,,0.55
2021,Philadelphia 76ers,Texas A&M,DeAndre Jordan,210.82,120.20188,C,48,622,92,143,0.643,0,0,0.0,22,40,0.55,83,181,264,21,12,35,37,71,206,51,0,18,82,0,4,93.45,86,179.45,0.6433566433566433,,0.55
2021,Philadelphia 76ers,Texas A&M,DeAndre Jordan,210.82,120.20188,C,48,622,92,143,0.643,0,0,0.0,22,40,0.55,83,181,264,21,12,35,37,71,206,51,0,18,82,0,4,93.45,86,179.45,0.6433566433566433,,0.55
2021,Philadelphia 76ers,Texas A&M,DeAndre Jordan,210.82,120.20188,C,48,622,92,143,0.643,0,0,0.0,22,40,0.55,83,181,264,21,12,35,37,71,206,51,0,18,82,0,4,93.45,86,179.45,0.6433566433566433,,0.55
2021,Philadelphia 76ers,Texas A&M,DeAndre Jordan,210.82,120.20188,C,48,622,92,143,0.643,0,0,0.0,22,40,0.55,83,181,264,21,12,35,37,71,206,51,0,18,82,0,4,93.45,86,179.45,0.6433566433566433,,0.55
2021,Philadelphia 76ers,Texas A&M,DeAndre Jordan,210.82,120.20188,C,48,622,92,143,0.643,0,0,0.0,22,40,0.55,83,181,264,21,12,35,37,71,206,51,0,18,82,0,4,93.45,86,179.45,0.6433566433566433,,0.55
2021,Philadelphia 76ers,Texas A&M,DeAndre Jordan,210.82,120.20188,C,48,622,92,143,0.643,0,0,0.0,22,40,0.55,83,181,264,21,12,35,37,71,206,51,0,18,82,0,4,93.45,86,179.45,0.6433566433566433,,0.55
2021,Philadelphia 76ers,Texas A&M,DeAndre Jordan,210.82,120.20188,C,48,622,92,143,0.643,0,0,0.0,22,40,0.55,83,181,264,21,12,35,37,71,206,51,0,18,82,0,4,93.45,86,179.45,0.6433566433566433,,0.55
2021,Portland Trail Blazers,North Carolina State,Dennis Smith Jr.,187.96,92.98636,PG,37,639,79,189,0.418,6,27,0.222,42,64,0.656,20,68,88,132,45,12,51,52,206,110,21,22,-62,-45,20,60.4,-87,-26.6,0.41798941798941797,0.2222222222222222,0.65625
2021,Oklahoma City Thunder,Georgia Tech,Derrick Favors,205.74,120.20188,C,39,652,94,182,0.516,2,16,0.125,16,25,0.64,58,126,184,25,17,12,9,62,206,88,14,9,12,-36,7,73.65,-17,56.650000000000006,0.5164835164835165,0.125,0.64
2021,Toronto Raptors,Nebraska,Dalano Banton,200.66,92.532768,PG,64,696,83,202,0.411,13,51,0.255,26,44,0.591,38,86,124,99,28,10,53,68,205,119,38,18,-72,-75,8,54.35,-139,-84.65,0.41089108910891087,0.2549019607843137,0.5909090909090909
2021,Washington Wizards,Indiana,Thomas Bryant,208.28,112.490816,C,27,439,77,148,0.52,12,42,0.286,35,40,0.875,26,82,108,23,6,21,19,43,201,71,30,5,12,-54,30,41.1,-12,29.1,0.5202702702702703,0.2857142857142857,0.875
2021,Oklahoma City Thunder,Oklahoma State,Lindy Waters III,198.12,97.52228,SG,25,465,71,175,0.406,53,146,0.363,4,5,0.8,6,67,73,24,19,8,11,31,199,104,93,1,-66,-120,3,32.2,-183,-150.8,0.4057142857142857,0.363013698630137,0.8
2021,Brooklyn Nets,North Carolina,Day'Ron Sharpe,205.74,120.20188,PF,32,391,86,149,0.577,2,7,0.286,24,41,0.585,81,79,160,17,10,15,30,60,198,63,5,17,46,-9,7,59.0,44,103.0,0.5771812080536913,0.2857142857142857,0.5853658536585366
2021,Philadelphia 76ers,Arkansas,Isaiah Joe,193.04,74.84268,SG,55,609,62,177,0.35,45,135,0.333,29,31,0.935,6,50,56,35,14,3,19,47,198,115,90,2,-106,-135,27,20.9,-214,-193.1,0.3502824858757062,0.3333333333333333,0.9354838709677419
2021,Boston Celtics,Vanderbilt,Aaron Nesmith,195.58,97.52228,SF,52,574,72,182,0.396,31,115,0.27,21,26,0.808,15,74,89,22,20,5,31,70,196,110,84,5,-76,-159,16,25.0,-219,-194.0,0.3956043956043956,0.26956521739130435,0.8076923076923077
2021,Orlando Magic,Washington,Markelle Fultz,193.04,94.800728,PG,18,360,83,175,0.474,4,17,0.235,25,31,0.806,4,45,49,99,20,5,40,22,195,92,13,6,-18,-27,19,29.4,-26,3.3999999999999986,0.4742857142857143,0.23529411764705882,0.8064516129032258
2021,Utah Jazz,Florida State,Trent Forrest,193.04,95.25432,PG,60,766,76,155,0.49,5,27,0.185,38,48,0.792,23,76,99,106,30,6,48,43,195,79,22,10,-6,-51,28,48.85,-29,19.85,0.49032258064516127,0.18518518518518517,0.7916666666666666
2021,Toronto Raptors,San Diego State,Malachi Flynn,185.42,79.3786,PG,44,537,72,183,0.393,30,90,0.333,15,24,0.625,10,53,63,70,20,4,13,45,189,111,60,9,-78,-90,6,39.0,-162,-123.0,0.39344262295081966,0.3333333333333333,0.625
2021,New Orleans Pelicans,New Mexico,Tony Snell,198.12,96.615096,SG,53,823,69,171,0.404,45,128,0.352,4,4,1.0,16,87,103,28,16,9,19,70,187,102,83,0,-66,-114,4,36.25,-176,-139.75,0.40350877192982454,0.3515625,1.0
2021,New Orleans Pelicans,New Mexico,Tony Snell,198.12,96.615096,SG,53,823,69,171,0.404,45,128,0.352,4,4,1.0,16,87,103,28,16,9,19,70,187,102,83,0,-66,-114,4,36.25,-176,-139.75,0.40350877192982454,0.3515625,1.0
2021,New Orleans Pelicans,New Mexico,Tony Snell,198.12,96.615096,SG,53,823,69,171,0.404,45,128,0.352,4,4,1.0,16,87,103,28,16,9,19,70,187,102,83,0,-66,-114,4,36.25,-176,-139.75,0.40350877192982454,0.3515625,1.0
2021,New Orleans Pelicans,New Mexico,Tony Snell,198.12,96.615096,SG,53,823,69,171,0.404,45,128,0.352,4,4,1.0,16,87,103,28,16,9,19,70,187,102,83,0,-66,-114,4,36.25,-176,-139.75,0.40350877192982454,0.3515625,1.0
2021,New Orleans Pelicans,New Mexico,Tony Snell,198.12,96.615096,SG,53,823,69,171,0.404,45,128,0.352,4,4,1.0,16,87,103,28,16,9,19,70,187,102,83,0,-66,-114,4,36.25,-176,-139.75,0.40350877192982454,0.3515625,1.0
2021,New Orleans Pelicans,New Mexico,Tony Snell,198.12,96.615096,SG,53,823,69,171,0.404,45,128,0.352,4,4,1.0,16,87,103,28,16,9,19,70,187,102,83,0,-66,-114,4,36.25,-176,-139.75,0.40350877192982454,0.3515625,1.0
2021,New Orleans Pelicans,New Mexico,Tony Snell,198.12,96.615096,SG,53,823,69,171,0.404,45,128,0.352,4,4,1.0,16,87,103,28,16,9,19,70,187,102,83,0,-66,-114,4,36.25,-176,-139.75,0.40350877192982454,0.3515625,1.0
2021,New Orleans Pelicans,New Mexico,Tony Snell,198.12,96.615096,SG,53,823,69,171,0.404,45,128,0.352,4,4,1.0,16,87,103,28,16,9,19,70,187,102,83,0,-66,-114,4,36.25,-176,-139.75,0.40350877192982454,0.3515625,1.0
2021,New Orleans Pelicans,New Mexico,Tony Snell,198.12,96.615096,SG,53,823,69,171,0.404,45,128,0.352,4,4,1.0,16,87,103,28,16,9,19,70,187,102,83,0,-66,-114,4,36.25,-176,-139.75,0.40350877192982454,0.3515625,1.0
2021,Oklahoma City Thunder,,Vit Krejci,203.2,88.45044,SG,30,690,68,167,0.407,32,98,0.327,19,22,0.864,18,83,101,57,19,8,29,65,187,99,66,3,-62,-102,16,39.75,-148,-108.25,0.40718562874251496,0.32653061224489793,0.8636363636363636
2021,Detroit Pistons,Iowa,Luka Garza,208.28,110.222856,C,32,389,66,147,0.449,16,49,0.327,38,61,0.623,58,42,100,20,9,6,18,55,186,81,33,23,-30,-51,15,40.25,-66,-25.75,0.4489795918367347,0.32653061224489793,0.6229508196721312
2021,Cleveland Cavaliers,Kentucky,Rajon Rondo,185.42,81.64656,PG,39,698,68,176,0.386,31,88,0.352,19,26,0.731,15,93,108,170,30,6,68,56,186,108,57,7,-80,-78,12,54.45,-146,-91.55,0.38636363636363635,0.3522727272727273,0.7307692307692307
2021,Cleveland Cavaliers,Kentucky,Rajon Rondo,185.42,81.64656,PG,39,698,68,176,0.386,31,88,0.352,19,26,0.731,15,93,108,170,30,6,68,56,186,108,57,7,-80,-78,12,54.45,-146,-91.55,0.38636363636363635,0.3522727272727273,0.7307692307692307
2021,Cleveland Cavaliers,Kentucky,Rajon Rondo,185.42,81.64656,PG,39,698,68,176,0.386,31,88,0.352,19,26,0.731,15,93,108,170,30,6,68,56,186,108,57,7,-80,-78,12,54.45,-146,-91.55,0.38636363636363635,0.3522727272727273,0.7307692307692307
2021,Cleveland Cavaliers,Kentucky,Rajon Rondo,185.42,81.64656,PG,39,698,68,176,0.386,31,88,0.352,19,26,0.731,15,93,108,170,30,6,68,56,186,108,57,7,-80,-78,12,54.45,-146,-91.55,0.38636363636363635,0.3522727272727273,0.7307692307692307
2021,Cleveland Cavaliers,Kentucky,Rajon Rondo,185.42,81.64656,PG,39,698,68,176,0.386,31,88,0.352,19,26,0.731,15,93,108,170,30,6,68,56,186,108,57,7,-80,-78,12,54.45,-146,-91.55,0.38636363636363635,0.3522727272727273,0.7307692307692307
2021,Cleveland Cavaliers,Kentucky,Rajon Rondo,185.42,81.64656,PG,39,698,68,176,0.386,31,88,0.352,19,26,0.731,15,93,108,170,30,6,68,56,186,108,57,7,-80,-78,12,54.45,-146,-91.55,0.38636363636363635,0.3522727272727273,0.7307692307692307
2021,Cleveland Cavaliers,Kentucky,Rajon Rondo,185.42,81.64656,PG,39,698,68,176,0.386,31,88,0.352,19,26,0.731,15,93,108,170,30,6,68,56,186,108,57,7,-80,-78,12,54.45,-146,-91.55,0.38636363636363635,0.3522727272727273,0.7307692307692307
2021,Cleveland Cavaliers,Kentucky,Rajon Rondo,185.42,81.64656,PG,39,698,68,176,0.386,31,88,0.352,19,26,0.731,15,93,108,170,30,6,68,56,186,108,57,7,-80,-78,12,54.45,-146,-91.55,0.38636363636363635,0.3522727272727273,0.7307692307692307
2021,Cleveland Cavaliers,Kentucky,Rajon Rondo,185.42,81.64656,PG,39,698,68,176,0.386,31,88,0.352,19,26,0.731,15,93,108,170,30,6,68,56,186,108,57,7,-80,-78,12,54.45,-146,-91.55,0.38636363636363635,0.3522727272727273,0.7307692307692307
2021,Charlotte Hornets,Washington,Isaiah Thomas,175.26,83.91452,PG,22,333,67,167,0.401,28,83,0.337,22,26,0.846,4,25,29,34,7,5,15,34,184,100,55,4,-66,-81,18,13.55,-129,-115.45,0.40119760479041916,0.3373493975903614,0.8461538461538461
2021,Charlotte Hornets,Washington,Isaiah Thomas,175.26,83.91452,PG,22,333,67,167,0.401,28,83,0.337,22,26,0.846,4,25,29,34,7,5,15,34,184,100,55,4,-66,-81,18,13.55,-129,-115.45,0.40119760479041916,0.3373493975903614,0.8461538461538461
2021,Charlotte Hornets,Washington,Isaiah Thomas,175.26,83.91452,PG,22,333,67,167,0.401,28,83,0.337,22,26,0.846,4,25,29,34,7,5,15,34,184,100,55,4,-66,-81,18,13.55,-129,-115.45,0.40119760479041916,0.3373493975903614,0.8461538461538461
2021,Charlotte Hornets,Washington,Isaiah Thomas,175.26,83.91452,PG,22,333,67,167,0.401,28,83,0.337,22,26,0.846,4,25,29,34,7,5,15,34,184,100,55,4,-66,-81,18,13.55,-129,-115.45,0.40119760479041916,0.3373493975903614,0.8461538461538461
2021,Charlotte Hornets,Washington,Isaiah Thomas,175.26,83.91452,PG,22,333,67,167,0.401,28,83,0.337,22,26,0.846,4,25,29,34,7,5,15,34,184,100,55,4,-66,-81,18,13.55,-129,-115.45,0.40119760479041916,0.3373493975903614,0.8461538461538461
2021,Charlotte Hornets,Washington,Isaiah Thomas,175.26,83.91452,PG,22,333,67,167,0.401,28,83,0.337,22,26,0.846,4,25,29,34,7,5,15,34,184,100,55,4,-66,-81,18,13.55,-129,-115.45,0.40119760479041916,0.3373493975903614,0.8461538461538461
2021,Charlotte Hornets,Washington,Isaiah Thomas,175.26,83.91452,PG,22,333,67,167,0.401,28,83,0.337,22,26,0.846,4,25,29,34,7,5,15,34,184,100,55,4,-66,-81,18,13.55,-129,-115.45,0.40119760479041916,0.3373493975903614,0.8461538461538461
2021,Charlotte Hornets,Washington,Isaiah Thomas,175.26,83.91452,PG,22,333,67,167,0.401,28,83,0.337,22,26,0.846,4,25,29,34,7,5,15,34,184,100,55,4,-66,-81,18,13.55,-129,-115.45,0.40119760479041916,0.3373493975903614,0.8461538461538461
2021,Charlotte Hornets,Washington,Isaiah Thomas,175.26,83.91452,PG,22,333,67,167,0.401,28,83,0.337,22,26,0.846,4,25,29,34,7,5,15,34,184,100,55,4,-66,-81,18,13.55,-129,-115.45,0.40119760479041916,0.3373493975903614,0.8461538461538461
2021,Charlotte Hornets,Washington,Isaiah Thomas,175.26,83.91452,PG,22,333,67,167,0.401,28,83,0.337,22,26,0.846,4,25,29,34,7,5,15,34,184,100,55,4,-66,-81,18,13.55,-129,-115.45,0.40119760479041916,0.3373493975903614,0.8461538461538461
2021,Charlotte Hornets,Washington,Isaiah Thomas,175.26,83.91452,PG,22,333,67,167,0.401,28,83,0.337,22,26,0.846,4,25,29,34,7,5,15,34,184,100,55,4,-66,-81,18,13.55,-129,-115.45,0.40119760479041916,0.3373493975903614,0.8461538461538461
2021,Charlotte Hornets,Washington,Isaiah Thomas,175.26,83.91452,PG,22,333,67,167,0.401,28,83,0.337,22,26,0.846,4,25,29,34,7,5,15,34,184,100,55,4,-66,-81,18,13.55,-129,-115.45,0.40119760479041916,0.3373493975903614,0.8461538461538461
2021,Charlotte Hornets,Washington,Isaiah Thomas,175.26,83.91452,PG,22,333,67,167,0.401,28,83,0.337,22,26,0.846,4,25,29,34,7,5,15,34,184,100,55,4,-66,-81,18,13.55,-129,-115.45,0.40119760479041916,0.3373493975903614,0.8461538461538461
2021,Charlotte Hornets,Washington,Isaiah Thomas,175.26,83.91452,PG,22,333,67,167,0.401,28,83,0.337,22,26,0.846,4,25,29,34,7,5,15,34,184,100,55,4,-66,-81,18,13.55,-129,-115.45,0.40119760479041916,0.3373493975903614,0.8461538461538461
2021,Charlotte Hornets,Washington,Isaiah Thomas,175.26,83.91452,PG,22,333,67,167,0.401,28,83,0.337,22,26,0.846,4,25,29,34,7,5,15,34,184,100,55,4,-66,-81,18,13.55,-129,-115.45,0.40119760479041916,0.3373493975903614,0.8461538461538461
2021,Charlotte Hornets,Washington,Isaiah Thomas,175.26,83.91452,PG,22,333,67,167,0.401,28,83,0.337,22,26,0.846,4,25,29,34,7,5,15,34,184,100,55,4,-66,-81,18,13.55,-129,-115.45,0.40119760479041916,0.3373493975903614,0.8461538461538461
2021,Washington Wizards,Virginia,Anthony Gill,200.66,104.32616,PF,44,463,62,109,0.569,14,26,0.538,42,52,0.808,33,52,85,27,5,11,18,58,180,47,12,10,30,6,32,32.35,68,100.35,0.5688073394495413,0.5384615384615384,0.8076923076923077
2021,Indiana Pacers,Wisc.-Green Bay,Keifer Sykes,180.34,75.749864,PG,32,566,69,190,0.363,27,90,0.3,15,17,0.882,8,37,45,62,12,4,33,51,180,121,63,2,-104,-108,13,17.7,-199,-181.3,0.3631578947368421,0.3,0.8823529411764706
2021,Cleveland Cavaliers,Alabama,Collin Sexton,185.42,86.18248,SG,11,316,68,151,0.45,11,45,0.244,29,39,0.744,13,23,36,23,10,0,31,25,176,83,34,10,-30,-69,19,6.25,-80,-73.75,0.4503311258278146,0.24444444444444444,0.7435897435897436
2021,Cleveland Cavaliers,Florida Gulf Coast,Brandon Goodwin,182.88,81.64656,PG,36,502,64,154,0.416,19,55,0.345,24,38,0.632,14,53,67,91,25,1,36,39,171,90,36,14,-52,-51,10,36.05,-93,-56.95,0.4155844155844156,0.34545454545454546,0.631578947368421
2021,Boston Celtics,Butler,Kelan Martin,195.58,104.32616,SF,30,450,70,171,0.409,22,75,0.293,9,13,0.692,17,38,55,21,13,9,14,36,171,101,53,4,-62,-93,5,25.45,-150,-124.55,0.4093567251461988,0.29333333333333333,0.6923076923076923
2021,Boston Celtics,Butler,Kelan Martin,195.58,104.32616,SF,30,450,70,171,0.409,22,75,0.293,9,13,0.692,17,38,55,21,13,9,14,36,171,101,53,4,-62,-93,5,25.45,-150,-124.55,0.4093567251461988,0.29333333333333333,0.6923076923076923
2021,Boston Celtics,Butler,Kelan Martin,195.58,104.32616,SF,30,450,70,171,0.409,22,75,0.293,9,13,0.692,17,38,55,21,13,9,14,36,171,101,53,4,-62,-93,5,25.45,-150,-124.55,0.4093567251461988,0.29333333333333333,0.6923076923076923
2021,Boston Celtics,Butler,Kelan Martin,195.58,104.32616,SF,30,450,70,171,0.409,22,75,0.293,9,13,0.692,17,38,55,21,13,9,14,36,171,101,53,4,-62,-93,5,25.45,-150,-124.55,0.4093567251461988,0.29333333333333333,0.6923076923076923
2021,Boston Celtics,Butler,Kelan Martin,195.58,104.32616,SF,30,450,70,171,0.409,22,75,0.293,9,13,0.692,17,38,55,21,13,9,14,36,171,101,53,4,-62,-93,5,25.45,-150,-124.55,0.4093567251461988,0.29333333333333333,0.6923076923076923
2021,Boston Celtics,Butler,Kelan Martin,195.58,104.32616,SF,30,450,70,171,0.409,22,75,0.293,9,13,0.692,17,38,55,21,13,9,14,36,171,101,53,4,-62,-93,5,25.45,-150,-124.55,0.4093567251461988,0.29333333333333333,0.6923076923076923
2021,Boston Celtics,Butler,Kelan Martin,195.58,104.32616,SF,30,450,70,171,0.409,22,75,0.293,9,13,0.692,17,38,55,21,13,9,14,36,171,101,53,4,-62,-93,5,25.45,-150,-124.55,0.4093567251461988,0.29333333333333333,0.6923076923076923
2021,Boston Celtics,Butler,Kelan Martin,195.58,104.32616,SF,30,450,70,171,0.409,22,75,0.293,9,13,0.692,17,38,55,21,13,9,14,36,171,101,53,4,-62,-93,5,25.45,-150,-124.55,0.4093567251461988,0.29333333333333333,0.6923076923076923
2021,Boston Celtics,Butler,Kelan Martin,195.58,104.32616,SF,30,450,70,171,0.409,22,75,0.293,9,13,0.692,17,38,55,21,13,9,14,36,171,101,53,4,-62,-93,5,25.45,-150,-124.55,0.4093567251461988,0.29333333333333333,0.6923076923076923
2021,Cleveland Cavaliers,UCLA,Moses Brown,218.44,111.13004,C,40,344,64,108,0.593,0,0,0.0,43,72,0.597,39,96,135,1,7,16,20,53,171,44,0,29,40,0,14,42.6,54,96.6,0.5925925925925926,,0.5972222222222222
2021,Cleveland Cavaliers,UCLA,Moses Brown,218.44,111.13004,C,40,344,64,108,0.593,0,0,0.0,43,72,0.597,39,96,135,1,7,16,20,53,171,44,0,29,40,0,14,42.6,54,96.6,0.5925925925925926,,0.5972222222222222
2021,Cleveland Cavaliers,UCLA,Moses Brown,218.44,111.13004,C,40,344,64,108,0.593,0,0,0.0,43,72,0.597,39,96,135,1,7,16,20,53,171,44,0,29,40,0,14,42.6,54,96.6,0.5925925925925926,,0.5972222222222222
2021,Cleveland Cavaliers,UCLA,Moses Brown,218.44,111.13004,C,40,344,64,108,0.593,0,0,0.0,43,72,0.597,39,96,135,1,7,16,20,53,171,44,0,29,40,0,14,42.6,54,96.6,0.5925925925925926,,0.5972222222222222
2021,Cleveland Cavaliers,UCLA,Moses Brown,218.44,111.13004,C,40,344,64,108,0.593,0,0,0.0,43,72,0.597,39,96,135,1,7,16,20,53,171,44,0,29,40,0,14,42.6,54,96.6,0.5925925925925926,,0.5972222222222222
2021,Cleveland Cavaliers,UCLA,Moses Brown,218.44,111.13004,C,40,344,64,108,0.593,0,0,0.0,43,72,0.597,39,96,135,1,7,16,20,53,171,44,0,29,40,0,14,42.6,54,96.6,0.5925925925925926,,0.5972222222222222
2021,Cleveland Cavaliers,UCLA,Moses Brown,218.44,111.13004,C,40,344,64,108,0.593,0,0,0.0,43,72,0.597,39,96,135,1,7,16,20,53,171,44,0,29,40,0,14,42.6,54,96.6,0.5925925925925926,,0.5972222222222222
2021,Cleveland Cavaliers,UCLA,Moses Brown,218.44,111.13004,C,40,344,64,108,0.593,0,0,0.0,43,72,0.597,39,96,135,1,7,16,20,53,171,44,0,29,40,0,14,42.6,54,96.6,0.5925925925925926,,0.5972222222222222
2021,Cleveland Cavaliers,UCLA,Moses Brown,218.44,111.13004,C,40,344,64,108,0.593,0,0,0.0,43,72,0.597,39,96,135,1,7,16,20,53,171,44,0,29,40,0,14,42.6,54,96.6,0.5925925925925926,,0.5972222222222222
2021,Milwaukee Bucks,,Thanasis Antetokounmpo,198.12,99.336648,SF,48,473,70,128,0.547,2,14,0.143,29,46,0.63,40,61,101,22,16,12,26,68,171,58,12,17,24,-30,12,38.35,6,44.35,0.546875,0.14285714285714285,0.6304347826086957
2021,Los Angeles Clippers,Duke,Rodney Hood,203.2,94.347136,PF,52,709,58,157,0.369,30,91,0.33,17,19,0.895,15,62,77,38,15,6,11,31,163,99,61,2,-82,-93,15,35.95,-160,-124.05,0.36942675159235666,0.32967032967032966,0.8947368421052632
2021,Los Angeles Clippers,Duke,Rodney Hood,203.2,94.347136,PF,52,709,58,157,0.369,30,91,0.33,17,19,0.895,15,62,77,38,15,6,11,31,163,99,61,2,-82,-93,15,35.95,-160,-124.05,0.36942675159235666,0.32967032967032966,0.8947368421052632
2021,Los Angeles Clippers,Duke,Rodney Hood,203.2,94.347136,PF,52,709,58,157,0.369,30,91,0.33,17,19,0.895,15,62,77,38,15,6,11,31,163,99,61,2,-82,-93,15,35.95,-160,-124.05,0.36942675159235666,0.32967032967032966,0.8947368421052632
2021,Los Angeles Clippers,Duke,Rodney Hood,203.2,94.347136,PF,52,709,58,157,0.369,30,91,0.33,17,19,0.895,15,62,77,38,15,6,11,31,163,99,61,2,-82,-93,15,35.95,-160,-124.05,0.36942675159235666,0.32967032967032966,0.8947368421052632
2021,Los Angeles Clippers,Duke,Rodney Hood,203.2,94.347136,PF,52,709,58,157,0.369,30,91,0.33,17,19,0.895,15,62,77,38,15,6,11,31,163,99,61,2,-82,-93,15,35.95,-160,-124.05,0.36942675159235666,0.32967032967032966,0.8947368421052632
2021,Los Angeles Clippers,Duke,Rodney Hood,203.2,94.347136,PF,52,709,58,157,0.369,30,91,0.33,17,19,0.895,15,62,77,38,15,6,11,31,163,99,61,2,-82,-93,15,35.95,-160,-124.05,0.36942675159235666,0.32967032967032966,0.8947368421052632
2021,Los Angeles Clippers,Duke,Rodney Hood,203.2,94.347136,SF,52,709,58,157,0.369,30,91,0.33,17,19,0.895,15,62,77,38,15,6,11,31,163,99,61,2,-82,-93,15,35.95,-160,-124.05,0.36942675159235666,0.32967032967032966,0.8947368421052632
2021,Los Angeles Clippers,Duke,Rodney Hood,203.2,94.347136,SF,52,709,58,157,0.369,30,91,0.33,17,19,0.895,15,62,77,38,15,6,11,31,163,99,61,2,-82,-93,15,35.95,-160,-124.05,0.36942675159235666,0.32967032967032966,0.8947368421052632
2021,Los Angeles Clippers,Duke,Rodney Hood,203.2,94.347136,SF,52,709,58,157,0.369,30,91,0.33,17,19,0.895,15,62,77,38,15,6,11,31,163,99,61,2,-82,-93,15,35.95,-160,-124.05,0.36942675159235666,0.32967032967032966,0.8947368421052632
2021,Chicago Bulls,North Carolina,Tony Bradley,208.28,112.490816,C,55,549,72,123,0.585,0,0,0.0,19,29,0.655,67,119,186,27,10,33,34,62,163,51,0,10,42,0,9,71.4,51,122.4,0.5853658536585366,,0.6551724137931034
2021,Toronto Raptors,George Washington,Yuta Watanabe,205.74,97.52228,SF,38,445,56,138,0.406,27,79,0.342,24,40,0.6,18,74,92,21,11,16,19,38,163,82,52,16,-52,-75,8,34.85,-119,-84.15,0.4057971014492754,0.34177215189873417,0.6
2021,Milwaukee Bucks,Stanford,Brook Lopez,213.36,127.912944,C,13,298,61,131,0.466,19,53,0.358,20,23,0.87,19,34,53,6,8,15,12,34,161,70,34,3,-18,-45,17,23.3,-46,-22.7,0.46564885496183206,0.3584905660377358,0.8695652173913043
2021,Utah Jazz,Baylor,Jared Butler,190.5,87.543256,SG,42,360,61,151,0.404,28,88,0.318,11,16,0.688,5,40,45,63,17,8,33,47,161,90,60,5,-58,-96,6,21.9,-148,-126.1,0.40397350993377484,0.3181818181818182,0.6875
2021,Chicago Bulls,Iowa State,Matt Thomas,190.5,86.18248,SG,40,460,55,134,0.41,35,91,0.385,16,20,0.8,3,47,50,20,8,3,8,18,161,79,56,4,-48,-63,12,18.85,-99,-80.15,0.41044776119402987,0.38461538461538464,0.8
2021,Dallas Mavericks,Southern Methodist,Sterling Brown,195.58,99.336648,SG,49,628,59,155,0.381,28,92,0.304,14,15,0.933,26,123,149,34,14,7,23,56,160,96,64,1,-74,-108,13,48.45,-169,-120.55,0.38064516129032255,0.30434782608695654,0.9333333333333333
2021,Brooklyn Nets,Virginia,Joe Harris,198.12,99.79024,SF,14,423,56,124,0.452,41,88,0.466,5,6,0.833,5,51,56,14,7,2,16,31,158,68,47,1,-24,-18,4,13.7,-38,-24.3,0.45161290322580644,0.4659090909090909,0.8333333333333334
2021,Atlanta Hawks,Louisville,Gorgui Dieng,208.28,112.490816,C,44,371,53,112,0.473,29,68,0.426,19,26,0.731,32,89,121,34,11,13,20,52,154,59,39,7,-12,-30,12,46.15,-30,16.15,0.4732142857142857,0.4264705882352941,0.7307692307692307
2021,Dallas Mavericks,Washington,Marquese Chriss,205.74,108.86208,PF,34,346,62,134,0.463,8,25,0.32,22,33,0.667,33,70,103,17,13,12,17,64,154,72,17,11,-20,-27,11,39.05,-36,3.049999999999997,0.4626865671641791,0.32,0.6666666666666666
2021,Milwaukee Bucks,Seton Hall,Sandro Mamukelashvili,205.74,108.86208,PF,41,407,57,115,0.496,22,52,0.423,18,22,0.818,35,47,82,22,9,9,15,28,154,58,30,4,-2,-24,14,34.85,-12,22.85,0.4956521739130435,0.4230769230769231,0.8181818181818182
2021,Oklahoma City Thunder,Kentucky,Olivier Sarr,213.36,108.86208,C,22,421,58,101,0.574,13,29,0.448,24,29,0.828,34,59,93,19,6,15,22,52,153,43,16,5,30,-9,19,33.4,40,73.4,0.5742574257425742,0.4482758620689655,0.8275862068965517
2021,Chicago Bulls,Florida State,Patrick Williams,200.66,97.52228,PF,17,422,54,102,0.529,15,29,0.517,30,41,0.732,17,52,69,15,9,9,16,28,153,48,14,11,12,3,19,24.85,34,58.85,0.5294117647058824,0.5172413793103449,0.7317073170731707
2021,Phoenix Suns,Louisana-Lafayette,Elfrid Payton,190.5,88.45044,PG,50,549,67,175,0.383,4,18,0.222,12,32,0.375,21,67,88,99,25,6,47,38,150,108,14,20,-82,-30,-8,42.1,-120,-77.9,0.38285714285714284,0.2222222222222222,0.375
2021,Charlotte Hornets,Kentucky,Nick Richards,213.36,111.13004,C,50,367,60,90,0.667,0,0,0.0,30,43,0.698,34,52,86,13,9,21,24,51,150,30,0,13,60,0,17,33.7,77,110.7,0.6666666666666666,,0.6976744186046512
2021,Orlando Magic,Tennessee,Admiral Schofield,195.58,109.315672,SF,38,469,54,129,0.419,26,79,0.329,12,15,0.8,17,72,89,25,4,5,21,58,146,75,53,3,-42,-81,9,23.85,-114,-90.15,0.4186046511627907,0.3291139240506329,0.8
2021,Charlotte Hornets,Connecticut,James Bouknight,193.04,86.18248,SG,31,304,49,141,0.348,17,49,0.347,27,31,0.871,22,30,52,26,7,1,15,29,142,92,32,4,-86,-45,23,20.05,-108,-87.95,0.3475177304964539,0.3469387755102041,0.8709677419354839
2021,New Orleans Pelicans,Alabama,Kira Lewis Jr.,185.42,77.11064,PG,24,341,59,146,0.404,13,58,0.224,10,12,0.833,9,30,39,49,11,1,26,17,141,87,45,2,-56,-96,8,16.4,-144,-127.6,0.4041095890410959,0.22413793103448276,0.8333333333333334
2021,Los Angeles Lakers,Kentucky,Wenyen Gabriel,205.74,92.98636,PF,26,359,54,110,0.491,8,28,0.286,25,42,0.595,39,58,97,14,5,11,16,68,141,56,20,17,-4,-36,8,34.1,-32,2.1000000000000014,0.4909090909090909,0.2857142857142857,0.5952380952380952
2021,Los Angeles Lakers,Kentucky,Wenyen Gabriel,205.74,92.98636,PF,26,359,54,110,0.491,8,28,0.286,25,42,0.595,39,58,97,14,5,11,16,68,141,56,20,17,-4,-36,8,34.1,-32,2.1000000000000014,0.4909090909090909,0.2857142857142857,0.5952380952380952
2021,Los Angeles Lakers,Kentucky,Wenyen Gabriel,205.74,92.98636,PF,26,359,54,110,0.491,8,28,0.286,25,42,0.595,39,58,97,14,5,11,16,68,141,56,20,17,-4,-36,8,34.1,-32,2.1000000000000014,0.4909090909090909,0.2857142857142857,0.5952380952380952
2021,Los Angeles Lakers,Kentucky,Wenyen Gabriel,205.74,92.98636,PF,26,359,54,110,0.491,8,28,0.286,25,42,0.595,39,58,97,14,5,11,16,68,141,56,20,17,-4,-36,8,34.1,-32,2.1000000000000014,0.4909090909090909,0.2857142857142857,0.5952380952380952
2021,Los Angeles Lakers,Kentucky,Wenyen Gabriel,205.74,92.98636,PF,26,359,54,110,0.491,8,28,0.286,25,42,0.595,39,58,97,14,5,11,16,68,141,56,20,17,-4,-36,8,34.1,-32,2.1000000000000014,0.4909090909090909,0.2857142857142857,0.5952380952380952
2021,Los Angeles Lakers,Kentucky,Wenyen Gabriel,205.74,92.98636,PF,26,359,54,110,0.491,8,28,0.286,25,42,0.595,39,58,97,14,5,11,16,68,141,56,20,17,-4,-36,8,34.1,-32,2.1000000000000014,0.4909090909090909,0.2857142857142857,0.5952380952380952
2021,Los Angeles Lakers,Kentucky,Wenyen Gabriel,205.74,92.98636,PF,26,359,54,110,0.491,8,28,0.286,25,42,0.595,39,58,97,14,5,11,16,68,141,56,20,17,-4,-36,8,34.1,-32,2.1000000000000014,0.4909090909090909,0.2857142857142857,0.5952380952380952
2021,Los Angeles Lakers,Kentucky,Wenyen Gabriel,205.74,92.98636,PF,26,359,54,110,0.491,8,28,0.286,25,42,0.595,39,58,97,14,5,11,16,68,141,56,20,17,-4,-36,8,34.1,-32,2.1000000000000014,0.4909090909090909,0.2857142857142857,0.5952380952380952
2021,Los Angeles Lakers,Kentucky,Wenyen Gabriel,205.74,92.98636,PF,26,359,54,110,0.491,8,28,0.286,25,42,0.595,39,58,97,14,5,11,16,68,141,56,20,17,-4,-36,8,34.1,-32,2.1000000000000014,0.4909090909090909,0.2857142857142857,0.5952380952380952
2021,Los Angeles Lakers,Kentucky,Wenyen Gabriel,205.74,92.98636,PF,26,359,54,110,0.491,8,28,0.286,25,42,0.595,39,58,97,14,5,11,16,68,141,56,20,17,-4,-36,8,34.1,-32,2.1000000000000014,0.4909090909090909,0.2857142857142857,0.5952380952380952
2021,Los Angeles Lakers,Kentucky,Wenyen Gabriel,205.74,92.98636,PF,26,359,54,110,0.491,8,28,0.286,25,42,0.595,39,58,97,14,5,11,16,68,141,56,20,17,-4,-36,8,34.1,-32,2.1000000000000014,0.4909090909090909,0.2857142857142857,0.5952380952380952
2021,Los Angeles Lakers,Kentucky,Wenyen Gabriel,205.74,92.98636,PF,26,359,54,110,0.491,8,28,0.286,25,42,0.595,39,58,97,14,5,11,16,68,141,56,20,17,-4,-36,8,34.1,-32,2.1000000000000014,0.4909090909090909,0.2857142857142857,0.5952380952380952
2021,Los Angeles Lakers,Kentucky,Wenyen Gabriel,205.74,92.98636,PF,26,359,54,110,0.491,8,28,0.286,25,42,0.595,39,58,97,14,5,11,16,68,141,56,20,17,-4,-36,8,34.1,-32,2.1000000000000014,0.4909090909090909,0.2857142857142857,0.5952380952380952
2021,Los Angeles Lakers,Kentucky,Wenyen Gabriel,205.74,92.98636,PF,26,359,54,110,0.491,8,28,0.286,25,42,0.595,39,58,97,14,5,11,16,68,141,56,20,17,-4,-36,8,34.1,-32,2.1000000000000014,0.4909090909090909,0.2857142857142857,0.5952380952380952
2021,Los Angeles Lakers,Kentucky,Wenyen Gabriel,205.74,92.98636,PF,26,359,54,110,0.491,8,28,0.286,25,42,0.595,39,58,97,14,5,11,16,68,141,56,20,17,-4,-36,8,34.1,-32,2.1000000000000014,0.4909090909090909,0.2857142857142857,0.5952380952380952
2021,Los Angeles Lakers,Kentucky,Wenyen Gabriel,205.74,92.98636,PF,26,359,54,110,0.491,8,28,0.286,25,42,0.595,39,58,97,14,5,11,16,68,141,56,20,17,-4,-36,8,34.1,-32,2.1000000000000014,0.4909090909090909,0.2857142857142857,0.5952380952380952
2021,Portland Trail Blazers,Indiana,Cody Zeller,210.82,108.86208,C,27,355,51,90,0.567,0,4,0.0,38,49,0.776,50,75,125,22,8,6,19,56,140,39,4,11,24,-12,27,43.95,39,82.95,0.5666666666666667,0.0,0.7755102040816326
2021,Minnesota Timberwolves,William & Mary,Nathan Knight,208.28,114.758776,PF,37,267,45,88,0.511,4,13,0.308,44,60,0.733,32,53,85,22,7,8,18,42,138,43,9,16,4,-15,28,31.15,17,48.15,0.5113636363636364,0.3076923076923077,0.7333333333333333
2021,Minnesota Timberwolves,Georgia Tech,Josh Okogie,193.04,96.615096,SG,49,516,42,104,0.404,14,47,0.298,35,51,0.686,29,41,70,25,26,12,23,53,133,62,33,16,-40,-57,19,35.85,-78,-42.15,0.40384615384615385,0.2978723404255319,0.6862745098039216
2021,Los Angeles Lakers,Old Dominion,Kent Bazemore,193.04,88.45044,SF,39,545,45,139,0.324,29,80,0.363,13,17,0.765,13,56,69,34,25,9,21,70,132,94,51,4,-98,-66,9,32.0,-155,-123.0,0.3237410071942446,0.3625,0.7647058823529411
2021,Memphis Grizzlies,Loyola-Maryland,Santi Aldama,210.82,97.52228,PF,32,360,53,132,0.402,6,48,0.125,20,32,0.625,33,54,87,21,6,10,16,36,132,79,42,12,-52,-108,8,33.45,-152,-118.55,0.4015151515151515,0.125,0.625
2021,Memphis Grizzlies,Texas Tech,Jarrett Culver,198.12,88.45044,SG,37,338,51,135,0.378,12,47,0.255,16,34,0.471,13,35,48,33,20,5,20,42,130,84,35,18,-66,-69,-2,23.9,-137,-113.1,0.37777777777777777,0.2553191489361702,0.47058823529411764
2021,Miami Heat,Kansas,Markieff Morris,205.74,111.13004,PF,17,298,54,114,0.474,13,39,0.333,8,9,0.889,17,28,45,23,6,1,20,33,129,60,26,1,-12,-39,7,13.1,-44,-30.9,0.47368421052631576,0.3333333333333333,0.8888888888888888
2021,Boston Celtics,,Enes Freedom,208.28,113.398,C,35,411,51,97,0.526,2,5,0.4,24,28,0.857,61,99,160,8,5,14,20,42,128,46,3,4,10,-3,20,54.65,27,81.65,0.5257731958762887,0.4,0.8571428571428571
2021,Portland Trail Blazers,Syracuse,Elijah Hughes,195.58,97.52228,SG,36,434,47,144,0.326,25,95,0.263,7,9,0.778,6,52,58,22,14,8,17,39,126,97,70,2,-100,-135,5,22.05,-230,-207.95,0.3263888888888889,0.2631578947368421,0.7777777777777778
2021,Portland Trail Blazers,Syracuse,Elijah Hughes,195.58,97.52228,SG,36,434,47,144,0.326,25,95,0.263,7,9,0.778,6,52,58,22,14,8,17,39,126,97,70,2,-100,-135,5,22.05,-230,-207.95,0.3263888888888889,0.2631578947368421,0.7777777777777778
2021,Portland Trail Blazers,Syracuse,Elijah Hughes,195.58,97.52228,SG,36,434,47,144,0.326,25,95,0.263,7,9,0.778,6,52,58,22,14,8,17,39,126,97,70,2,-100,-135,5,22.05,-230,-207.95,0.3263888888888889,0.2631578947368421,0.7777777777777778
2021,Portland Trail Blazers,Syracuse,Elijah Hughes,195.58,97.52228,SF,36,434,47,144,0.326,25,95,0.263,7,9,0.778,6,52,58,22,14,8,17,39,126,97,70,2,-100,-135,5,22.05,-230,-207.95,0.3263888888888889,0.2631578947368421,0.7777777777777778
2021,Portland Trail Blazers,Syracuse,Elijah Hughes,195.58,97.52228,SF,36,434,47,144,0.326,25,95,0.263,7,9,0.778,6,52,58,22,14,8,17,39,126,97,70,2,-100,-135,5,22.05,-230,-207.95,0.3263888888888889,0.2631578947368421,0.7777777777777778
2021,Portland Trail Blazers,Syracuse,Elijah Hughes,195.58,97.52228,SF,36,434,47,144,0.326,25,95,0.263,7,9,0.778,6,52,58,22,14,8,17,39,126,97,70,2,-100,-135,5,22.05,-230,-207.95,0.3263888888888889,0.2631578947368421,0.7777777777777778
2021,Portland Trail Blazers,Syracuse,Elijah Hughes,195.58,97.52228,SG,36,434,47,144,0.326,25,95,0.263,7,9,0.778,6,52,58,22,14,8,17,39,126,97,70,2,-100,-135,5,22.05,-230,-207.95,0.3263888888888889,0.2631578947368421,0.7777777777777778
2021,Portland Trail Blazers,Syracuse,Elijah Hughes,195.58,97.52228,SG,36,434,47,144,0.326,25,95,0.263,7,9,0.778,6,52,58,22,14,8,17,39,126,97,70,2,-100,-135,5,22.05,-230,-207.95,0.3263888888888889,0.2631578947368421,0.7777777777777778
2021,Portland Trail Blazers,Syracuse,Elijah Hughes,195.58,97.52228,SG,36,434,47,144,0.326,25,95,0.263,7,9,0.778,6,52,58,22,14,8,17,39,126,97,70,2,-100,-135,5,22.05,-230,-207.95,0.3263888888888889,0.2631578947368421,0.7777777777777778
2021,Denver Nuggets,Marquette,Markus Howard,177.8,79.3786,SG,31,177,39,101,0.386,28,70,0.4,20,23,0.87,2,10,12,7,9,0,7,17,126,62,42,3,-46,-42,17,5.4,-71,-65.6,0.38613861386138615,0.4,0.8695652173913043
2021,Golden State Warriors,Arizona,Andre Iguodala,198.12,97.52228,SF,31,603,46,121,0.38,17,74,0.23,15,20,0.75,21,79,100,114,27,22,28,34,124,75,57,5,-58,-120,10,67.55,-168,-100.45,0.38016528925619836,0.22972972972972974,0.75
2021,Detroit Pistons,Michigan,Isaiah Livers,198.12,105.233344,SF,19,383,41,90,0.456,27,64,0.422,12,14,0.857,15,42,57,21,13,7,15,37,121,49,37,2,-16,-30,10,23.9,-36,-12.100000000000001,0.45555555555555555,0.421875,0.8571428571428571
2021,Memphis Grizzlies,Gonzaga,Killian Tillie,205.74,99.79024,C,36,461,43,127,0.339,27,86,0.314,5,8,0.625,21,39,60,22,23,15,13,58,118,84,59,3,-82,-96,2,35.35,-176,-140.65,0.33858267716535434,0.313953488372093,0.625
2021,Philadelphia 76ers,DePaul,Paul Reed,205.74,95.25432,C,38,303,54,96,0.563,2,8,0.25,6,14,0.429,44,48,92,16,33,14,10,57,116,42,6,8,24,-12,-2,53.65,10,63.65,0.5625,0.25,0.42857142857142855
2021,Philadelphia 76ers,Louisiana Tech,Paul Millsap,200.66,116.573144,C,33,376,45,115,0.391,8,35,0.229,17,24,0.708,41,73,114,29,10,13,19,67,115,70,27,7,-50,-57,10,44.65,-97,-52.35,0.391304347826087,0.22857142857142856,0.7083333333333334
2021,Philadelphia 76ers,Louisiana Tech,Paul Millsap,200.66,116.573144,C,33,376,45,115,0.391,8,35,0.229,17,24,0.708,41,73,114,29,10,13,19,67,115,70,27,7,-50,-57,10,44.65,-97,-52.35,0.391304347826087,0.22857142857142856,0.7083333333333334
2021,Philadelphia 76ers,Louisiana Tech,Paul Millsap,200.66,116.573144,C,33,376,45,115,0.391,8,35,0.229,17,24,0.708,41,73,114,29,10,13,19,67,115,70,27,7,-50,-57,10,44.65,-97,-52.35,0.391304347826087,0.22857142857142856,0.7083333333333334
2021,Philadelphia 76ers,Louisiana Tech,Paul Millsap,200.66,116.573144,C,33,376,45,115,0.391,8,35,0.229,17,24,0.708,41,73,114,29,10,13,19,67,115,70,27,7,-50,-57,10,44.65,-97,-52.35,0.391304347826087,0.22857142857142856,0.7083333333333334
2021,Philadelphia 76ers,Louisiana Tech,Paul Millsap,200.66,116.573144,C,33,376,45,115,0.391,8,35,0.229,17,24,0.708,41,73,114,29,10,13,19,67,115,70,27,7,-50,-57,10,44.65,-97,-52.35,0.391304347826087,0.22857142857142856,0.7083333333333334
2021,Philadelphia 76ers,Louisiana Tech,Paul Millsap,200.66,116.573144,C,33,376,45,115,0.391,8,35,0.229,17,24,0.708,41,73,114,29,10,13,19,67,115,70,27,7,-50,-57,10,44.65,-97,-52.35,0.391304347826087,0.22857142857142856,0.7083333333333334
2021,Philadelphia 76ers,Louisiana Tech,Paul Millsap,200.66,116.573144,C,33,376,45,115,0.391,8,35,0.229,17,24,0.708,41,73,114,29,10,13,19,67,115,70,27,7,-50,-57,10,44.65,-97,-52.35,0.391304347826087,0.22857142857142856,0.7083333333333334
2021,Philadelphia 76ers,Louisiana Tech,Paul Millsap,200.66,116.573144,C,33,376,45,115,0.391,8,35,0.229,17,24,0.708,41,73,114,29,10,13,19,67,115,70,27,7,-50,-57,10,44.65,-97,-52.35,0.391304347826087,0.22857142857142856,0.7083333333333334
2021,Philadelphia 76ers,Louisiana Tech,Paul Millsap,200.66,116.573144,C,33,376,45,115,0.391,8,35,0.229,17,24,0.708,41,73,114,29,10,13,19,67,115,70,27,7,-50,-57,10,44.65,-97,-52.35,0.391304347826087,0.22857142857142856,0.7083333333333334
2021,Cleveland Cavaliers,Belmont,Dylan Windler,198.12,88.904032,SF,50,459,37,98,0.378,21,70,0.3,15,18,0.833,21,68,89,34,14,3,16,47,110,61,49,3,-48,-84,12,34.15,-120,-85.85,0.37755102040816324,0.3,0.8333333333333334
2021,Phoenix Suns,Baylor,Ish Wainright,195.58,113.398,PF,45,359,41,104,0.394,19,59,0.322,7,12,0.583,27,27,54,15,20,6,13,49,108,63,40,5,-44,-63,2,28.05,-105,-76.95,0.3942307692307692,0.3220338983050847,0.5833333333333334
2021,Portland Trail Blazers,Providence,Kris Dunn,190.5,92.98636,PG,14,336,44,102,0.431,1,11,0.091,17,18,0.944,9,40,49,79,23,3,32,38,106,58,10,1,-28,-27,16,29.35,-39,-9.649999999999999,0.43137254901960786,0.09090909090909091,0.9444444444444444
2021,Brooklyn Nets,Providence,David Duke Jr.,193.04,92.532768,PG,22,341,39,108,0.361,9,37,0.243,17,21,0.81,30,37,67,17,14,7,9,36,104,69,28,4,-60,-57,13,32.7,-104,-71.3,0.3611111111111111,0.24324324324324326,0.8095238095238095
2021,Oklahoma City Thunder,Wake Forest,Jaylen Hoard,203.2,97.975872,SF,7,240,44,90,0.489,9,25,0.36,6,14,0.429,30,54,84,17,6,5,8,14,103,46,16,8,-4,-21,-2,33.55,-27,6.549999999999997,0.4888888888888889,0.36,0.42857142857142855
2021,Indiana Pacers,Virginia,Justin Anderson,195.58,104.779752,SF,16,316,36,95,0.379,15,59,0.254,15,19,0.789,4,42,46,33,8,6,8,22,102,59,44,4,-46,-87,11,22.65,-122,-99.35,0.37894736842105264,0.2542372881355932,0.7894736842105263
2021,Indiana Pacers,Virginia,Justin Anderson,195.58,104.779752,SF,16,316,36,95,0.379,15,59,0.254,15,19,0.789,4,42,46,33,8,6,8,22,102,59,44,4,-46,-87,11,22.65,-122,-99.35,0.37894736842105264,0.2542372881355932,0.7894736842105263
2021,Indiana Pacers,Virginia,Justin Anderson,195.58,104.779752,SF,16,316,36,95,0.379,15,59,0.254,15,19,0.789,4,42,46,33,8,6,8,22,102,59,44,4,-46,-87,11,22.65,-122,-99.35,0.37894736842105264,0.2542372881355932,0.7894736842105263
2021,Indiana Pacers,Virginia,Justin Anderson,195.58,104.779752,SF,16,316,36,95,0.379,15,59,0.254,15,19,0.789,4,42,46,33,8,6,8,22,102,59,44,4,-46,-87,11,22.65,-122,-99.35,0.37894736842105264,0.2542372881355932,0.7894736842105263
2021,Indiana Pacers,Virginia,Justin Anderson,195.58,104.779752,SF,16,316,36,95,0.379,15,59,0.254,15,19,0.789,4,42,46,33,8,6,8,22,102,59,44,4,-46,-87,11,22.65,-122,-99.35,0.37894736842105264,0.2542372881355932,0.7894736842105263
2021,Indiana Pacers,Virginia,Justin Anderson,195.58,104.779752,SF,16,316,36,95,0.379,15,59,0.254,15,19,0.789,4,42,46,33,8,6,8,22,102,59,44,4,-46,-87,11,22.65,-122,-99.35,0.37894736842105264,0.2542372881355932,0.7894736842105263
2021,Indiana Pacers,Virginia,Justin Anderson,195.58,104.779752,SF,16,316,36,95,0.379,15,59,0.254,15,19,0.789,4,42,46,33,8,6,8,22,102,59,44,4,-46,-87,11,22.65,-122,-99.35,0.37894736842105264,0.2542372881355932,0.7894736842105263
2021,Indiana Pacers,Virginia,Justin Anderson,195.58,104.779752,SF,16,316,36,95,0.379,15,59,0.254,15,19,0.789,4,42,46,33,8,6,8,22,102,59,44,4,-46,-87,11,22.65,-122,-99.35,0.37894736842105264,0.2542372881355932,0.7894736842105263
2021,Indiana Pacers,Virginia,Justin Anderson,195.58,104.779752,SF,16,316,36,95,0.379,15,59,0.254,15,19,0.789,4,42,46,33,8,6,8,22,102,59,44,4,-46,-87,11,22.65,-122,-99.35,0.37894736842105264,0.2542372881355932,0.7894736842105263
2021,New Orleans Pelicans,Cincinnati,Gary Clark,198.12,102.0582,PF,38,378,33,88,0.375,28,70,0.4,7,10,0.7,23,67,90,18,13,7,10,20,101,55,42,3,-44,-42,4,36.75,-82,-45.25,0.375,0.4,0.7
2021,Miami Heat,Indiana,Victor Oladipo,193.04,96.615096,SG,8,173,35,73,0.479,15,36,0.417,14,19,0.737,3,20,23,28,5,1,16,13,99,38,21,5,-6,-18,9,7.85,-15,-7.15,0.4794520547945205,0.4166666666666667,0.7368421052631579
2021,Los Angeles Clippers,Southern Methodist,Semi Ojeleye,198.12,108.86208,PF,30,406,30,99,0.303,15,50,0.3,23,29,0.793,27,47,74,9,7,6,9,30,98,69,35,6,-78,-60,17,28.0,-121,-93.0,0.30303030303030304,0.3,0.7931034482758621
2021,Los Angeles Clippers,Southern Methodist,Semi Ojeleye,198.12,108.86208,PF,30,406,30,99,0.303,15,50,0.3,23,29,0.793,27,47,74,9,7,6,9,30,98,69,35,6,-78,-60,17,28.0,-121,-93.0,0.30303030303030304,0.3,0.7931034482758621
2021,Los Angeles Clippers,Southern Methodist,Semi Ojeleye,198.12,108.86208,PF,30,406,30,99,0.303,15,50,0.3,23,29,0.793,27,47,74,9,7,6,9,30,98,69,35,6,-78,-60,17,28.0,-121,-93.0,0.30303030303030304,0.3,0.7931034482758621
2021,Los Angeles Clippers,Southern Methodist,Semi Ojeleye,198.12,108.86208,PF,30,406,30,99,0.303,15,50,0.3,23,29,0.793,27,47,74,9,7,6,9,30,98,69,35,6,-78,-60,17,28.0,-121,-93.0,0.30303030303030304,0.3,0.7931034482758621
2021,Los Angeles Clippers,Southern Methodist,Semi Ojeleye,198.12,108.86208,PF,30,406,30,99,0.303,15,50,0.3,23,29,0.793,27,47,74,9,7,6,9,30,98,69,35,6,-78,-60,17,28.0,-121,-93.0,0.30303030303030304,0.3,0.7931034482758621
2021,Los Angeles Clippers,Southern Methodist,Semi Ojeleye,198.12,108.86208,PF,30,406,30,99,0.303,15,50,0.3,23,29,0.793,27,47,74,9,7,6,9,30,98,69,35,6,-78,-60,17,28.0,-121,-93.0,0.30303030303030304,0.3,0.7931034482758621
2021,Los Angeles Clippers,Southern Methodist,Semi Ojeleye,198.12,108.86208,PF,30,406,30,99,0.303,15,50,0.3,23,29,0.793,27,47,74,9,7,6,9,30,98,69,35,6,-78,-60,17,28.0,-121,-93.0,0.30303030303030304,0.3,0.7931034482758621
2021,Los Angeles Clippers,Southern Methodist,Semi Ojeleye,198.12,108.86208,PF,30,406,30,99,0.303,15,50,0.3,23,29,0.793,27,47,74,9,7,6,9,30,98,69,35,6,-78,-60,17,28.0,-121,-93.0,0.30303030303030304,0.3,0.7931034482758621
2021,Los Angeles Clippers,Southern Methodist,Semi Ojeleye,198.12,108.86208,PF,30,406,30,99,0.303,15,50,0.3,23,29,0.793,27,47,74,9,7,6,9,30,98,69,35,6,-78,-60,17,28.0,-121,-93.0,0.30303030303030304,0.3,0.7931034482758621
2021,Los Angeles Lakers,UCLA,Trevor Ariza,203.2,97.52228,SF,24,462,33,99,0.333,20,74,0.27,10,18,0.556,10,72,82,27,13,6,11,20,96,66,54,8,-66,-102,2,32.75,-166,-133.25,0.3333333333333333,0.2702702702702703,0.5555555555555556
2021,Phoenix Suns,Wisconsin,Frank Kaminsky,213.36,108.86208,C,9,181,36,66,0.545,5,15,0.333,18,20,0.9,11,30,41,13,8,7,5,14,95,30,10,2,12,-15,16,20.55,13,33.55,0.5454545454545454,0.3333333333333333,0.9
2021,Portland Trail Blazers,Montana State,Keljin Blevins,193.04,90.7184,SF,31,349,34,111,0.306,21,72,0.292,6,11,0.545,16,29,45,19,13,1,17,29,95,77,51,5,-86,-90,1,17.05,-175,-157.95,0.3063063063063063,0.2916666666666667,0.5454545454545454
2021,Portland Trail Blazers,Mississippi State,Reggie Perry,203.2,113.398,PF,10,187,40,79,0.506,3,16,0.188,9,15,0.6,15,32,47,12,9,6,11,33,92,39,13,6,2,-30,3,18.85,-25,-6.149999999999999,0.5063291139240507,0.1875,0.6
2021,Portland Trail Blazers,Mississippi State,Reggie Perry,203.2,113.398,PF,10,187,40,79,0.506,3,16,0.188,9,15,0.6,15,32,47,12,9,6,11,33,92,39,13,6,2,-30,3,18.85,-25,-6.149999999999999,0.5063291139240507,0.1875,0.6
2021,Portland Trail Blazers,Mississippi State,Reggie Perry,203.2,113.398,PF,10,187,40,79,0.506,3,16,0.188,9,15,0.6,15,32,47,12,9,6,11,33,92,39,13,6,2,-30,3,18.85,-25,-6.149999999999999,0.5063291139240507,0.1875,0.6
2021,Portland Trail Blazers,Mississippi State,Reggie Perry,203.2,113.398,PF,10,187,40,79,0.506,3,16,0.188,9,15,0.6,15,32,47,12,9,6,11,33,92,39,13,6,2,-30,3,18.85,-25,-6.149999999999999,0.5063291139240507,0.1875,0.6
2021,Portland Trail Blazers,Mississippi State,Reggie Perry,203.2,113.398,PF,10,187,40,79,0.506,3,16,0.188,9,15,0.6,15,32,47,12,9,6,11,33,92,39,13,6,2,-30,3,18.85,-25,-6.149999999999999,0.5063291139240507,0.1875,0.6
2021,Portland Trail Blazers,Mississippi State,Reggie Perry,203.2,113.398,PF,10,187,40,79,0.506,3,16,0.188,9,15,0.6,15,32,47,12,9,6,11,33,92,39,13,6,2,-30,3,18.85,-25,-6.149999999999999,0.5063291139240507,0.1875,0.6
2021,Portland Trail Blazers,Mississippi State,Reggie Perry,203.2,113.398,PF,10,187,40,79,0.506,3,16,0.188,9,15,0.6,15,32,47,12,9,6,11,33,92,39,13,6,2,-30,3,18.85,-25,-6.149999999999999,0.5063291139240507,0.1875,0.6
2021,Portland Trail Blazers,Mississippi State,Reggie Perry,203.2,113.398,PF,10,187,40,79,0.506,3,16,0.188,9,15,0.6,15,32,47,12,9,6,11,33,92,39,13,6,2,-30,3,18.85,-25,-6.149999999999999,0.5063291139240507,0.1875,0.6
2021,Portland Trail Blazers,Mississippi State,Reggie Perry,203.2,113.398,PF,10,187,40,79,0.506,3,16,0.188,9,15,0.6,15,32,47,12,9,6,11,33,92,39,13,6,2,-30,3,18.85,-25,-6.149999999999999,0.5063291139240507,0.1875,0.6
2021,New York Knicks,Texas-Austin,Jericho Sims,205.74,113.398,PF,41,555,39,54,0.722,0,0,0.0,12,29,0.414,61,108,169,21,11,22,20,66,90,15,0,17,48,0,-5,65.95,43,108.95,0.7222222222222222,,0.41379310344827586
2021,Denver Nuggets,Missouri,Michael Porter Jr.,208.28,98.883056,SF,9,265,37,103,0.359,10,48,0.208,5,9,0.556,9,50,59,17,10,2,12,16,89,66,38,4,-58,-84,1,20.45,-141,-120.55,0.3592233009708738,0.20833333333333334,0.5555555555555556
2021,New York Knicks,West Virginia,Miles McBride,185.42,88.45044,PG,40,372,32,108,0.296,17,68,0.25,8,12,0.667,4,38,42,41,14,1,5,45,89,76,51,4,-88,-102,4,24.5,-186,-161.5,0.2962962962962963,0.25,0.6666666666666666
2021,Houston Rockets,Maryland,Bruno Fernando,205.74,108.86208,C,30,153,36,55,0.655,1,2,0.5,15,24,0.625,18,37,55,7,1,11,14,24,88,19,1,9,34,0,6,17.8,40,57.8,0.6545454545454545,0.5,0.625
2021,Houston Rockets,Maryland,Bruno Fernando,205.74,108.86208,C,30,153,36,55,0.655,1,2,0.5,15,24,0.625,18,37,55,7,1,11,14,24,88,19,1,9,34,0,6,17.8,40,57.8,0.6545454545454545,0.5,0.625
2021,Houston Rockets,Maryland,Bruno Fernando,205.74,108.86208,C,30,153,36,55,0.655,1,2,0.5,15,24,0.625,18,37,55,7,1,11,14,24,88,19,1,9,34,0,6,17.8,40,57.8,0.6545454545454545,0.5,0.625
2021,Houston Rockets,Maryland,Bruno Fernando,205.74,108.86208,C,30,153,36,55,0.655,1,2,0.5,15,24,0.625,18,37,55,7,1,11,14,24,88,19,1,9,34,0,6,17.8,40,57.8,0.6545454545454545,0.5,0.625
2021,Houston Rockets,Maryland,Bruno Fernando,205.74,108.86208,C,30,153,36,55,0.655,1,2,0.5,15,24,0.625,18,37,55,7,1,11,14,24,88,19,1,9,34,0,6,17.8,40,57.8,0.6545454545454545,0.5,0.625
2021,Houston Rockets,Maryland,Bruno Fernando,205.74,108.86208,C,30,153,36,55,0.655,1,2,0.5,15,24,0.625,18,37,55,7,1,11,14,24,88,19,1,9,34,0,6,17.8,40,57.8,0.6545454545454545,0.5,0.625
2021,Houston Rockets,Maryland,Bruno Fernando,205.74,108.86208,C,30,153,36,55,0.655,1,2,0.5,15,24,0.625,18,37,55,7,1,11,14,24,88,19,1,9,34,0,6,17.8,40,57.8,0.6545454545454545,0.5,0.625
2021,Houston Rockets,Maryland,Bruno Fernando,205.74,108.86208,C,30,153,36,55,0.655,1,2,0.5,15,24,0.625,18,37,55,7,1,11,14,24,88,19,1,9,34,0,6,17.8,40,57.8,0.6545454545454545,0.5,0.625
2021,Houston Rockets,Maryland,Bruno Fernando,205.74,108.86208,C,30,153,36,55,0.655,1,2,0.5,15,24,0.625,18,37,55,7,1,11,14,24,88,19,1,9,34,0,6,17.8,40,57.8,0.6545454545454545,0.5,0.625
2021,Oklahoma City Thunder,,Georgios Kalaitzakis,200.66,87.089664,SF,13,213,31,67,0.463,10,26,0.385,14,30,0.467,6,15,21,12,11,2,20,19,86,36,16,16,-10,-18,-2,5.3,-30,-24.7,0.4626865671641791,0.38461538461538464,0.4666666666666667
2021,Oklahoma City Thunder,,Georgios Kalaitzakis,200.66,87.089664,SF,13,213,31,67,0.463,10,26,0.385,14,30,0.467,6,15,21,12,11,2,20,19,86,36,16,16,-10,-18,-2,5.3,-30,-24.7,0.4626865671641791,0.38461538461538464,0.4666666666666667
2021,Oklahoma City Thunder,,Georgios Kalaitzakis,200.66,87.089664,SF,13,213,31,67,0.463,10,26,0.385,14,30,0.467,6,15,21,12,11,2,20,19,86,36,16,16,-10,-18,-2,5.3,-30,-24.7,0.4626865671641791,0.38461538461538464,0.4666666666666667
2021,Oklahoma City Thunder,,Georgios Kalaitzakis,200.66,87.089664,SF,13,213,31,67,0.463,10,26,0.385,14,30,0.467,6,15,21,12,11,2,20,19,86,36,16,16,-10,-18,-2,5.3,-30,-24.7,0.4626865671641791,0.38461538461538464,0.4666666666666667
2021,Oklahoma City Thunder,,Georgios Kalaitzakis,200.66,87.089664,SF,13,213,31,67,0.463,10,26,0.385,14,30,0.467,6,15,21,12,11,2,20,19,86,36,16,16,-10,-18,-2,5.3,-30,-24.7,0.4626865671641791,0.38461538461538464,0.4666666666666667
2021,Oklahoma City Thunder,,Georgios Kalaitzakis,200.66,87.089664,SF,13,213,31,67,0.463,10,26,0.385,14,30,0.467,6,15,21,12,11,2,20,19,86,36,16,16,-10,-18,-2,5.3,-30,-24.7,0.4626865671641791,0.38461538461538464,0.4666666666666667
2021,Oklahoma City Thunder,,Georgios Kalaitzakis,200.66,87.089664,SF,13,213,31,67,0.463,10,26,0.385,14,30,0.467,6,15,21,12,11,2,20,19,86,36,16,16,-10,-18,-2,5.3,-30,-24.7,0.4626865671641791,0.38461538461538464,0.4666666666666667
2021,Oklahoma City Thunder,,Georgios Kalaitzakis,200.66,87.089664,SF,13,213,31,67,0.463,10,26,0.385,14,30,0.467,6,15,21,12,11,2,20,19,86,36,16,16,-10,-18,-2,5.3,-30,-24.7,0.4626865671641791,0.38461538461538464,0.4666666666666667
2021,Oklahoma City Thunder,,Georgios Kalaitzakis,200.66,87.089664,SF,13,213,31,67,0.463,10,26,0.385,14,30,0.467,6,15,21,12,11,2,20,19,86,36,16,16,-10,-18,-2,5.3,-30,-24.7,0.4626865671641791,0.38461538461538464,0.4666666666666667
2021,New York Knicks,Kentucky,Nerlens Noel,210.82,99.79024,C,25,562,32,60,0.533,0,3,0.0,21,30,0.7,48,93,141,23,30,31,20,67,85,28,3,9,8,-9,12,70.15,11,81.15,0.5333333333333333,0.0,0.7
2021,Washington Wizards,Pittsburgh,Brad Wanamaker,190.5,95.25432,PG,23,320,28,77,0.364,4,17,0.235,23,25,0.92,6,33,39,55,7,6,23,45,83,49,13,2,-42,-27,21,17.75,-48,-30.25,0.36363636363636365,0.23529411764705882,0.92
2021,Washington Wizards,Pittsburgh,Brad Wanamaker,190.5,95.25432,PG,23,320,28,77,0.364,4,17,0.235,23,25,0.92,6,33,39,55,7,6,23,45,83,49,13,2,-42,-27,21,17.75,-48,-30.25,0.36363636363636365,0.23529411764705882,0.92
2021,Washington Wizards,Pittsburgh,Brad Wanamaker,190.5,95.25432,PG,23,320,28,77,0.364,4,17,0.235,23,25,0.92,6,33,39,55,7,6,23,45,83,49,13,2,-42,-27,21,17.75,-48,-30.25,0.36363636363636365,0.23529411764705882,0.92
2021,Washington Wizards,Pittsburgh,Brad Wanamaker,190.5,95.25432,PG,23,320,28,77,0.364,4,17,0.235,23,25,0.92,6,33,39,55,7,6,23,45,83,49,13,2,-42,-27,21,17.75,-48,-30.25,0.36363636363636365,0.23529411764705882,0.92
2021,Washington Wizards,Pittsburgh,Brad Wanamaker,190.5,95.25432,PG,23,320,28,77,0.364,4,17,0.235,23,25,0.92,6,33,39,55,7,6,23,45,83,49,13,2,-42,-27,21,17.75,-48,-30.25,0.36363636363636365,0.23529411764705882,0.92
2021,Washington Wizards,Pittsburgh,Brad Wanamaker,190.5,95.25432,PG,23,320,28,77,0.364,4,17,0.235,23,25,0.92,6,33,39,55,7,6,23,45,83,49,13,2,-42,-27,21,17.75,-48,-30.25,0.36363636363636365,0.23529411764705882,0.92
2021,Washington Wizards,Pittsburgh,Brad Wanamaker,190.5,95.25432,PG,23,320,28,77,0.364,4,17,0.235,23,25,0.92,6,33,39,55,7,6,23,45,83,49,13,2,-42,-27,21,17.75,-48,-30.25,0.36363636363636365,0.23529411764705882,0.92
2021,Washington Wizards,Pittsburgh,Brad Wanamaker,190.5,95.25432,PG,23,320,28,77,0.364,4,17,0.235,23,25,0.92,6,33,39,55,7,6,23,45,83,49,13,2,-42,-27,21,17.75,-48,-30.25,0.36363636363636365,0.23529411764705882,0.92
2021,Washington Wizards,Pittsburgh,Brad Wanamaker,190.5,95.25432,PG,23,320,28,77,0.364,4,17,0.235,23,25,0.92,6,33,39,55,7,6,23,45,83,49,13,2,-42,-27,21,17.75,-48,-30.25,0.36363636363636365,0.23529411764705882,0.92
2021,Minnesota Timberwolves,Maryland,Jake Layman,203.2,94.800728,SF,34,231,30,73,0.411,8,35,0.229,13,18,0.722,6,30,36,9,7,5,10,12,81,43,27,5,-26,-57,8,13.15,-75,-61.85,0.410958904109589,0.22857142857142856,0.7222222222222222
2021,Toronto Raptors,Pittsburgh,Justin Champagnie,198.12,93.439952,SF,36,281,31,67,0.463,10,28,0.357,9,9,1.0,37,35,72,11,8,4,8,32,81,36,18,0,-10,-24,9,30.4,-25,5.399999999999999,0.4626865671641791,0.35714285714285715,1.0
2021,Milwaukee Bucks,Iowa State,Lindell Wigginton,185.42,85.728888,PG,19,199,26,61,0.426,9,26,0.346,19,35,0.543,3,22,25,23,5,1,12,17,80,35,17,16,-18,-24,3,8.9,-39,-30.1,0.4262295081967213,0.34615384615384615,0.5428571428571428
2021,Atlanta Hawks,Louisiana State,Skylar Mays,193.04,92.98636,SG,28,220,32,64,0.5,8,25,0.32,8,9,0.889,5,20,25,17,7,0,10,9,80,32,17,1,0,-27,7,9.8,-20,-10.2,0.5,0.32,0.8888888888888888
2021,Utah Jazz,Kansas,Udoka Azubuike,213.36,122.46984,C,17,195,37,49,0.755,0,0,0.0,6,11,0.545,18,53,71,0,1,11,12,25,80,12,0,5,50,0,1,21.0,51,72.0,0.7551020408163265,,0.5454545454545454
2021,Detroit Pistons,Virginia,Braxton Key,203.2,102.0582,SF,11,197,33,72,0.458,6,21,0.286,7,13,0.538,13,37,50,11,10,11,11,26,79,39,15,6,-12,-27,1,22.2,-38,-15.8,0.4583333333333333,0.2857142857142857,0.5384615384615384
2021,Detroit Pistons,Virginia,Braxton Key,203.2,102.0582,SF,11,197,33,72,0.458,6,21,0.286,7,13,0.538,13,37,50,11,10,11,11,26,79,39,15,6,-12,-27,1,22.2,-38,-15.8,0.4583333333333333,0.2857142857142857,0.5384615384615384
2021,Detroit Pistons,Virginia,Braxton Key,203.2,102.0582,SF,11,197,33,72,0.458,6,21,0.286,7,13,0.538,13,37,50,11,10,11,11,26,79,39,15,6,-12,-27,1,22.2,-38,-15.8,0.4583333333333333,0.2857142857142857,0.5384615384615384
2021,Detroit Pistons,Virginia,Braxton Key,203.2,102.0582,SF,11,197,33,72,0.458,6,21,0.286,7,13,0.538,13,37,50,11,10,11,11,26,79,39,15,6,-12,-27,1,22.2,-38,-15.8,0.4583333333333333,0.2857142857142857,0.5384615384615384
2021,Detroit Pistons,Virginia,Braxton Key,203.2,102.0582,SF,11,197,33,72,0.458,6,21,0.286,7,13,0.538,13,37,50,11,10,11,11,26,79,39,15,6,-12,-27,1,22.2,-38,-15.8,0.4583333333333333,0.2857142857142857,0.5384615384615384
2021,Detroit Pistons,Virginia,Braxton Key,203.2,102.0582,SF,11,197,33,72,0.458,6,21,0.286,7,13,0.538,13,37,50,11,10,11,11,26,79,39,15,6,-12,-27,1,22.2,-38,-15.8,0.4583333333333333,0.2857142857142857,0.5384615384615384
2021,Detroit Pistons,Virginia,Braxton Key,203.2,102.0582,SF,11,197,33,72,0.458,6,21,0.286,7,13,0.538,13,37,50,11,10,11,11,26,79,39,15,6,-12,-27,1,22.2,-38,-15.8,0.4583333333333333,0.2857142857142857,0.5384615384615384
2021,Detroit Pistons,Virginia,Braxton Key,203.2,102.0582,SF,11,197,33,72,0.458,6,21,0.286,7,13,0.538,13,37,50,11,10,11,11,26,79,39,15,6,-12,-27,1,22.2,-38,-15.8,0.4583333333333333,0.2857142857142857,0.5384615384615384
2021,Detroit Pistons,Virginia,Braxton Key,203.2,102.0582,SF,11,197,33,72,0.458,6,21,0.286,7,13,0.538,13,37,50,11,10,11,11,26,79,39,15,6,-12,-27,1,22.2,-38,-15.8,0.4583333333333333,0.2857142857142857,0.5384615384615384
2021,Detroit Pistons,Virginia Tech,Justin Robinson,185.42,88.45044,PG,25,304,28,93,0.301,18,61,0.295,4,8,0.5,4,17,21,32,9,1,17,27,78,65,43,4,-74,-75,0,9.4,-149,-139.6,0.3010752688172043,0.29508196721311475,0.5
2021,Detroit Pistons,Virginia Tech,Justin Robinson,185.42,88.45044,PG,25,304,28,93,0.301,18,61,0.295,4,8,0.5,4,17,21,32,9,1,17,27,78,65,43,4,-74,-75,0,9.4,-149,-139.6,0.3010752688172043,0.29508196721311475,0.5
2021,Detroit Pistons,Virginia Tech,Justin Robinson,185.42,88.45044,PG,25,304,28,93,0.301,18,61,0.295,4,8,0.5,4,17,21,32,9,1,17,27,78,65,43,4,-74,-75,0,9.4,-149,-139.6,0.3010752688172043,0.29508196721311475,0.5
2021,Detroit Pistons,Virginia Tech,Justin Robinson,185.42,88.45044,PG,25,304,28,93,0.301,18,61,0.295,4,8,0.5,4,17,21,32,9,1,17,27,78,65,43,4,-74,-75,0,9.4,-149,-139.6,0.3010752688172043,0.29508196721311475,0.5
2021,Detroit Pistons,Virginia Tech,Justin Robinson,185.42,88.45044,PG,25,304,28,93,0.301,18,61,0.295,4,8,0.5,4,17,21,32,9,1,17,27,78,65,43,4,-74,-75,0,9.4,-149,-139.6,0.3010752688172043,0.29508196721311475,0.5
2021,Detroit Pistons,Virginia Tech,Justin Robinson,185.42,88.45044,PG,25,304,28,93,0.301,18,61,0.295,4,8,0.5,4,17,21,32,9,1,17,27,78,65,43,4,-74,-75,0,9.4,-149,-139.6,0.3010752688172043,0.29508196721311475,0.5
2021,Detroit Pistons,Virginia Tech,Justin Robinson,185.42,88.45044,PG,25,304,28,93,0.301,18,61,0.295,4,8,0.5,4,17,21,32,9,1,17,27,78,65,43,4,-74,-75,0,9.4,-149,-139.6,0.3010752688172043,0.29508196721311475,0.5
2021,Detroit Pistons,Virginia Tech,Justin Robinson,185.42,88.45044,PG,25,304,28,93,0.301,18,61,0.295,4,8,0.5,4,17,21,32,9,1,17,27,78,65,43,4,-74,-75,0,9.4,-149,-139.6,0.3010752688172043,0.29508196721311475,0.5
2021,Detroit Pistons,Virginia Tech,Justin Robinson,185.42,88.45044,PG,25,304,28,93,0.301,18,61,0.295,4,8,0.5,4,17,21,32,9,1,17,27,78,65,43,4,-74,-75,0,9.4,-149,-139.6,0.3010752688172043,0.29508196721311475,0.5
2021,Detroit Pistons,Virginia Tech,Justin Robinson,185.42,88.45044,PG,25,304,28,93,0.301,18,61,0.295,4,8,0.5,4,17,21,32,9,1,17,27,78,65,43,4,-74,-75,0,9.4,-149,-139.6,0.3010752688172043,0.29508196721311475,0.5
2021,Detroit Pistons,Virginia Tech,Justin Robinson,185.42,88.45044,PG,25,304,28,93,0.301,18,61,0.295,4,8,0.5,4,17,21,32,9,1,17,27,78,65,43,4,-74,-75,0,9.4,-149,-139.6,0.3010752688172043,0.29508196721311475,0.5
2021,Detroit Pistons,Virginia Tech,Justin Robinson,185.42,88.45044,PG,25,304,28,93,0.301,18,61,0.295,4,8,0.5,4,17,21,32,9,1,17,27,78,65,43,4,-74,-75,0,9.4,-149,-139.6,0.3010752688172043,0.29508196721311475,0.5
2021,Detroit Pistons,Virginia Tech,Justin Robinson,185.42,88.45044,PG,25,304,28,93,0.301,18,61,0.295,4,8,0.5,4,17,21,32,9,1,17,27,78,65,43,4,-74,-75,0,9.4,-149,-139.6,0.3010752688172043,0.29508196721311475,0.5
2021,Detroit Pistons,Virginia Tech,Justin Robinson,185.42,88.45044,PG,25,304,28,93,0.301,18,61,0.295,4,8,0.5,4,17,21,32,9,1,17,27,78,65,43,4,-74,-75,0,9.4,-149,-139.6,0.3010752688172043,0.29508196721311475,0.5
2021,Detroit Pistons,Virginia Tech,Justin Robinson,185.42,88.45044,PG,25,304,28,93,0.301,18,61,0.295,4,8,0.5,4,17,21,32,9,1,17,27,78,65,43,4,-74,-75,0,9.4,-149,-139.6,0.3010752688172043,0.29508196721311475,0.5
2021,Detroit Pistons,Virginia Tech,Justin Robinson,185.42,88.45044,PG,25,304,28,93,0.301,18,61,0.295,4,8,0.5,4,17,21,32,9,1,17,27,78,65,43,4,-74,-75,0,9.4,-149,-139.6,0.3010752688172043,0.29508196721311475,0.5
2021,Houston Rockets,,Daishen Nix,193.04,102.511792,SG,24,261,27,67,0.403,7,26,0.269,16,30,0.533,7,26,33,40,15,0,26,21,77,40,19,14,-26,-36,2,13.45,-60,-46.55,0.40298507462686567,0.2692307692307692,0.5333333333333333
2021,Miami Heat,Stanford,KZ Okpala,203.2,97.52228,PF,21,244,30,69,0.435,9,26,0.346,8,11,0.727,11,30,41,14,4,7,5,25,77,39,17,3,-18,-24,5,18.25,-37,-18.75,0.43478260869565216,0.34615384615384615,0.7272727272727273
2021,Minnesota Timberwolves,Georgetown,Greg Monroe,208.28,113.398,C,14,195,32,57,0.561,0,0,0.0,12,23,0.522,30,34,64,22,8,10,12,24,76,25,0,11,14,0,1,30.8,15,45.8,0.5614035087719298,,0.5217391304347826
2021,Minnesota Timberwolves,Georgetown,Greg Monroe,208.28,113.398,C,14,195,32,57,0.561,0,0,0.0,12,23,0.522,30,34,64,22,8,10,12,24,76,25,0,11,14,0,1,30.8,15,45.8,0.5614035087719298,,0.5217391304347826
2021,Minnesota Timberwolves,Georgetown,Greg Monroe,208.28,113.398,C,14,195,32,57,0.561,0,0,0.0,12,23,0.522,30,34,64,22,8,10,12,24,76,25,0,11,14,0,1,30.8,15,45.8,0.5614035087719298,,0.5217391304347826
2021,Minnesota Timberwolves,Georgetown,Greg Monroe,208.28,113.398,C,14,195,32,57,0.561,0,0,0.0,12,23,0.522,30,34,64,22,8,10,12,24,76,25,0,11,14,0,1,30.8,15,45.8,0.5614035087719298,,0.5217391304347826
2021,Minnesota Timberwolves,Georgetown,Greg Monroe,208.28,113.398,C,14,195,32,57,0.561,0,0,0.0,12,23,0.522,30,34,64,22,8,10,12,24,76,25,0,11,14,0,1,30.8,15,45.8,0.5614035087719298,,0.5217391304347826
2021,Minnesota Timberwolves,Georgetown,Greg Monroe,208.28,113.398,C,14,195,32,57,0.561,0,0,0.0,12,23,0.522,30,34,64,22,8,10,12,24,76,25,0,11,14,0,1,30.8,15,45.8,0.5614035087719298,,0.5217391304347826
2021,Minnesota Timberwolves,Georgetown,Greg Monroe,208.28,113.398,C,14,195,32,57,0.561,0,0,0.0,12,23,0.522,30,34,64,22,8,10,12,24,76,25,0,11,14,0,1,30.8,15,45.8,0.5614035087719298,,0.5217391304347826
2021,Minnesota Timberwolves,Georgetown,Greg Monroe,208.28,113.398,C,14,195,32,57,0.561,0,0,0.0,12,23,0.522,30,34,64,22,8,10,12,24,76,25,0,11,14,0,1,30.8,15,45.8,0.5614035087719298,,0.5217391304347826
2021,Minnesota Timberwolves,Georgetown,Greg Monroe,208.28,113.398,C,14,195,32,57,0.561,0,0,0.0,12,23,0.522,30,34,64,22,8,10,12,24,76,25,0,11,14,0,1,30.8,15,45.8,0.5614035087719298,,0.5217391304347826
2021,Minnesota Timberwolves,Georgetown,Greg Monroe,208.28,113.398,C,14,195,32,57,0.561,0,0,0.0,12,23,0.522,30,34,64,22,8,10,12,24,76,25,0,11,14,0,1,30.8,15,45.8,0.5614035087719298,,0.5217391304347826
2021,Minnesota Timberwolves,Georgetown,Greg Monroe,208.28,113.398,C,14,195,32,57,0.561,0,0,0.0,12,23,0.522,30,34,64,22,8,10,12,24,76,25,0,11,14,0,1,30.8,15,45.8,0.5614035087719298,,0.5217391304347826
2021,Minnesota Timberwolves,Georgetown,Greg Monroe,208.28,113.398,C,14,195,32,57,0.561,0,0,0.0,12,23,0.522,30,34,64,22,8,10,12,24,76,25,0,11,14,0,1,30.8,15,45.8,0.5614035087719298,,0.5217391304347826
2021,Minnesota Timberwolves,Georgetown,Greg Monroe,208.28,113.398,C,14,195,32,57,0.561,0,0,0.0,12,23,0.522,30,34,64,22,8,10,12,24,76,25,0,11,14,0,1,30.8,15,45.8,0.5614035087719298,,0.5217391304347826
2021,Minnesota Timberwolves,Georgetown,Greg Monroe,208.28,113.398,C,14,195,32,57,0.561,0,0,0.0,12,23,0.522,30,34,64,22,8,10,12,24,76,25,0,11,14,0,1,30.8,15,45.8,0.5614035087719298,,0.5217391304347826
2021,Minnesota Timberwolves,Georgetown,Greg Monroe,208.28,113.398,C,14,195,32,57,0.561,0,0,0.0,12,23,0.522,30,34,64,22,8,10,12,24,76,25,0,11,14,0,1,30.8,15,45.8,0.5614035087719298,,0.5217391304347826
2021,Minnesota Timberwolves,Georgetown,Greg Monroe,208.28,113.398,C,14,195,32,57,0.561,0,0,0.0,12,23,0.522,30,34,64,22,8,10,12,24,76,25,0,11,14,0,1,30.8,15,45.8,0.5614035087719298,,0.5217391304347826
2021,Minnesota Timberwolves,Georgetown,Greg Monroe,208.28,113.398,C,14,195,32,57,0.561,0,0,0.0,12,23,0.522,30,34,64,22,8,10,12,24,76,25,0,11,14,0,1,30.8,15,45.8,0.5614035087719298,,0.5217391304347826
2021,Minnesota Timberwolves,Georgetown,Greg Monroe,208.28,113.398,C,14,195,32,57,0.561,0,0,0.0,12,23,0.522,30,34,64,22,8,10,12,24,76,25,0,11,14,0,1,30.8,15,45.8,0.5614035087719298,,0.5217391304347826
2021,Minnesota Timberwolves,Georgetown,Greg Monroe,208.28,113.398,C,14,195,32,57,0.561,0,0,0.0,12,23,0.522,30,34,64,22,8,10,12,24,76,25,0,11,14,0,1,30.8,15,45.8,0.5614035087719298,,0.5217391304347826
2021,Minnesota Timberwolves,Georgetown,Greg Monroe,208.28,113.398,C,14,195,32,57,0.561,0,0,0.0,12,23,0.522,30,34,64,22,8,10,12,24,76,25,0,11,14,0,1,30.8,15,45.8,0.5614035087719298,,0.5217391304347826
2021,Minnesota Timberwolves,Georgetown,Greg Monroe,208.28,113.398,C,14,195,32,57,0.561,0,0,0.0,12,23,0.522,30,34,64,22,8,10,12,24,76,25,0,11,14,0,1,30.8,15,45.8,0.5614035087719298,,0.5217391304347826
2021,Minnesota Timberwolves,Georgetown,Greg Monroe,208.28,113.398,C,14,195,32,57,0.561,0,0,0.0,12,23,0.522,30,34,64,22,8,10,12,24,76,25,0,11,14,0,1,30.8,15,45.8,0.5614035087719298,,0.5217391304347826
2021,Minnesota Timberwolves,Georgetown,Greg Monroe,208.28,113.398,C,14,195,32,57,0.561,0,0,0.0,12,23,0.522,30,34,64,22,8,10,12,24,76,25,0,11,14,0,1,30.8,15,45.8,0.5614035087719298,,0.5217391304347826
2021,Minnesota Timberwolves,Georgetown,Greg Monroe,208.28,113.398,C,14,195,32,57,0.561,0,0,0.0,12,23,0.522,30,34,64,22,8,10,12,24,76,25,0,11,14,0,1,30.8,15,45.8,0.5614035087719298,,0.5217391304347826
2021,Minnesota Timberwolves,Georgetown,Greg Monroe,208.28,113.398,C,14,195,32,57,0.561,0,0,0.0,12,23,0.522,30,34,64,22,8,10,12,24,76,25,0,11,14,0,1,30.8,15,45.8,0.5614035087719298,,0.5217391304347826
2021,Miami Heat,Virginia,Kyle Guy,185.42,75.749864,SG,19,186,26,65,0.4,14,40,0.35,8,12,0.667,4,13,17,17,7,1,13,12,74,39,26,4,-26,-36,4,6.4,-58,-51.6,0.4,0.35,0.6666666666666666
2021,Chicago Bulls,Illinois,Malcolm Hill,198.12,99.79024,SF,19,212,24,52,0.462,13,36,0.361,11,14,0.786,11,24,35,8,7,3,3,24,72,28,23,3,-8,-30,8,15.8,-30,-14.2,0.46153846153846156,0.3611111111111111,0.7857142857142857
2021,Chicago Bulls,Illinois,Malcolm Hill,198.12,99.79024,SF,19,212,24,52,0.462,13,36,0.361,11,14,0.786,11,24,35,8,7,3,3,24,72,28,23,3,-8,-30,8,15.8,-30,-14.2,0.46153846153846156,0.3611111111111111,0.7857142857142857
2021,Chicago Bulls,Illinois,Malcolm Hill,198.12,99.79024,SF,19,212,24,52,0.462,13,36,0.361,11,14,0.786,11,24,35,8,7,3,3,24,72,28,23,3,-8,-30,8,15.8,-30,-14.2,0.46153846153846156,0.3611111111111111,0.7857142857142857
2021,Chicago Bulls,Illinois,Malcolm Hill,198.12,99.79024,SG,19,212,24,52,0.462,13,36,0.361,11,14,0.786,11,24,35,8,7,3,3,24,72,28,23,3,-8,-30,8,15.8,-30,-14.2,0.46153846153846156,0.3611111111111111,0.7857142857142857
2021,Chicago Bulls,Illinois,Malcolm Hill,198.12,99.79024,SG,19,212,24,52,0.462,13,36,0.361,11,14,0.786,11,24,35,8,7,3,3,24,72,28,23,3,-8,-30,8,15.8,-30,-14.2,0.46153846153846156,0.3611111111111111,0.7857142857142857
2021,Chicago Bulls,Illinois,Malcolm Hill,198.12,99.79024,SG,19,212,24,52,0.462,13,36,0.361,11,14,0.786,11,24,35,8,7,3,3,24,72,28,23,3,-8,-30,8,15.8,-30,-14.2,0.46153846153846156,0.3611111111111111,0.7857142857142857
2021,Chicago Bulls,Illinois,Malcolm Hill,198.12,99.79024,SF,19,212,24,52,0.462,13,36,0.361,11,14,0.786,11,24,35,8,7,3,3,24,72,28,23,3,-8,-30,8,15.8,-30,-14.2,0.46153846153846156,0.3611111111111111,0.7857142857142857
2021,Chicago Bulls,Illinois,Malcolm Hill,198.12,99.79024,SF,19,212,24,52,0.462,13,36,0.361,11,14,0.786,11,24,35,8,7,3,3,24,72,28,23,3,-8,-30,8,15.8,-30,-14.2,0.46153846153846156,0.3611111111111111,0.7857142857142857
2021,Chicago Bulls,Illinois,Malcolm Hill,198.12,99.79024,SF,19,212,24,52,0.462,13,36,0.361,11,14,0.786,11,24,35,8,7,3,3,24,72,28,23,3,-8,-30,8,15.8,-30,-14.2,0.46153846153846156,0.3611111111111111,0.7857142857142857
2021,Philadelphia 76ers,Western Kentucky,Charles Bassey,205.74,104.32616,C,23,168,30,47,0.638,0,4,0.0,9,12,0.75,22,40,62,7,5,17,8,32,69,17,4,3,26,-12,6,28.15,20,48.15,0.6382978723404256,0.0,0.75
2021,Utah Jazz,Michigan State,Denzel Valentine,193.04,99.79024,SG,24,222,25,66,0.379,19,47,0.404,0,0,0.0,9,33,42,11,8,0,12,20,69,41,28,0,-32,-27,0,12.5,-59,-46.5,0.3787878787878788,0.40425531914893614,
2021,Utah Jazz,Michigan State,Denzel Valentine,193.04,99.79024,SG,24,222,25,66,0.379,19,47,0.404,0,0,0.0,9,33,42,11,8,0,12,20,69,41,28,0,-32,-27,0,12.5,-59,-46.5,0.3787878787878788,0.40425531914893614,
2021,Utah Jazz,Michigan State,Denzel Valentine,193.04,99.79024,SG,24,222,25,66,0.379,19,47,0.404,0,0,0.0,9,33,42,11,8,0,12,20,69,41,28,0,-32,-27,0,12.5,-59,-46.5,0.3787878787878788,0.40425531914893614,
2021,Utah Jazz,Michigan State,Denzel Valentine,193.04,99.79024,SG,24,222,25,66,0.379,19,47,0.404,0,0,0.0,9,33,42,11,8,0,12,20,69,41,28,0,-32,-27,0,12.5,-59,-46.5,0.3787878787878788,0.40425531914893614,
2021,Utah Jazz,Michigan State,Denzel Valentine,193.04,99.79024,SG,24,222,25,66,0.379,19,47,0.404,0,0,0.0,9,33,42,11,8,0,12,20,69,41,28,0,-32,-27,0,12.5,-59,-46.5,0.3787878787878788,0.40425531914893614,
2021,Utah Jazz,Michigan State,Denzel Valentine,193.04,99.79024,SG,24,222,25,66,0.379,19,47,0.404,0,0,0.0,9,33,42,11,8,0,12,20,69,41,28,0,-32,-27,0,12.5,-59,-46.5,0.3787878787878788,0.40425531914893614,
2021,Utah Jazz,Michigan State,Denzel Valentine,193.04,99.79024,SG,24,222,25,66,0.379,19,47,0.404,0,0,0.0,9,33,42,11,8,0,12,20,69,41,28,0,-32,-27,0,12.5,-59,-46.5,0.3787878787878788,0.40425531914893614,
2021,Utah Jazz,Michigan State,Denzel Valentine,193.04,99.79024,SG,24,222,25,66,0.379,19,47,0.404,0,0,0.0,9,33,42,11,8,0,12,20,69,41,28,0,-32,-27,0,12.5,-59,-46.5,0.3787878787878788,0.40425531914893614,
2021,Utah Jazz,Michigan State,Denzel Valentine,193.04,99.79024,SG,24,222,25,66,0.379,19,47,0.404,0,0,0.0,9,33,42,11,8,0,12,20,69,41,28,0,-32,-27,0,12.5,-59,-46.5,0.3787878787878788,0.40425531914893614,
2021,Miami Heat,Kentucky,Mychal Mulder,190.5,88.45044,PG,17,240,24,77,0.312,17,54,0.315,4,4,1.0,2,22,24,5,4,2,8,13,69,53,37,0,-58,-60,4,6.1,-114,-107.9,0.3116883116883117,0.3148148148148148,1.0
2021,Miami Heat,Kentucky,Mychal Mulder,190.5,88.45044,PG,17,240,24,77,0.312,17,54,0.315,4,4,1.0,2,22,24,5,4,2,8,13,69,53,37,0,-58,-60,4,6.1,-114,-107.9,0.3116883116883117,0.3148148148148148,1.0
2021,Miami Heat,Kentucky,Mychal Mulder,190.5,88.45044,PG,17,240,24,77,0.312,17,54,0.315,4,4,1.0,2,22,24,5,4,2,8,13,69,53,37,0,-58,-60,4,6.1,-114,-107.9,0.3116883116883117,0.3148148148148148,1.0
2021,Miami Heat,Kentucky,Mychal Mulder,190.5,88.45044,PG,17,240,24,77,0.312,17,54,0.315,4,4,1.0,2,22,24,5,4,2,8,13,69,53,37,0,-58,-60,4,6.1,-114,-107.9,0.3116883116883117,0.3148148148148148,1.0
2021,Miami Heat,Kentucky,Mychal Mulder,190.5,88.45044,PG,17,240,24,77,0.312,17,54,0.315,4,4,1.0,2,22,24,5,4,2,8,13,69,53,37,0,-58,-60,4,6.1,-114,-107.9,0.3116883116883117,0.3148148148148148,1.0
2021,Miami Heat,Kentucky,Mychal Mulder,190.5,88.45044,PG,17,240,24,77,0.312,17,54,0.315,4,4,1.0,2,22,24,5,4,2,8,13,69,53,37,0,-58,-60,4,6.1,-114,-107.9,0.3116883116883117,0.3148148148148148,1.0
2021,Miami Heat,Kentucky,Mychal Mulder,190.5,88.45044,PG,17,240,24,77,0.312,17,54,0.315,4,4,1.0,2,22,24,5,4,2,8,13,69,53,37,0,-58,-60,4,6.1,-114,-107.9,0.3116883116883117,0.3148148148148148,1.0
2021,Miami Heat,Kentucky,Mychal Mulder,190.5,88.45044,PG,17,240,24,77,0.312,17,54,0.315,4,4,1.0,2,22,24,5,4,2,8,13,69,53,37,0,-58,-60,4,6.1,-114,-107.9,0.3116883116883117,0.3148148148148148,1.0
2021,Miami Heat,Kentucky,Mychal Mulder,190.5,88.45044,PG,17,240,24,77,0.312,17,54,0.315,4,4,1.0,2,22,24,5,4,2,8,13,69,53,37,0,-58,-60,4,6.1,-114,-107.9,0.3116883116883117,0.3148148148148148,1.0
2021,Golden State Warriors,Florida,Chris Chiozza,180.34,79.3786,PG,34,372,24,81,0.296,17,53,0.321,2,3,0.667,9,27,36,65,13,0,32,32,67,57,36,1,-66,-57,1,16.4,-122,-105.6,0.2962962962962963,0.32075471698113206,0.6666666666666666
2021,Charlotte Hornets,Auburn,JT Thor,205.74,92.079176,PF,33,262,24,55,0.436,7,27,0.259,12,20,0.6,11,32,43,19,8,11,10,26,67,31,20,8,-14,-39,4,21.45,-49,-27.55,0.43636363636363634,0.25925925925925924,0.6
2021,Chicago Bulls,Iowa,Tyler Cook,203.2,115.66596,PF,20,200,23,38,0.605,0,0,0.0,21,32,0.656,16,37,53,3,4,4,7,28,67,15,0,11,16,0,10,17.1,26,43.1,0.6052631578947368,,0.65625
2021,Boston Celtics,Virginia,Sam Hauser,200.66,98.429464,SF,26,158,23,50,0.46,19,44,0.432,0,0,0.0,5,24,29,10,1,2,2,7,65,27,25,0,-8,-18,0,11.15,-26,-14.85,0.46,0.4318181818181818,
2021,San Antonio Spurs,Iowa,Joe Wieskamp,198.12,92.98636,SG,29,205,20,56,0.357,14,43,0.326,7,13,0.538,4,10,14,9,4,3,2,14,61,36,29,6,-32,-45,1,8.55,-76,-67.45,0.35714285714285715,0.32558139534883723,0.5384615384615384
2021,Sacramento Kings,Texas Tech,Jahmi'us Ramsey,190.5,86.18248,SG,19,134,24,58,0.414,5,18,0.278,7,14,0.5,4,9,13,7,1,1,5,10,60,34,13,7,-20,-24,0,4.0,-44,-40.0,0.41379310344827586,0.2777777777777778,0.5
2021,Chicago Bulls,Wisc.-Green Bay,Alfonzo McKinnie,200.66,97.52228,SF,17,206,24,61,0.393,9,27,0.333,2,8,0.25,13,20,33,5,2,3,7,26,59,37,18,6,-26,-27,-4,10.45,-57,-46.55,0.39344262295081966,0.3333333333333333,0.25
2021,Los Angeles Clippers,Morehead State,Xavier Moon,187.96,74.84268,SG,10,137,25,51,0.49,5,14,0.357,3,5,0.6,2,12,14,24,7,3,6,9,58,26,9,2,-2,-12,1,11.55,-13,-1.4499999999999993,0.49019607843137253,0.35714285714285715,0.6
2021,Oklahoma City Thunder,Virginia,Mamadi Diakite,205.74,103.418976,PF,13,188,25,47,0.532,0,5,0.0,6,11,0.545,17,42,59,2,5,9,7,33,56,22,5,5,6,-15,1,21.35,-8,13.350000000000001,0.5319148936170213,0.0,0.5454545454545454
2021,Boston Celtics,Duke,Jabari Parker,200.66,111.13004,PF,12,112,18,38,0.474,8,16,0.5,9,9,1.0,5,23,28,6,4,1,8,13,53,20,8,0,-4,0,9,7.6,5,12.6,0.47368421052631576,0.5,1.0
2021,Detroit Pistons,Duke,Cassius Stanley,195.58,86.18248,SG,9,155,19,46,0.413,4,17,0.235,10,10,1.0,5,14,19,4,5,2,6,17,52,27,13,0,-16,-27,10,6.65,-33,-26.35,0.41304347826086957,0.23529411764705882,1.0
2021,Atlanta Hawks,Duke,Jalen Johnson,203.2,99.336648,PF,22,120,22,41,0.537,3,13,0.231,5,7,0.714,2,24,26,3,3,2,9,9,52,19,10,2,6,-21,3,5.3,-12,-6.7,0.5365853658536586,0.23076923076923078,0.7142857142857143
2021,Miami Heat,Louisiana State,Javonte Smart,193.04,92.98636,PG,17,200,19,60,0.317,8,27,0.296,5,6,0.833,5,19,24,16,6,3,11,12,51,41,19,1,-44,-33,4,9.65,-73,-63.35,0.31666666666666665,0.2962962962962963,0.8333333333333334
2021,Miami Heat,Louisiana State,Javonte Smart,193.04,92.98636,PG,17,200,19,60,0.317,8,27,0.296,5,6,0.833,5,19,24,16,6,3,11,12,51,41,19,1,-44,-33,4,9.65,-73,-63.35,0.31666666666666665,0.2962962962962963,0.8333333333333334
2021,Miami Heat,Louisiana State,Javonte Smart,193.04,92.98636,PG,17,200,19,60,0.317,8,27,0.296,5,6,0.833,5,19,24,16,6,3,11,12,51,41,19,1,-44,-33,4,9.65,-73,-63.35,0.31666666666666665,0.2962962962962963,0.8333333333333334
2021,Miami Heat,Louisiana State,Javonte Smart,193.04,92.98636,PG,17,200,19,60,0.317,8,27,0.296,5,6,0.833,5,19,24,16,6,3,11,12,51,41,19,1,-44,-33,4,9.65,-73,-63.35,0.31666666666666665,0.2962962962962963,0.8333333333333334
2021,Miami Heat,Louisiana State,Javonte Smart,193.04,92.98636,PG,17,200,19,60,0.317,8,27,0.296,5,6,0.833,5,19,24,16,6,3,11,12,51,41,19,1,-44,-33,4,9.65,-73,-63.35,0.31666666666666665,0.2962962962962963,0.8333333333333334
2021,Miami Heat,Louisiana State,Javonte Smart,193.04,92.98636,PG,17,200,19,60,0.317,8,27,0.296,5,6,0.833,5,19,24,16,6,3,11,12,51,41,19,1,-44,-33,4,9.65,-73,-63.35,0.31666666666666665,0.2962962962962963,0.8333333333333334
2021,Miami Heat,Louisiana State,Javonte Smart,193.04,92.98636,PG,17,200,19,60,0.317,8,27,0.296,5,6,0.833,5,19,24,16,6,3,11,12,51,41,19,1,-44,-33,4,9.65,-73,-63.35,0.31666666666666665,0.2962962962962963,0.8333333333333334
2021,Miami Heat,Louisiana State,Javonte Smart,193.04,92.98636,PG,17,200,19,60,0.317,8,27,0.296,5,6,0.833,5,19,24,16,6,3,11,12,51,41,19,1,-44,-33,4,9.65,-73,-63.35,0.31666666666666665,0.2962962962962963,0.8333333333333334
2021,Miami Heat,Louisiana State,Javonte Smart,193.04,92.98636,PG,17,200,19,60,0.317,8,27,0.296,5,6,0.833,5,19,24,16,6,3,11,12,51,41,19,1,-44,-33,4,9.65,-73,-63.35,0.31666666666666665,0.2962962962962963,0.8333333333333334
2021,Orlando Magic,Princeton,Devin Cannady,187.96,83.007336,PG,5,145,15,44,0.341,15,37,0.405,5,7,0.714,1,5,6,10,5,3,5,9,50,29,22,2,-28,-21,3,5.3,-46,-40.7,0.3409090909090909,0.40540540540540543,0.7142857142857143
2021,Orlando Magic,South Carolina,Hassani Gravett,187.96,84.821704,PG,8,171,18,38,0.474,11,26,0.423,3,4,0.75,1,20,21,20,5,1,9,13,50,20,15,1,-4,-12,2,8.35,-14,-5.65,0.47368421052631576,0.4230769230769231,0.75
2021,Detroit Pistons,Georgetown,Jamorko Pickett,205.74,93.439952,PF,13,176,18,50,0.36,13,39,0.333,1,2,0.5,6,26,32,7,0,7,5,12,50,32,26,1,-28,-39,0,11.65,-67,-55.35,0.36,0.3333333333333333,0.5
2021,Minnesota Timberwolves,,Leandro Bolmaro,198.12,90.7184,SF,35,241,17,54,0.315,5,18,0.278,11,13,0.846,16,27,43,21,6,0,13,26,50,37,13,2,-40,-24,9,15.2,-55,-39.8,0.3148148148148148,0.2777777777777778,0.8461538461538461
2021,Los Angeles Clippers,,Jay Scrubb,195.58,99.79024,SG,18,121,18,46,0.391,6,21,0.286,7,10,0.7,2,14,16,8,4,3,7,9,49,28,15,3,-20,-27,4,6.05,-43,-36.95,0.391304347826087,0.2857142857142857,0.7
2021,Dallas Mavericks,North Carolina,Theo Pinson,195.58,96.161504,SF,19,148,14,39,0.359,10,30,0.333,10,10,1.0,2,19,21,17,5,2,5,12,48,25,20,0,-22,-30,10,10.4,-42,-31.6,0.358974358974359,0.3333333333333333,1.0
2021,Houston Rockets,,Usman Garuba,203.2,103.872568,PF,24,239,19,44,0.432,5,20,0.25,5,7,0.714,21,62,83,17,10,11,6,28,48,25,15,2,-12,-30,3,36.35,-39,-2.6499999999999986,0.4318181818181818,0.25,0.7142857142857143
2021,San Antonio Spurs,North Carolina-Wilmington,Devontae Cacok,200.66,108.86208,PF,15,121,21,31,0.677,0,0,0.0,4,7,0.571,8,34,42,6,8,7,3,16,46,10,0,3,22,0,1,19.2,23,42.2,0.6774193548387096,,0.5714285714285714
2021,Sacramento Kings,Oregon,Louis King,200.66,92.98636,SF,10,104,15,47,0.319,8,27,0.296,7,10,0.7,0,12,12,9,2,1,0,14,45,32,19,3,-34,-33,4,6.05,-63,-56.95,0.3191489361702128,0.2962962962962963,0.7
2021,Sacramento Kings,Utah State,Neemias Queta,213.36,112.490816,C,15,120,17,38,0.447,0,0,0.0,11,17,0.647,14,17,31,6,1,8,6,18,45,21,0,6,-8,0,5,13.35,-3,10.35,0.4473684210526316,,0.6470588235294118
2021,Oklahoma City Thunder,Michigan,Zavier Simpson,182.88,86.18248,PG,4,174,19,52,0.365,1,8,0.125,5,5,1.0,2,19,21,30,5,4,10,15,44,33,7,0,-28,-18,5,12.0,-41,-29.0,0.36538461538461536,0.125,1.0
2021,Miami Heat,Wheeling Jesuit,Haywood Highsmith,193.04,99.79024,SF,19,163,16,46,0.348,9,28,0.321,2,5,0.4,10,16,26,6,2,3,3,13,43,30,19,3,-28,-30,-1,10.85,-59,-48.15,0.34782608695652173,0.32142857142857145,0.4
2021,Houston Rockets,New Mexico State,Trevelin Queen,198.12,86.18248,SG,10,74,15,33,0.455,9,24,0.375,4,4,1.0,7,9,16,4,5,1,7,6,43,18,15,0,-6,-18,4,5.95,-20,-14.05,0.45454545454545453,0.375,1.0
2021,New Orleans Pelicans,Missouri State,Alize Johnson,203.2,96.161504,PF,23,167,17,39,0.436,0,4,0.0,7,12,0.583,28,33,61,9,5,0,12,18,41,22,4,5,-10,-12,2,20.1,-20,0.10000000000000142,0.4358974358974359,0.0,0.5833333333333334
2021,New Orleans Pelicans,Missouri State,Alize Johnson,203.2,96.161504,PF,23,167,17,39,0.436,0,4,0.0,7,12,0.583,28,33,61,9,5,0,12,18,41,22,4,5,-10,-12,2,20.1,-20,0.10000000000000142,0.4358974358974359,0.0,0.5833333333333334
2021,New Orleans Pelicans,Missouri State,Alize Johnson,203.2,96.161504,PF,23,167,17,39,0.436,0,4,0.0,7,12,0.583,28,33,61,9,5,0,12,18,41,22,4,5,-10,-12,2,20.1,-20,0.10000000000000142,0.4358974358974359,0.0,0.5833333333333334
2021,New Orleans Pelicans,Missouri State,Alize Johnson,203.2,96.161504,PF,23,167,17,39,0.436,0,4,0.0,7,12,0.583,28,33,61,9,5,0,12,18,41,22,4,5,-10,-12,2,20.1,-20,0.10000000000000142,0.4358974358974359,0.0,0.5833333333333334
2021,New Orleans Pelicans,Missouri State,Alize Johnson,203.2,96.161504,PF,23,167,17,39,0.436,0,4,0.0,7,12,0.583,28,33,61,9,5,0,12,18,41,22,4,5,-10,-12,2,20.1,-20,0.10000000000000142,0.4358974358974359,0.0,0.5833333333333334
2021,New Orleans Pelicans,Missouri State,Alize Johnson,203.2,96.161504,PF,23,167,17,39,0.436,0,4,0.0,7,12,0.583,28,33,61,9,5,0,12,18,41,22,4,5,-10,-12,2,20.1,-20,0.10000000000000142,0.4358974358974359,0.0,0.5833333333333334
2021,New Orleans Pelicans,Missouri State,Alize Johnson,203.2,96.161504,PF,23,167,17,39,0.436,0,4,0.0,7,12,0.583,28,33,61,9,5,0,12,18,41,22,4,5,-10,-12,2,20.1,-20,0.10000000000000142,0.4358974358974359,0.0,0.5833333333333334
2021,New Orleans Pelicans,Missouri State,Alize Johnson,203.2,96.161504,PF,23,167,17,39,0.436,0,4,0.0,7,12,0.583,28,33,61,9,5,0,12,18,41,22,4,5,-10,-12,2,20.1,-20,0.10000000000000142,0.4358974358974359,0.0,0.5833333333333334
2021,New Orleans Pelicans,Missouri State,Alize Johnson,203.2,96.161504,PF,23,167,17,39,0.436,0,4,0.0,7,12,0.583,28,33,61,9,5,0,12,18,41,22,4,5,-10,-12,2,20.1,-20,0.10000000000000142,0.4358974358974359,0.0,0.5833333333333334
2021,New Orleans Pelicans,Missouri State,Alize Johnson,203.2,96.161504,PF,23,167,17,39,0.436,0,4,0.0,7,12,0.583,28,33,61,9,5,0,12,18,41,22,4,5,-10,-12,2,20.1,-20,0.10000000000000142,0.4358974358974359,0.0,0.5833333333333334
2021,New Orleans Pelicans,Missouri State,Alize Johnson,203.2,96.161504,PF,23,167,17,39,0.436,0,4,0.0,7,12,0.583,28,33,61,9,5,0,12,18,41,22,4,5,-10,-12,2,20.1,-20,0.10000000000000142,0.4358974358974359,0.0,0.5833333333333334
2021,New Orleans Pelicans,Missouri State,Alize Johnson,203.2,96.161504,PF,23,167,17,39,0.436,0,4,0.0,7,12,0.583,28,33,61,9,5,0,12,18,41,22,4,5,-10,-12,2,20.1,-20,0.10000000000000142,0.4358974358974359,0.0,0.5833333333333334
2021,New Orleans Pelicans,Missouri State,Alize Johnson,203.2,96.161504,PF,23,167,17,39,0.436,0,4,0.0,7,12,0.583,28,33,61,9,5,0,12,18,41,22,4,5,-10,-12,2,20.1,-20,0.10000000000000142,0.4358974358974359,0.0,0.5833333333333334
2021,New Orleans Pelicans,Missouri State,Alize Johnson,203.2,96.161504,PF,23,167,17,39,0.436,0,4,0.0,7,12,0.583,28,33,61,9,5,0,12,18,41,22,4,5,-10,-12,2,20.1,-20,0.10000000000000142,0.4358974358974359,0.0,0.5833333333333334
2021,New Orleans Pelicans,Missouri State,Alize Johnson,203.2,96.161504,PF,23,167,17,39,0.436,0,4,0.0,7,12,0.583,28,33,61,9,5,0,12,18,41,22,4,5,-10,-12,2,20.1,-20,0.10000000000000142,0.4358974358974359,0.0,0.5833333333333334
2021,New Orleans Pelicans,Missouri State,Alize Johnson,203.2,96.161504,PF,23,167,17,39,0.436,0,4,0.0,7,12,0.583,28,33,61,9,5,0,12,18,41,22,4,5,-10,-12,2,20.1,-20,0.10000000000000142,0.4358974358974359,0.0,0.5833333333333334
2021,Cleveland Cavaliers,Gonzaga,Kevin Pangos,185.42,81.19296800000001,PG,24,166,15,46,0.326,6,26,0.231,3,4,0.75,2,9,11,30,3,0,7,11,39,31,20,1,-32,-42,2,8.2,-72,-63.8,0.32608695652173914,0.23076923076923078,0.75
2021,Cleveland Cavaliers,Penn State,Tim Frazier,182.88,77.11064,PG,12,208,14,45,0.311,6,17,0.353,5,9,0.556,5,14,19,34,3,1,15,27,39,31,11,4,-34,-15,1,7.65,-48,-40.35,0.3111111111111111,0.35294117647058826,0.5555555555555556
2021,Cleveland Cavaliers,Penn State,Tim Frazier,182.88,77.11064,PG,12,208,14,45,0.311,6,17,0.353,5,9,0.556,5,14,19,34,3,1,15,27,39,31,11,4,-34,-15,1,7.65,-48,-40.35,0.3111111111111111,0.35294117647058826,0.5555555555555556
2021,Cleveland Cavaliers,Penn State,Tim Frazier,182.88,77.11064,PG,12,208,14,45,0.311,6,17,0.353,5,9,0.556,5,14,19,34,3,1,15,27,39,31,11,4,-34,-15,1,7.65,-48,-40.35,0.3111111111111111,0.35294117647058826,0.5555555555555556
2021,Cleveland Cavaliers,Penn State,Tim Frazier,182.88,77.11064,PG,12,208,14,45,0.311,6,17,0.353,5,9,0.556,5,14,19,34,3,1,15,27,39,31,11,4,-34,-15,1,7.65,-48,-40.35,0.3111111111111111,0.35294117647058826,0.5555555555555556
2021,Cleveland Cavaliers,Penn State,Tim Frazier,182.88,77.11064,PG,12,208,14,45,0.311,6,17,0.353,5,9,0.556,5,14,19,34,3,1,15,27,39,31,11,4,-34,-15,1,7.65,-48,-40.35,0.3111111111111111,0.35294117647058826,0.5555555555555556
2021,Cleveland Cavaliers,Penn State,Tim Frazier,182.88,77.11064,PG,12,208,14,45,0.311,6,17,0.353,5,9,0.556,5,14,19,34,3,1,15,27,39,31,11,4,-34,-15,1,7.65,-48,-40.35,0.3111111111111111,0.35294117647058826,0.5555555555555556
2021,Cleveland Cavaliers,Penn State,Tim Frazier,182.88,77.11064,PG,12,208,14,45,0.311,6,17,0.353,5,9,0.556,5,14,19,34,3,1,15,27,39,31,11,4,-34,-15,1,7.65,-48,-40.35,0.3111111111111111,0.35294117647058826,0.5555555555555556
2021,Cleveland Cavaliers,Penn State,Tim Frazier,182.88,77.11064,PG,12,208,14,45,0.311,6,17,0.353,5,9,0.556,5,14,19,34,3,1,15,27,39,31,11,4,-34,-15,1,7.65,-48,-40.35,0.3111111111111111,0.35294117647058826,0.5555555555555556
2021,Cleveland Cavaliers,Penn State,Tim Frazier,182.88,77.11064,PG,12,208,14,45,0.311,6,17,0.353,5,9,0.556,5,14,19,34,3,1,15,27,39,31,11,4,-34,-15,1,7.65,-48,-40.35,0.3111111111111111,0.35294117647058826,0.5555555555555556
2021,New Orleans Pelicans,Auburn,Jared Harper,177.8,79.3786,PG,5,43,14,26,0.538,5,12,0.417,4,4,1.0,2,0,2,14,4,1,2,5,37,12,7,0,4,-6,4,5.75,2,7.75,0.5384615384615384,0.4166666666666667,1.0
2021,Portland Trail Blazers,,Didi Louzada,195.58,85.275296,SG,9,129,12,33,0.364,9,23,0.391,2,2,1.0,5,12,17,5,2,2,5,13,35,21,14,0,-18,-15,2,5.6,-31,-25.4,0.36363636363636365,0.391304347826087,1.0
2021,Portland Trail Blazers,,Didi Louzada,195.58,85.275296,SG,9,129,12,33,0.364,9,23,0.391,2,2,1.0,5,12,17,5,2,2,5,13,35,21,14,0,-18,-15,2,5.6,-31,-25.4,0.36363636363636365,0.391304347826087,1.0
2021,Portland Trail Blazers,,Didi Louzada,195.58,85.275296,SG,9,129,12,33,0.364,9,23,0.391,2,2,1.0,5,12,17,5,2,2,5,13,35,21,14,0,-18,-15,2,5.6,-31,-25.4,0.36363636363636365,0.391304347826087,1.0
2021,Portland Trail Blazers,,Didi Louzada,195.58,85.275296,SF,9,129,12,33,0.364,9,23,0.391,2,2,1.0,5,12,17,5,2,2,5,13,35,21,14,0,-18,-15,2,5.6,-31,-25.4,0.36363636363636365,0.391304347826087,1.0
2021,Portland Trail Blazers,,Didi Louzada,195.58,85.275296,SF,9,129,12,33,0.364,9,23,0.391,2,2,1.0,5,12,17,5,2,2,5,13,35,21,14,0,-18,-15,2,5.6,-31,-25.4,0.36363636363636365,0.391304347826087,1.0
2021,Portland Trail Blazers,,Didi Louzada,195.58,85.275296,SF,9,129,12,33,0.364,9,23,0.391,2,2,1.0,5,12,17,5,2,2,5,13,35,21,14,0,-18,-15,2,5.6,-31,-25.4,0.36363636363636365,0.391304347826087,1.0
2021,Portland Trail Blazers,,Didi Louzada,195.58,85.275296,SG,9,129,12,33,0.364,9,23,0.391,2,2,1.0,5,12,17,5,2,2,5,13,35,21,14,0,-18,-15,2,5.6,-31,-25.4,0.36363636363636365,0.391304347826087,1.0
2021,Portland Trail Blazers,,Didi Louzada,195.58,85.275296,SG,9,129,12,33,0.364,9,23,0.391,2,2,1.0,5,12,17,5,2,2,5,13,35,21,14,0,-18,-15,2,5.6,-31,-25.4,0.36363636363636365,0.391304347826087,1.0
2021,Portland Trail Blazers,,Didi Louzada,195.58,85.275296,SG,9,129,12,33,0.364,9,23,0.391,2,2,1.0,5,12,17,5,2,2,5,13,35,21,14,0,-18,-15,2,5.6,-31,-25.4,0.36363636363636365,0.391304347826087,1.0
2021,Phoenix Suns,Iowa State,Abdel Nader,195.58,102.0582,SF,14,145,12,35,0.343,4,14,0.286,6,10,0.6,4,23,27,7,8,4,11,20,34,23,10,4,-22,-18,2,9.0,-38,-29.0,0.34285714285714286,0.2857142857142857,0.6
2021,Philadelphia 76ers,Kentucky,Willie Cauley-Stein,213.36,108.86208,C,20,183,16,35,0.457,1,2,0.5,1,2,0.5,13,27,40,10,6,3,7,19,34,19,1,1,-6,0,0,15.8,-6,9.8,0.45714285714285713,0.5,0.5
2021,Philadelphia 76ers,Kentucky,Willie Cauley-Stein,213.36,108.86208,C,20,183,16,35,0.457,1,2,0.5,1,2,0.5,13,27,40,10,6,3,7,19,34,19,1,1,-6,0,0,15.8,-6,9.8,0.45714285714285713,0.5,0.5
2021,Philadelphia 76ers,Kentucky,Willie Cauley-Stein,213.36,108.86208,C,20,183,16,35,0.457,1,2,0.5,1,2,0.5,13,27,40,10,6,3,7,19,34,19,1,1,-6,0,0,15.8,-6,9.8,0.45714285714285713,0.5,0.5
2021,Philadelphia 76ers,Kentucky,Willie Cauley-Stein,213.36,108.86208,C,20,183,16,35,0.457,1,2,0.5,1,2,0.5,13,27,40,10,6,3,7,19,34,19,1,1,-6,0,0,15.8,-6,9.8,0.45714285714285713,0.5,0.5
2021,Philadelphia 76ers,Kentucky,Willie Cauley-Stein,213.36,108.86208,C,20,183,16,35,0.457,1,2,0.5,1,2,0.5,13,27,40,10,6,3,7,19,34,19,1,1,-6,0,0,15.8,-6,9.8,0.45714285714285713,0.5,0.5
2021,Philadelphia 76ers,Kentucky,Willie Cauley-Stein,213.36,108.86208,C,20,183,16,35,0.457,1,2,0.5,1,2,0.5,13,27,40,10,6,3,7,19,34,19,1,1,-6,0,0,15.8,-6,9.8,0.45714285714285713,0.5,0.5
2021,Philadelphia 76ers,Kentucky,Willie Cauley-Stein,213.36,108.86208,C,20,183,16,35,0.457,1,2,0.5,1,2,0.5,13,27,40,10,6,3,7,19,34,19,1,1,-6,0,0,15.8,-6,9.8,0.45714285714285713,0.5,0.5
2021,Philadelphia 76ers,Kentucky,Willie Cauley-Stein,213.36,108.86208,C,20,183,16,35,0.457,1,2,0.5,1,2,0.5,13,27,40,10,6,3,7,19,34,19,1,1,-6,0,0,15.8,-6,9.8,0.45714285714285713,0.5,0.5
2021,Philadelphia 76ers,Kentucky,Willie Cauley-Stein,213.36,108.86208,C,20,183,16,35,0.457,1,2,0.5,1,2,0.5,13,27,40,10,6,3,7,19,34,19,1,1,-6,0,0,15.8,-6,9.8,0.45714285714285713,0.5,0.5
2021,Orlando Magic,Oregon,Bol Bol,218.44,99.79024,PF,14,81,15,27,0.556,1,4,0.25,2,5,0.4,4,16,20,5,1,2,4,4,33,12,3,3,6,-6,-1,6.55,-1,5.55,0.5555555555555556,0.25,0.4
2021,Dallas Mavericks,Kentucky,Brandon Knight,187.96,82.553744,PG,5,65,10,25,0.4,4,17,0.235,8,8,1.0,0,8,8,8,1,0,4,5,32,15,13,0,-10,-27,8,2.25,-29,-26.75,0.4,0.23529411764705882,1.0
2021,Miami Heat,Florida,Udonis Haslem,203.2,106.59412,C,13,83,14,31,0.452,1,4,0.25,3,3,1.0,4,21,25,4,1,1,5,15,32,17,3,0,-6,-6,3,6.0,-9,-3.0,0.45161290322580644,0.25,1.0
2021,Atlanta Hawks,Michigan,Chaundee Brown Jr.,195.58,97.52228,SG,5,104,10,32,0.313,6,18,0.333,5,6,0.833,1,15,16,4,2,0,1,7,31,22,12,1,-24,-18,4,5.4,-38,-32.6,0.3125,0.3333333333333333,0.8333333333333334
2021,Atlanta Hawks,Michigan,Chaundee Brown Jr.,195.58,97.52228,SG,5,104,10,32,0.313,6,18,0.333,5,6,0.833,1,15,16,4,2,0,1,7,31,22,12,1,-24,-18,4,5.4,-38,-32.6,0.3125,0.3333333333333333,0.8333333333333334
2021,Atlanta Hawks,Michigan,Chaundee Brown Jr.,195.58,97.52228,SG,5,104,10,32,0.313,6,18,0.333,5,6,0.833,1,15,16,4,2,0,1,7,31,22,12,1,-24,-18,4,5.4,-38,-32.6,0.3125,0.3333333333333333,0.8333333333333334
2021,Atlanta Hawks,Michigan,Chaundee Brown Jr.,195.58,97.52228,SF,5,104,10,32,0.313,6,18,0.333,5,6,0.833,1,15,16,4,2,0,1,7,31,22,12,1,-24,-18,4,5.4,-38,-32.6,0.3125,0.3333333333333333,0.8333333333333334
2021,Atlanta Hawks,Michigan,Chaundee Brown Jr.,195.58,97.52228,SF,5,104,10,32,0.313,6,18,0.333,5,6,0.833,1,15,16,4,2,0,1,7,31,22,12,1,-24,-18,4,5.4,-38,-32.6,0.3125,0.3333333333333333,0.8333333333333334
2021,Atlanta Hawks,Michigan,Chaundee Brown Jr.,195.58,97.52228,SF,5,104,10,32,0.313,6,18,0.333,5,6,0.833,1,15,16,4,2,0,1,7,31,22,12,1,-24,-18,4,5.4,-38,-32.6,0.3125,0.3333333333333333,0.8333333333333334
2021,Atlanta Hawks,Michigan,Chaundee Brown Jr.,195.58,97.52228,SG,5,104,10,32,0.313,6,18,0.333,5,6,0.833,1,15,16,4,2,0,1,7,31,22,12,1,-24,-18,4,5.4,-38,-32.6,0.3125,0.3333333333333333,0.8333333333333334
2021,Atlanta Hawks,Michigan,Chaundee Brown Jr.,195.58,97.52228,SG,5,104,10,32,0.313,6,18,0.333,5,6,0.833,1,15,16,4,2,0,1,7,31,22,12,1,-24,-18,4,5.4,-38,-32.6,0.3125,0.3333333333333333,0.8333333333333334
2021,Atlanta Hawks,Michigan,Chaundee Brown Jr.,195.58,97.52228,SG,5,104,10,32,0.313,6,18,0.333,5,6,0.833,1,15,16,4,2,0,1,7,31,22,12,1,-24,-18,4,5.4,-38,-32.6,0.3125,0.3333333333333333,0.8333333333333334
2021,Oklahoma City Thunder,Fresno State,Paul Watson,198.12,95.25432,SF,9,156,12,35,0.343,6,26,0.231,1,2,0.5,3,24,27,8,3,3,4,10,31,23,20,1,-22,-42,0,10.0,-64,-54.0,0.34285714285714286,0.23076923076923078,0.5
2021,Philadelphia 76ers,St. Joseph's (PA),Charlie Brown Jr.,198.12,90.264808,SG,22,178,10,39,0.256,1,12,0.083,9,10,0.9,14,18,32,6,10,4,5,18,30,29,11,1,-38,-30,8,16.6,-60,-43.4,0.2564102564102564,0.08333333333333333,0.9
2021,Philadelphia 76ers,St. Joseph's (PA),Charlie Brown Jr.,198.12,90.264808,SG,22,178,10,39,0.256,1,12,0.083,9,10,0.9,14,18,32,6,10,4,5,18,30,29,11,1,-38,-30,8,16.6,-60,-43.4,0.2564102564102564,0.08333333333333333,0.9
2021,Philadelphia 76ers,St. Joseph's (PA),Charlie Brown Jr.,198.12,90.264808,SG,22,178,10,39,0.256,1,12,0.083,9,10,0.9,14,18,32,6,10,4,5,18,30,29,11,1,-38,-30,8,16.6,-60,-43.4,0.2564102564102564,0.08333333333333333,0.9
2021,Philadelphia 76ers,St. Joseph's (PA),Charlie Brown Jr.,198.12,90.264808,SG,22,178,10,39,0.256,1,12,0.083,9,10,0.9,14,18,32,6,10,4,5,18,30,29,11,1,-38,-30,8,16.6,-60,-43.4,0.2564102564102564,0.08333333333333333,0.9
2021,Philadelphia 76ers,St. Joseph's (PA),Charlie Brown Jr.,198.12,90.264808,SG,22,178,10,39,0.256,1,12,0.083,9,10,0.9,14,18,32,6,10,4,5,18,30,29,11,1,-38,-30,8,16.6,-60,-43.4,0.2564102564102564,0.08333333333333333,0.9
2021,Philadelphia 76ers,St. Joseph's (PA),Charlie Brown Jr.,198.12,90.264808,SG,22,178,10,39,0.256,1,12,0.083,9,10,0.9,14,18,32,6,10,4,5,18,30,29,11,1,-38,-30,8,16.6,-60,-43.4,0.2564102564102564,0.08333333333333333,0.9
2021,Philadelphia 76ers,St. Joseph's (PA),Charlie Brown Jr.,198.12,90.264808,SG,22,178,10,39,0.256,1,12,0.083,9,10,0.9,14,18,32,6,10,4,5,18,30,29,11,1,-38,-30,8,16.6,-60,-43.4,0.2564102564102564,0.08333333333333333,0.9
2021,Philadelphia 76ers,St. Joseph's (PA),Charlie Brown Jr.,198.12,90.264808,SG,22,178,10,39,0.256,1,12,0.083,9,10,0.9,14,18,32,6,10,4,5,18,30,29,11,1,-38,-30,8,16.6,-60,-43.4,0.2564102564102564,0.08333333333333333,0.9
2021,Philadelphia 76ers,St. Joseph's (PA),Charlie Brown Jr.,198.12,90.264808,SG,22,178,10,39,0.256,1,12,0.083,9,10,0.9,14,18,32,6,10,4,5,18,30,29,11,1,-38,-30,8,16.6,-60,-43.4,0.2564102564102564,0.08333333333333333,0.9
2021,Toronto Raptors,Michigan,D.J. Wilson,208.28,104.779752,PF,4,54,11,15,0.733,0,2,0.0,8,10,0.8,1,15,16,5,5,1,2,6,30,4,2,2,14,-6,6,7.2,14,21.2,0.7333333333333333,0.0,0.8
2021,Boston Celtics,Vanderbilt,Luke Kornet,218.44,113.398,C,15,103,13,27,0.481,0,5,0.0,4,6,0.667,13,16,29,9,3,3,0,9,30,14,5,2,-2,-15,2,15.3,-15,0.3000000000000007,0.48148148148148145,0.0,0.6666666666666666
2021,Boston Celtics,Vanderbilt,Luke Kornet,218.44,113.398,C,15,103,13,27,0.481,0,5,0.0,4,6,0.667,13,16,29,9,3,3,0,9,30,14,5,2,-2,-15,2,15.3,-15,0.3000000000000007,0.48148148148148145,0.0,0.6666666666666666
2021,Boston Celtics,Vanderbilt,Luke Kornet,218.44,113.398,C,15,103,13,27,0.481,0,5,0.0,4,6,0.667,13,16,29,9,3,3,0,9,30,14,5,2,-2,-15,2,15.3,-15,0.3000000000000007,0.48148148148148145,0.0,0.6666666666666666
2021,Boston Celtics,Vanderbilt,Luke Kornet,218.44,113.398,C,15,103,13,27,0.481,0,5,0.0,4,6,0.667,13,16,29,9,3,3,0,9,30,14,5,2,-2,-15,2,15.3,-15,0.3000000000000007,0.48148148148148145,0.0,0.6666666666666666
2021,Boston Celtics,Vanderbilt,Luke Kornet,218.44,113.398,C,15,103,13,27,0.481,0,5,0.0,4,6,0.667,13,16,29,9,3,3,0,9,30,14,5,2,-2,-15,2,15.3,-15,0.3000000000000007,0.48148148148148145,0.0,0.6666666666666666
2021,Boston Celtics,Vanderbilt,Luke Kornet,218.44,113.398,C,15,103,13,27,0.481,0,5,0.0,4,6,0.667,13,16,29,9,3,3,0,9,30,14,5,2,-2,-15,2,15.3,-15,0.3000000000000007,0.48148148148148145,0.0,0.6666666666666666
2021,Boston Celtics,Vanderbilt,Luke Kornet,218.44,113.398,C,15,103,13,27,0.481,0,5,0.0,4,6,0.667,13,16,29,9,3,3,0,9,30,14,5,2,-2,-15,2,15.3,-15,0.3000000000000007,0.48148148148148145,0.0,0.6666666666666666
2021,Boston Celtics,Vanderbilt,Luke Kornet,218.44,113.398,C,15,103,13,27,0.481,0,5,0.0,4,6,0.667,13,16,29,9,3,3,0,9,30,14,5,2,-2,-15,2,15.3,-15,0.3000000000000007,0.48148148148148145,0.0,0.6666666666666666
2021,Boston Celtics,Vanderbilt,Luke Kornet,218.44,113.398,C,15,103,13,27,0.481,0,5,0.0,4,6,0.667,13,16,29,9,3,3,0,9,30,14,5,2,-2,-15,2,15.3,-15,0.3000000000000007,0.48148148148148145,0.0,0.6666666666666666
2021,Boston Celtics,Vanderbilt,Luke Kornet,218.44,113.398,C,15,103,13,27,0.481,0,5,0.0,4,6,0.667,13,16,29,9,3,3,0,9,30,14,5,2,-2,-15,2,15.3,-15,0.3000000000000007,0.48148148148148145,0.0,0.6666666666666666
2021,Boston Celtics,Vanderbilt,Luke Kornet,218.44,113.398,C,15,103,13,27,0.481,0,5,0.0,4,6,0.667,13,16,29,9,3,3,0,9,30,14,5,2,-2,-15,2,15.3,-15,0.3000000000000007,0.48148148148148145,0.0,0.6666666666666666
2021,Boston Celtics,Vanderbilt,Luke Kornet,218.44,113.398,C,15,103,13,27,0.481,0,5,0.0,4,6,0.667,13,16,29,9,3,3,0,9,30,14,5,2,-2,-15,2,15.3,-15,0.3000000000000007,0.48148148148148145,0.0,0.6666666666666666
2021,Boston Celtics,Vanderbilt,Luke Kornet,218.44,113.398,C,15,103,13,27,0.481,0,5,0.0,4,6,0.667,13,16,29,9,3,3,0,9,30,14,5,2,-2,-15,2,15.3,-15,0.3000000000000007,0.48148148148148145,0.0,0.6666666666666666
2021,Boston Celtics,Vanderbilt,Luke Kornet,218.44,113.398,C,15,103,13,27,0.481,0,5,0.0,4,6,0.667,13,16,29,9,3,3,0,9,30,14,5,2,-2,-15,2,15.3,-15,0.3000000000000007,0.48148148148148145,0.0,0.6666666666666666
2021,Boston Celtics,Vanderbilt,Luke Kornet,218.44,113.398,C,15,103,13,27,0.481,0,5,0.0,4,6,0.667,13,16,29,9,3,3,0,9,30,14,5,2,-2,-15,2,15.3,-15,0.3000000000000007,0.48148148148148145,0.0,0.6666666666666666
2021,Boston Celtics,Vanderbilt,Luke Kornet,218.44,113.398,C,15,103,13,27,0.481,0,5,0.0,4,6,0.667,13,16,29,9,3,3,0,9,30,14,5,2,-2,-15,2,15.3,-15,0.3000000000000007,0.48148148148148145,0.0,0.6666666666666666
2021,Golden State Warriors,Mississippi State,Quinndary Weatherspoon,190.5,92.98636,SG,11,73,12,21,0.571,1,5,0.2,5,5,1.0,2,12,14,5,1,1,3,15,30,9,4,0,6,-9,5,4.0,2,6.0,0.5714285714285714,0.2,1.0
2021,Chicago Bulls,Kansas,Devon Dotson,185.42,83.91452,PG,11,85,11,23,0.478,2,9,0.222,5,9,0.556,1,8,9,15,1,0,5,11,29,12,7,4,-2,-15,1,3.7,-16,-12.3,0.4782608695652174,0.2222222222222222,0.5555555555555556
2021,Denver Nuggets,Cal State-Long Beach,James Ennis III,198.12,97.52228,SF,7,56,11,24,0.458,3,8,0.375,4,5,0.8,5,7,12,3,2,2,2,5,29,13,5,1,-4,-6,3,5.75,-7,-1.25,0.4583333333333333,0.375,0.8
2021,Denver Nuggets,Cal State-Long Beach,James Ennis III,198.12,97.52228,SF,7,56,11,24,0.458,3,8,0.375,4,5,0.8,5,7,12,3,2,2,2,5,29,13,5,1,-4,-6,3,5.75,-7,-1.25,0.4583333333333333,0.375,0.8
2021,Denver Nuggets,Cal State-Long Beach,James Ennis III,198.12,97.52228,SF,7,56,11,24,0.458,3,8,0.375,4,5,0.8,5,7,12,3,2,2,2,5,29,13,5,1,-4,-6,3,5.75,-7,-1.25,0.4583333333333333,0.375,0.8
2021,Denver Nuggets,Cal State-Long Beach,James Ennis III,198.12,97.52228,SF,7,56,11,24,0.458,3,8,0.375,4,5,0.8,5,7,12,3,2,2,2,5,29,13,5,1,-4,-6,3,5.75,-7,-1.25,0.4583333333333333,0.375,0.8
2021,Denver Nuggets,Cal State-Long Beach,James Ennis III,198.12,97.52228,SF,7,56,11,24,0.458,3,8,0.375,4,5,0.8,5,7,12,3,2,2,2,5,29,13,5,1,-4,-6,3,5.75,-7,-1.25,0.4583333333333333,0.375,0.8
2021,Denver Nuggets,Cal State-Long Beach,James Ennis III,198.12,97.52228,SF,7,56,11,24,0.458,3,8,0.375,4,5,0.8,5,7,12,3,2,2,2,5,29,13,5,1,-4,-6,3,5.75,-7,-1.25,0.4583333333333333,0.375,0.8
2021,Denver Nuggets,Cal State-Long Beach,James Ennis III,198.12,97.52228,SF,7,56,11,24,0.458,3,8,0.375,4,5,0.8,5,7,12,3,2,2,2,5,29,13,5,1,-4,-6,3,5.75,-7,-1.25,0.4583333333333333,0.375,0.8
2021,Denver Nuggets,Cal State-Long Beach,James Ennis III,198.12,97.52228,SF,7,56,11,24,0.458,3,8,0.375,4,5,0.8,5,7,12,3,2,2,2,5,29,13,5,1,-4,-6,3,5.75,-7,-1.25,0.4583333333333333,0.375,0.8
2021,Denver Nuggets,Cal State-Long Beach,James Ennis III,198.12,97.52228,SF,7,56,11,24,0.458,3,8,0.375,4,5,0.8,5,7,12,3,2,2,2,5,29,13,5,1,-4,-6,3,5.75,-7,-1.25,0.4583333333333333,0.375,0.8
2021,Denver Nuggets,Cal State-Long Beach,James Ennis III,198.12,97.52228,SF,7,56,11,24,0.458,3,8,0.375,4,5,0.8,5,7,12,3,2,2,2,5,29,13,5,1,-4,-6,3,5.75,-7,-1.25,0.4583333333333333,0.375,0.8
2021,Denver Nuggets,Cal State-Long Beach,James Ennis III,198.12,97.52228,SF,7,56,11,24,0.458,3,8,0.375,4,5,0.8,5,7,12,3,2,2,2,5,29,13,5,1,-4,-6,3,5.75,-7,-1.25,0.4583333333333333,0.375,0.8
2021,Denver Nuggets,Cal State-Long Beach,James Ennis III,198.12,97.52228,SF,7,56,11,24,0.458,3,8,0.375,4,5,0.8,5,7,12,3,2,2,2,5,29,13,5,1,-4,-6,3,5.75,-7,-1.25,0.4583333333333333,0.375,0.8
2021,Denver Nuggets,Cal State-Long Beach,James Ennis III,198.12,97.52228,SF,7,56,11,24,0.458,3,8,0.375,4,5,0.8,5,7,12,3,2,2,2,5,29,13,5,1,-4,-6,3,5.75,-7,-1.25,0.4583333333333333,0.375,0.8
2021,Denver Nuggets,Cal State-Long Beach,James Ennis III,198.12,97.52228,SF,7,56,11,24,0.458,3,8,0.375,4,5,0.8,5,7,12,3,2,2,2,5,29,13,5,1,-4,-6,3,5.75,-7,-1.25,0.4583333333333333,0.375,0.8
2021,Denver Nuggets,Cal State-Long Beach,James Ennis III,198.12,97.52228,SF,7,56,11,24,0.458,3,8,0.375,4,5,0.8,5,7,12,3,2,2,2,5,29,13,5,1,-4,-6,3,5.75,-7,-1.25,0.4583333333333333,0.375,0.8
2021,Denver Nuggets,Cal State-Long Beach,James Ennis III,198.12,97.52228,SF,7,56,11,24,0.458,3,8,0.375,4,5,0.8,5,7,12,3,2,2,2,5,29,13,5,1,-4,-6,3,5.75,-7,-1.25,0.4583333333333333,0.375,0.8
2021,Cleveland Cavaliers,North Carolina,Ed Davis,205.74,98.883056,C,31,201,11,16,0.688,0,0,0.0,6,14,0.429,14,50,64,7,3,9,5,33,28,5,0,8,12,0,-2,23.1,10,33.1,0.6875,,0.42857142857142855
2021,Los Angeles Lakers,Arkansas,Mason Jones,193.04,90.7184,SG,4,51,7,15,0.467,1,4,0.25,12,15,0.8,1,9,10,4,2,0,1,8,27,8,3,3,-2,-6,9,3.85,1,4.85,0.4666666666666667,0.25,0.8
2021,Miami Heat,South Carolina,Chris Silva,203.2,106.140528,PF,10,91,8,15,0.533,0,0,0.0,10,12,0.833,13,23,36,7,0,1,8,20,26,7,0,2,2,0,8,9.5,10,19.5,0.5333333333333333,,0.8333333333333334
2021,Miami Heat,South Carolina,Chris Silva,203.2,106.140528,PF,10,91,8,15,0.533,0,0,0.0,10,12,0.833,13,23,36,7,0,1,8,20,26,7,0,2,2,0,8,9.5,10,19.5,0.5333333333333333,,0.8333333333333334
2021,Miami Heat,South Carolina,Chris Silva,203.2,106.140528,PF,10,91,8,15,0.533,0,0,0.0,10,12,0.833,13,23,36,7,0,1,8,20,26,7,0,2,2,0,8,9.5,10,19.5,0.5333333333333333,,0.8333333333333334
2021,Miami Heat,South Carolina,Chris Silva,203.2,106.140528,PF,10,91,8,15,0.533,0,0,0.0,10,12,0.833,13,23,36,7,0,1,8,20,26,7,0,2,2,0,8,9.5,10,19.5,0.5333333333333333,,0.8333333333333334
2021,Miami Heat,South Carolina,Chris Silva,203.2,106.140528,PF,10,91,8,15,0.533,0,0,0.0,10,12,0.833,13,23,36,7,0,1,8,20,26,7,0,2,2,0,8,9.5,10,19.5,0.5333333333333333,,0.8333333333333334
2021,Miami Heat,South Carolina,Chris Silva,203.2,106.140528,PF,10,91,8,15,0.533,0,0,0.0,10,12,0.833,13,23,36,7,0,1,8,20,26,7,0,2,2,0,8,9.5,10,19.5,0.5333333333333333,,0.8333333333333334
2021,Miami Heat,South Carolina,Chris Silva,203.2,106.140528,PF,10,91,8,15,0.533,0,0,0.0,10,12,0.833,13,23,36,7,0,1,8,20,26,7,0,2,2,0,8,9.5,10,19.5,0.5333333333333333,,0.8333333333333334
2021,Miami Heat,South Carolina,Chris Silva,203.2,106.140528,PF,10,91,8,15,0.533,0,0,0.0,10,12,0.833,13,23,36,7,0,1,8,20,26,7,0,2,2,0,8,9.5,10,19.5,0.5333333333333333,,0.8333333333333334
2021,Miami Heat,South Carolina,Chris Silva,203.2,106.140528,PF,10,91,8,15,0.533,0,0,0.0,10,12,0.833,13,23,36,7,0,1,8,20,26,7,0,2,2,0,8,9.5,10,19.5,0.5333333333333333,,0.8333333333333334
2021,Memphis Grizzlies,Utah State,Sam Merrill,193.04,92.98636,SG,6,58,8,24,0.333,7,23,0.304,2,4,0.5,1,6,7,4,0,0,2,3,25,16,16,2,-16,-27,0,1.85,-43,-41.15,0.3333333333333333,0.30434782608695654,0.5
2021,Atlanta Hawks,Nevada,Cameron Oliver,203.2,108.408488,SF,2,43,10,15,0.667,1,3,0.333,2,3,0.667,2,4,6,3,1,1,0,5,23,5,2,1,10,-3,1,3.5,8,11.5,0.6666666666666666,0.3333333333333333,0.6666666666666666
2021,Detroit Pistons,Purdue,Carsen Edwards,180.34,90.7184,SG,4,79,9,30,0.3,4,16,0.25,1,1,1.0,2,4,6,14,2,0,5,4,23,21,12,0,-24,-24,1,3.8,-47,-43.2,0.3,0.25,1.0
2021,Charlotte Hornets,Texas-Austin,Kai Jones,208.28,100.243832,C,21,63,9,14,0.643,1,2,0.5,3,8,0.375,3,8,11,4,1,2,6,8,22,5,1,5,8,0,-2,2.6,6,8.6,0.6428571428571429,0.5,0.375
2021,Atlanta Hawks,Kansas State,Wes Iwundu,198.12,88.45044,SF,3,82,8,18,0.444,3,5,0.6,3,4,0.75,3,10,13,0,1,0,1,8,22,10,2,1,-4,3,2,3.6,1,4.6,0.4444444444444444,0.6,0.75
2021,Boston Celtics,Truman State,Brodric Thomas,195.58,83.91452,SG,12,60,8,18,0.444,2,9,0.222,3,5,0.6,2,8,10,11,1,1,6,7,21,10,7,2,-4,-15,1,3.4,-18,-14.6,0.4444444444444444,0.2222222222222222,0.6
2021,Orlando Magic,Baylor,Freddie Gillespie,205.74,111.13004,PF,9,119,9,22,0.409,0,1,0.0,3,7,0.429,13,23,36,5,3,9,5,18,21,13,1,4,-8,-3,-1,16.1,-12,4.100000000000001,0.4090909090909091,0.0,0.42857142857142855
2021,Boston Celtics,,Malik Fitts,195.58,104.32616,PF,15,63,8,19,0.421,5,10,0.5,0,0,0.0,2,15,17,5,0,0,2,4,21,11,5,0,-6,0,0,4.8,-6,-1.2000000000000002,0.42105263157894735,0.5,
2021,Boston Celtics,,Malik Fitts,195.58,104.32616,PF,15,63,8,19,0.421,5,10,0.5,0,0,0.0,2,15,17,5,0,0,2,4,21,11,5,0,-6,0,0,4.8,-6,-1.2000000000000002,0.42105263157894735,0.5,
2021,Boston Celtics,,Malik Fitts,195.58,104.32616,PF,15,63,8,19,0.421,5,10,0.5,0,0,0.0,2,15,17,5,0,0,2,4,21,11,5,0,-6,0,0,4.8,-6,-1.2000000000000002,0.42105263157894735,0.5,
2021,Boston Celtics,,Malik Fitts,195.58,104.32616,PF,15,63,8,19,0.421,5,10,0.5,0,0,0.0,2,15,17,5,0,0,2,4,21,11,5,0,-6,0,0,4.8,-6,-1.2000000000000002,0.42105263157894735,0.5,
2021,Boston Celtics,,Malik Fitts,195.58,104.32616,PF,15,63,8,19,0.421,5,10,0.5,0,0,0.0,2,15,17,5,0,0,2,4,21,11,5,0,-6,0,0,4.8,-6,-1.2000000000000002,0.42105263157894735,0.5,
2021,Boston Celtics,,Malik Fitts,195.58,104.32616,PF,15,63,8,19,0.421,5,10,0.5,0,0,0.0,2,15,17,5,0,0,2,4,21,11,5,0,-6,0,0,4.8,-6,-1.2000000000000002,0.42105263157894735,0.5,
2021,Boston Celtics,,Malik Fitts,195.58,104.32616,PF,15,63,8,19,0.421,5,10,0.5,0,0,0.0,2,15,17,5,0,0,2,4,21,11,5,0,-6,0,0,4.8,-6,-1.2000000000000002,0.42105263157894735,0.5,
2021,Boston Celtics,,Malik Fitts,195.58,104.32616,PF,15,63,8,19,0.421,5,10,0.5,0,0,0.0,2,15,17,5,0,0,2,4,21,11,5,0,-6,0,0,4.8,-6,-1.2000000000000002,0.42105263157894735,0.5,
2021,Boston Celtics,,Malik Fitts,195.58,104.32616,PF,15,63,8,19,0.421,5,10,0.5,0,0,0.0,2,15,17,5,0,0,2,4,21,11,5,0,-6,0,0,4.8,-6,-1.2000000000000002,0.42105263157894735,0.5,
2021,Milwaukee Bucks,Arkansas-Little Rock,Rayjon Tucker,190.5,94.800728,SG,5,71,6,9,0.667,4,5,0.8,5,7,0.714,3,5,8,10,4,0,1,5,21,3,1,2,6,9,3,6.5,18,24.5,0.6666666666666666,0.8,0.7142857142857143
2021,Milwaukee Bucks,Arkansas-Little Rock,Rayjon Tucker,190.5,94.800728,SG,5,71,6,9,0.667,4,5,0.8,5,7,0.714,3,5,8,10,4,0,1,5,21,3,1,2,6,9,3,6.5,18,24.5,0.6666666666666666,0.8,0.7142857142857143
2021,Milwaukee Bucks,Arkansas-Little Rock,Rayjon Tucker,190.5,94.800728,SG,5,71,6,9,0.667,4,5,0.8,5,7,0.714,3,5,8,10,4,0,1,5,21,3,1,2,6,9,3,6.5,18,24.5,0.6666666666666666,0.8,0.7142857142857143
2021,Milwaukee Bucks,Arkansas-Little Rock,Rayjon Tucker,190.5,94.800728,SG,5,71,6,9,0.667,4,5,0.8,5,7,0.714,3,5,8,10,4,0,1,5,21,3,1,2,6,9,3,6.5,18,24.5,0.6666666666666666,0.8,0.7142857142857143
2021,Milwaukee Bucks,Arkansas-Little Rock,Rayjon Tucker,190.5,94.800728,SG,5,71,6,9,0.667,4,5,0.8,5,7,0.714,3,5,8,10,4,0,1,5,21,3,1,2,6,9,3,6.5,18,24.5,0.6666666666666666,0.8,0.7142857142857143
2021,Milwaukee Bucks,Arkansas-Little Rock,Rayjon Tucker,190.5,94.800728,SG,5,71,6,9,0.667,4,5,0.8,5,7,0.714,3,5,8,10,4,0,1,5,21,3,1,2,6,9,3,6.5,18,24.5,0.6666666666666666,0.8,0.7142857142857143
2021,Milwaukee Bucks,Arkansas-Little Rock,Rayjon Tucker,190.5,94.800728,SG,5,71,6,9,0.667,4,5,0.8,5,7,0.714,3,5,8,10,4,0,1,5,21,3,1,2,6,9,3,6.5,18,24.5,0.6666666666666666,0.8,0.7142857142857143
2021,Milwaukee Bucks,Arkansas-Little Rock,Rayjon Tucker,190.5,94.800728,SG,5,71,6,9,0.667,4,5,0.8,5,7,0.714,3,5,8,10,4,0,1,5,21,3,1,2,6,9,3,6.5,18,24.5,0.6666666666666666,0.8,0.7142857142857143
2021,Milwaukee Bucks,Arkansas-Little Rock,Rayjon Tucker,190.5,94.800728,SG,5,71,6,9,0.667,4,5,0.8,5,7,0.714,3,5,8,10,4,0,1,5,21,3,1,2,6,9,3,6.5,18,24.5,0.6666666666666666,0.8,0.7142857142857143
2021,Washington Wizards,,Isaiah Todd,205.74,99.336648,PF,12,74,7,26,0.269,4,16,0.25,2,6,0.333,3,9,12,4,4,2,4,4,20,19,12,4,-24,-24,-2,5.55,-50,-44.45,0.2692307692307692,0.25,0.3333333333333333
2021,Washington Wizards,Duke,Vernon Carey Jr.,205.74,122.46984,C,7,44,7,13,0.538,0,0,0.0,6,13,0.462,8,4,12,0,2,1,3,4,20,6,0,7,2,0,-1,4.8,1,5.8,0.5384615384615384,,0.46153846153846156
2021,Washington Wizards,Duke,Vernon Carey Jr.,205.74,122.46984,C,7,44,7,13,0.538,0,0,0.0,6,13,0.462,8,4,12,0,2,1,3,4,20,6,0,7,2,0,-1,4.8,1,5.8,0.5384615384615384,,0.46153846153846156
2021,Washington Wizards,Duke,Vernon Carey Jr.,205.74,122.46984,C,7,44,7,13,0.538,0,0,0.0,6,13,0.462,8,4,12,0,2,1,3,4,20,6,0,7,2,0,-1,4.8,1,5.8,0.5384615384615384,,0.46153846153846156
2021,Washington Wizards,Duke,Vernon Carey Jr.,205.74,122.46984,C,7,44,7,13,0.538,0,0,0.0,6,13,0.462,8,4,12,0,2,1,3,4,20,6,0,7,2,0,-1,4.8,1,5.8,0.5384615384615384,,0.46153846153846156
2021,Washington Wizards,Duke,Vernon Carey Jr.,205.74,122.46984,C,7,44,7,13,0.538,0,0,0.0,6,13,0.462,8,4,12,0,2,1,3,4,20,6,0,7,2,0,-1,4.8,1,5.8,0.5384615384615384,,0.46153846153846156
2021,Washington Wizards,Duke,Vernon Carey Jr.,205.74,122.46984,C,7,44,7,13,0.538,0,0,0.0,6,13,0.462,8,4,12,0,2,1,3,4,20,6,0,7,2,0,-1,4.8,1,5.8,0.5384615384615384,,0.46153846153846156
2021,Washington Wizards,Duke,Vernon Carey Jr.,205.74,122.46984,C,7,44,7,13,0.538,0,0,0.0,6,13,0.462,8,4,12,0,2,1,3,4,20,6,0,7,2,0,-1,4.8,1,5.8,0.5384615384615384,,0.46153846153846156
2021,Washington Wizards,Duke,Vernon Carey Jr.,205.74,122.46984,C,7,44,7,13,0.538,0,0,0.0,6,13,0.462,8,4,12,0,2,1,3,4,20,6,0,7,2,0,-1,4.8,1,5.8,0.5384615384615384,,0.46153846153846156
2021,Washington Wizards,Duke,Vernon Carey Jr.,205.74,122.46984,C,7,44,7,13,0.538,0,0,0.0,6,13,0.462,8,4,12,0,2,1,3,4,20,6,0,7,2,0,-1,4.8,1,5.8,0.5384615384615384,,0.46153846153846156
2021,Oklahoma City Thunder,,Gabriel Deck,198.12,104.779752,PF,7,56,8,14,0.571,2,4,0.5,0,0,0.0,1,5,6,5,1,0,2,2,18,6,2,0,4,0,0,2.4,4,6.4,0.5714285714285714,0.5,
2021,Boston Celtics,Michigan,Nik Stauskas,198.12,93.893544,SG,8,39,5,14,0.357,4,10,0.4,4,6,0.667,1,2,3,2,0,0,1,1,18,9,6,2,-8,-6,2,0.95,-12,-11.05,0.35714285714285715,0.4,0.6666666666666666
2021,Boston Celtics,Michigan,Nik Stauskas,198.12,93.893544,SG,8,39,5,14,0.357,4,10,0.4,4,6,0.667,1,2,3,2,0,0,1,1,18,9,6,2,-8,-6,2,0.95,-12,-11.05,0.35714285714285715,0.4,0.6666666666666666
2021,Boston Celtics,Michigan,Nik Stauskas,198.12,93.893544,SG,8,39,5,14,0.357,4,10,0.4,4,6,0.667,1,2,3,2,0,0,1,1,18,9,6,2,-8,-6,2,0.95,-12,-11.05,0.35714285714285715,0.4,0.6666666666666666
2021,Boston Celtics,Michigan,Nik Stauskas,198.12,93.893544,SG,8,39,5,14,0.357,4,10,0.4,4,6,0.667,1,2,3,2,0,0,1,1,18,9,6,2,-8,-6,2,0.95,-12,-11.05,0.35714285714285715,0.4,0.6666666666666666
2021,Boston Celtics,Michigan,Nik Stauskas,198.12,93.893544,SG,8,39,5,14,0.357,4,10,0.4,4,6,0.667,1,2,3,2,0,0,1,1,18,9,6,2,-8,-6,2,0.95,-12,-11.05,0.35714285714285715,0.4,0.6666666666666666
2021,Boston Celtics,Michigan,Nik Stauskas,198.12,93.893544,SG,8,39,5,14,0.357,4,10,0.4,4,6,0.667,1,2,3,2,0,0,1,1,18,9,6,2,-8,-6,2,0.95,-12,-11.05,0.35714285714285715,0.4,0.6666666666666666
2021,Boston Celtics,Michigan,Nik Stauskas,198.12,93.893544,SG,8,39,5,14,0.357,4,10,0.4,4,6,0.667,1,2,3,2,0,0,1,1,18,9,6,2,-8,-6,2,0.95,-12,-11.05,0.35714285714285715,0.4,0.6666666666666666
2021,Boston Celtics,Michigan,Nik Stauskas,198.12,93.893544,SG,8,39,5,14,0.357,4,10,0.4,4,6,0.667,1,2,3,2,0,0,1,1,18,9,6,2,-8,-6,2,0.95,-12,-11.05,0.35714285714285715,0.4,0.6666666666666666
2021,Boston Celtics,Michigan,Nik Stauskas,198.12,93.893544,SG,8,39,5,14,0.357,4,10,0.4,4,6,0.667,1,2,3,2,0,0,1,1,18,9,6,2,-8,-6,2,0.95,-12,-11.05,0.35714285714285715,0.4,0.6666666666666666
2021,Chicago Bulls,,Marko Simonovic,210.82,99.79024,C,9,35,4,15,0.267,1,5,0.2,8,11,0.727,5,5,10,0,1,1,2,6,17,11,4,3,-14,-9,5,3.45,-18,-14.55,0.26666666666666666,0.2,0.7272727272727273
2021,San Antonio Spurs,Fresno State,Tyler Johnson,190.5,84.368112,PG,6,91,6,20,0.3,5,13,0.385,0,0,0.0,3,9,12,7,3,3,2,7,17,14,8,0,-16,-9,0,7.15,-25,-17.85,0.3,0.38461538461538464,
2021,San Antonio Spurs,Fresno State,Tyler Johnson,190.5,84.368112,PG,6,91,6,20,0.3,5,13,0.385,0,0,0.0,3,9,12,7,3,3,2,7,17,14,8,0,-16,-9,0,7.15,-25,-17.85,0.3,0.38461538461538464,
2021,San Antonio Spurs,Fresno State,Tyler Johnson,190.5,84.368112,PG,6,91,6,20,0.3,5,13,0.385,0,0,0.0,3,9,12,7,3,3,2,7,17,14,8,0,-16,-9,0,7.15,-25,-17.85,0.3,0.38461538461538464,
2021,San Antonio Spurs,Fresno State,Tyler Johnson,190.5,84.368112,PG,6,91,6,20,0.3,5,13,0.385,0,0,0.0,3,9,12,7,3,3,2,7,17,14,8,0,-16,-9,0,7.15,-25,-17.85,0.3,0.38461538461538464,
2021,San Antonio Spurs,Fresno State,Tyler Johnson,190.5,84.368112,PG,6,91,6,20,0.3,5,13,0.385,0,0,0.0,3,9,12,7,3,3,2,7,17,14,8,0,-16,-9,0,7.15,-25,-17.85,0.3,0.38461538461538464,
2021,San Antonio Spurs,Fresno State,Tyler Johnson,190.5,84.368112,PG,6,91,6,20,0.3,5,13,0.385,0,0,0.0,3,9,12,7,3,3,2,7,17,14,8,0,-16,-9,0,7.15,-25,-17.85,0.3,0.38461538461538464,
2021,San Antonio Spurs,Fresno State,Tyler Johnson,190.5,84.368112,PG,6,91,6,20,0.3,5,13,0.385,0,0,0.0,3,9,12,7,3,3,2,7,17,14,8,0,-16,-9,0,7.15,-25,-17.85,0.3,0.38461538461538464,
2021,San Antonio Spurs,Fresno State,Tyler Johnson,190.5,84.368112,PG,6,91,6,20,0.3,5,13,0.385,0,0,0.0,3,9,12,7,3,3,2,7,17,14,8,0,-16,-9,0,7.15,-25,-17.85,0.3,0.38461538461538464,
2021,San Antonio Spurs,Fresno State,Tyler Johnson,190.5,84.368112,PG,6,91,6,20,0.3,5,13,0.385,0,0,0.0,3,9,12,7,3,3,2,7,17,14,8,0,-16,-9,0,7.15,-25,-17.85,0.3,0.38461538461538464,
2021,New Orleans Pelicans,California,Tyrone Wallace,195.58,89.811216,SG,6,75,7,20,0.35,2,8,0.25,1,5,0.2,0,8,8,1,3,1,2,7,17,13,6,4,-12,-12,-3,2.9,-27,-24.1,0.35,0.25,0.2
2021,New York Knicks,Villanova,Ryan Arcidiacono,190.5,88.45044,PG,10,76,6,12,0.5,4,9,0.444,0,0,0.0,0,8,8,4,1,0,3,5,16,6,5,0,0,-3,0,1.75,-3,-1.25,0.5,0.4444444444444444,
2021,Phoenix Suns,UNC,Justin Jackson,203.2,99.79024,SF,7,36,5,15,0.333,3,9,0.333,2,2,1.0,1,6,7,2,0,0,1,3,15,10,6,0,-10,-9,2,1.85,-17,-15.15,0.3333333333333333,0.3333333333333333,1.0
2021,Phoenix Suns,UNC,Justin Jackson,203.2,99.79024,SF,7,36,5,15,0.333,3,9,0.333,2,2,1.0,1,6,7,2,0,0,1,3,15,10,6,0,-10,-9,2,1.85,-17,-15.15,0.3333333333333333,0.3333333333333333,1.0
2021,Phoenix Suns,UNC,Justin Jackson,203.2,99.79024,SF,7,36,5,15,0.333,3,9,0.333,2,2,1.0,1,6,7,2,0,0,1,3,15,10,6,0,-10,-9,2,1.85,-17,-15.15,0.3333333333333333,0.3333333333333333,1.0
2021,Phoenix Suns,UNC,Justin Jackson,203.2,99.79024,SF,7,36,5,15,0.333,3,9,0.333,2,2,1.0,1,6,7,2,0,0,1,3,15,10,6,0,-10,-9,2,1.85,-17,-15.15,0.3333333333333333,0.3333333333333333,1.0
2021,Phoenix Suns,UNC,Justin Jackson,203.2,99.79024,SF,7,36,5,15,0.333,3,9,0.333,2,2,1.0,1,6,7,2,0,0,1,3,15,10,6,0,-10,-9,2,1.85,-17,-15.15,0.3333333333333333,0.3333333333333333,1.0
2021,Phoenix Suns,UNC,Justin Jackson,203.2,99.79024,SF,7,36,5,15,0.333,3,9,0.333,2,2,1.0,1,6,7,2,0,0,1,3,15,10,6,0,-10,-9,2,1.85,-17,-15.15,0.3333333333333333,0.3333333333333333,1.0
2021,Phoenix Suns,UNC,Justin Jackson,203.2,99.79024,SF,7,36,5,15,0.333,3,9,0.333,2,2,1.0,1,6,7,2,0,0,1,3,15,10,6,0,-10,-9,2,1.85,-17,-15.15,0.3333333333333333,0.3333333333333333,1.0
2021,Phoenix Suns,UNC,Justin Jackson,203.2,99.79024,SF,7,36,5,15,0.333,3,9,0.333,2,2,1.0,1,6,7,2,0,0,1,3,15,10,6,0,-10,-9,2,1.85,-17,-15.15,0.3333333333333333,0.3333333333333333,1.0
2021,Phoenix Suns,UNC,Justin Jackson,203.2,99.79024,SF,7,36,5,15,0.333,3,9,0.333,2,2,1.0,1,6,7,2,0,0,1,3,15,10,6,0,-10,-9,2,1.85,-17,-15.15,0.3333333333333333,0.3333333333333333,1.0
2021,Cleveland Cavaliers,TCU,RJ Nembhard Jr.,193.04,90.7184,SG,14,63,6,18,0.333,0,2,0.0,3,4,0.75,3,4,7,12,1,0,3,2,15,12,2,1,-12,-6,2,4.4,-16,-11.6,0.3333333333333333,0.0,0.75
2021,Orlando Magic,Wisconsin,Aleem Ford,203.2,99.79024,SF,5,74,6,20,0.3,2,15,0.133,0,0,0.0,2,13,15,2,1,0,4,7,14,14,13,0,-16,-33,0,2.9,-49,-46.1,0.3,0.13333333333333333,
2021,Portland Trail Blazers,Oklahoma State,Cameron McGriff,200.66,99.79024,SF,3,46,5,14,0.357,2,6,0.333,2,2,1.0,6,9,15,3,0,1,0,7,14,9,4,0,-8,-6,2,6.15,-12,-5.85,0.35714285714285715,0.3333333333333333,1.0
2021,Washington Wizards,Michigan State,Cassius Winston,185.42,83.91452,PG,7,39,4,11,0.364,2,6,0.333,4,4,1.0,0,1,1,7,0,0,3,9,14,7,4,0,-6,-6,4,0.04999999999999999,-8,-7.95,0.36363636363636365,0.3333333333333333,1.0
2021,Milwaukee Bucks,St. Joseph's (PA),Langston Galloway,185.42,90.7184,SG,7,107,6,26,0.231,2,16,0.125,0,0,0.0,3,15,18,12,1,0,6,7,14,20,14,0,-28,-36,0,5.4,-64,-58.6,0.23076923076923078,0.125,
2021,Milwaukee Bucks,St. Joseph's (PA),Langston Galloway,185.42,90.7184,SG,7,107,6,26,0.231,2,16,0.125,0,0,0.0,3,15,18,12,1,0,6,7,14,20,14,0,-28,-36,0,5.4,-64,-58.6,0.23076923076923078,0.125,
2021,Milwaukee Bucks,St. Joseph's (PA),Langston Galloway,185.42,90.7184,SG,7,107,6,26,0.231,2,16,0.125,0,0,0.0,3,15,18,12,1,0,6,7,14,20,14,0,-28,-36,0,5.4,-64,-58.6,0.23076923076923078,0.125,
2021,Milwaukee Bucks,St. Joseph's (PA),Langston Galloway,185.42,90.7184,SG,7,107,6,26,0.231,2,16,0.125,0,0,0.0,3,15,18,12,1,0,6,7,14,20,14,0,-28,-36,0,5.4,-64,-58.6,0.23076923076923078,0.125,
2021,Milwaukee Bucks,St. Joseph's (PA),Langston Galloway,185.42,90.7184,SG,7,107,6,26,0.231,2,16,0.125,0,0,0.0,3,15,18,12,1,0,6,7,14,20,14,0,-28,-36,0,5.4,-64,-58.6,0.23076923076923078,0.125,
2021,Milwaukee Bucks,St. Joseph's (PA),Langston Galloway,185.42,90.7184,SG,7,107,6,26,0.231,2,16,0.125,0,0,0.0,3,15,18,12,1,0,6,7,14,20,14,0,-28,-36,0,5.4,-64,-58.6,0.23076923076923078,0.125,
2021,Milwaukee Bucks,St. Joseph's (PA),Langston Galloway,185.42,90.7184,SG,7,107,6,26,0.231,2,16,0.125,0,0,0.0,3,15,18,12,1,0,6,7,14,20,14,0,-28,-36,0,5.4,-64,-58.6,0.23076923076923078,0.125,
2021,Milwaukee Bucks,St. Joseph's (PA),Langston Galloway,185.42,90.7184,SG,7,107,6,26,0.231,2,16,0.125,0,0,0.0,3,15,18,12,1,0,6,7,14,20,14,0,-28,-36,0,5.4,-64,-58.6,0.23076923076923078,0.125,
2021,Milwaukee Bucks,St. Joseph's (PA),Langston Galloway,185.42,90.7184,SG,7,107,6,26,0.231,2,16,0.125,0,0,0.0,3,15,18,12,1,0,6,7,14,20,14,0,-28,-36,0,5.4,-64,-58.6,0.23076923076923078,0.125,
2021,Denver Nuggets,,Petr Cornelie,210.82,99.79024,PF,13,38,5,15,0.333,1,8,0.125,3,4,0.75,7,7,14,3,1,1,4,7,14,10,7,1,-10,-18,2,4.65,-26,-21.35,0.3333333333333333,0.125,0.75
2021,Los Angeles Lakers,,Sekou Doumbouya,205.74,104.32616,PF,2,16,5,8,0.625,1,2,0.5,3,4,0.75,2,4,6,0,3,2,2,1,14,3,1,1,4,0,2,3.45,6,9.45,0.625,0.5,0.75
2021,Phoenix Suns,,Gabriel Lundberg,193.04,92.079176,SG,4,44,5,19,0.263,3,8,0.375,0,0,0.0,2,5,7,11,3,0,3,7,13,14,5,0,-18,-6,0,4.65,-24,-19.35,0.2631578947368421,0.375,
2021,Miami Heat,Kansas,Marcus Garrett,195.58,92.98636,SG,12,128,5,21,0.238,1,4,0.25,2,5,0.4,9,14,23,7,5,3,2,16,13,16,3,3,-22,-6,-1,11.95,-29,-17.05,0.23809523809523808,0.25,0.4
2021,Philadelphia 76ers,Seton Hall,Myles Powell,187.96,88.45044,PG,11,52,5,17,0.294,1,6,0.167,2,2,1.0,1,5,6,3,1,0,3,8,13,12,5,0,-14,-12,2,1.1,-24,-22.9,0.29411764705882354,0.16666666666666666,1.0
2021,Memphis Grizzlies,Tennessee,Yves Pons,195.58,93.439952,SF,12,71,5,16,0.313,3,9,0.333,0,2,0.0,5,7,12,1,1,4,1,6,13,11,6,2,-12,-9,-2,6.2,-23,-16.8,0.3125,0.3333333333333333,0.0
2021,Toronto Raptors,,Isaac Bonga,203.2,81.64656,SF,15,69,3,13,0.231,1,4,0.25,5,8,0.625,4,3,7,4,8,2,2,10,12,10,3,3,-14,-6,2,7.25,-18,-10.75,0.23076923076923078,0.25,0.625
2021,Detroit Pistons,Wisconsin,Micah Potter,208.28,112.490816,C,3,31,5,11,0.455,0,2,0.0,2,2,1.0,4,5,9,0,1,1,1,4,12,6,2,0,-2,-6,2,3.55,-6,-2.45,0.45454545454545453,0.0,1.0
2021,Cleveland Cavaliers,UCF,Tacko Fall,228.6,141.067112,C,11,59,5,12,0.417,0,0,0.0,2,7,0.286,7,16,23,2,0,6,3,3,12,7,0,5,-4,0,-3,9.35,-7,2.3499999999999996,0.4166666666666667,,0.2857142857142857
2021,Detroit Pistons,Kansas,Cheick Diallo,203.2,99.336648,C,3,31,3,8,0.375,0,0,0.0,5,6,0.833,4,8,12,0,1,0,1,6,11,5,0,1,-4,0,4,3.7,0,3.7,0.375,,0.8333333333333334
2021,Washington Wizards,LSU,Tremont Waters,177.8,79.3786,PG,3,50,4,14,0.286,2,9,0.222,0,0,0.0,0,4,4,7,5,0,4,4,10,10,7,0,-12,-15,0,3.05,-27,-23.95,0.2857142857142857,0.2222222222222222,
2021,Washington Wizards,LSU,Tremont Waters,177.8,79.3786,PG,3,50,4,14,0.286,2,9,0.222,0,0,0.0,0,4,4,7,5,0,4,4,10,10,7,0,-12,-15,0,3.05,-27,-23.95,0.2857142857142857,0.2222222222222222,
2021,Washington Wizards,LSU,Tremont Waters,177.8,79.3786,PG,3,50,4,14,0.286,2,9,0.222,0,0,0.0,0,4,4,7,5,0,4,4,10,10,7,0,-12,-15,0,3.05,-27,-23.95,0.2857142857142857,0.2222222222222222,
2021,Washington Wizards,LSU,Tremont Waters,177.8,79.3786,PG,3,50,4,14,0.286,2,9,0.222,0,0,0.0,0,4,4,7,5,0,4,4,10,10,7,0,-12,-15,0,3.05,-27,-23.95,0.2857142857142857,0.2222222222222222,
2021,Washington Wizards,LSU,Tremont Waters,177.8,79.3786,PG,3,50,4,14,0.286,2,9,0.222,0,0,0.0,0,4,4,7,5,0,4,4,10,10,7,0,-12,-15,0,3.05,-27,-23.95,0.2857142857142857,0.2222222222222222,
2021,Washington Wizards,LSU,Tremont Waters,177.8,79.3786,PG,3,50,4,14,0.286,2,9,0.222,0,0,0.0,0,4,4,7,5,0,4,4,10,10,7,0,-12,-15,0,3.05,-27,-23.95,0.2857142857142857,0.2222222222222222,
2021,Washington Wizards,LSU,Tremont Waters,177.8,79.3786,PG,3,50,4,14,0.286,2,9,0.222,0,0,0.0,0,4,4,7,5,0,4,4,10,10,7,0,-12,-15,0,3.05,-27,-23.95,0.2857142857142857,0.2222222222222222,
2021,Washington Wizards,LSU,Tremont Waters,177.8,79.3786,PG,3,50,4,14,0.286,2,9,0.222,0,0,0.0,0,4,4,7,5,0,4,4,10,10,7,0,-12,-15,0,3.05,-27,-23.95,0.2857142857142857,0.2222222222222222,
2021,Washington Wizards,LSU,Tremont Waters,177.8,79.3786,PG,3,50,4,14,0.286,2,9,0.222,0,0,0.0,0,4,4,7,5,0,4,4,10,10,7,0,-12,-15,0,3.05,-27,-23.95,0.2857142857142857,0.2222222222222222,
2021,Toronto Raptors,Minnesota,Daniel Oturu,203.2,108.86208,C,3,27,3,6,0.5,0,1,0.0,3,5,0.6,1,4,5,0,0,2,0,1,9,3,1,2,0,-3,1,2.45,-2,0.4500000000000002,0.5,0.0,0.6
2021,Indiana Pacers,Arizona,Gabe York,190.5,86.18248,SG,2,21,2,7,0.286,1,6,0.167,3,5,0.6,0,2,2,4,2,1,1,4,8,5,5,2,-6,-12,1,2.3,-17,-14.7,0.2857142857142857,0.16666666666666666,0.6
2021,Los Angeles Lakers,Texas Tech,Mac McClung,187.96,83.91452,SG,2,24,3,6,0.5,1,3,0.333,1,1,1.0,0,3,3,1,1,1,3,5,8,3,2,0,0,-3,1,0.25,-2,-1.75,0.5,0.3333333333333333,1.0
2021,Los Angeles Lakers,Texas Tech,Mac McClung,187.96,83.91452,SG,2,24,3,6,0.5,1,3,0.333,1,1,1.0,0,3,3,1,1,1,3,5,8,3,2,0,0,-3,1,0.25,-2,-1.75,0.5,0.3333333333333333,1.0
2021,Los Angeles Lakers,Texas Tech,Mac McClung,187.96,83.91452,SG,2,24,3,6,0.5,1,3,0.333,1,1,1.0,0,3,3,1,1,1,3,5,8,3,2,0,0,-3,1,0.25,-2,-1.75,0.5,0.3333333333333333,1.0
2021,Los Angeles Lakers,Texas Tech,Mac McClung,187.96,83.91452,PG,2,24,3,6,0.5,1,3,0.333,1,1,1.0,0,3,3,1,1,1,3,5,8,3,2,0,0,-3,1,0.25,-2,-1.75,0.5,0.3333333333333333,1.0
2021,Los Angeles Lakers,Texas Tech,Mac McClung,187.96,83.91452,PG,2,24,3,6,0.5,1,3,0.333,1,1,1.0,0,3,3,1,1,1,3,5,8,3,2,0,0,-3,1,0.25,-2,-1.75,0.5,0.3333333333333333,1.0
2021,Los Angeles Lakers,Texas Tech,Mac McClung,187.96,83.91452,PG,2,24,3,6,0.5,1,3,0.333,1,1,1.0,0,3,3,1,1,1,3,5,8,3,2,0,0,-3,1,0.25,-2,-1.75,0.5,0.3333333333333333,1.0
2021,Los Angeles Lakers,Texas Tech,Mac McClung,187.96,83.91452,SG,2,24,3,6,0.5,1,3,0.333,1,1,1.0,0,3,3,1,1,1,3,5,8,3,2,0,0,-3,1,0.25,-2,-1.75,0.5,0.3333333333333333,1.0
2021,Los Angeles Lakers,Texas Tech,Mac McClung,187.96,83.91452,SG,2,24,3,6,0.5,1,3,0.333,1,1,1.0,0,3,3,1,1,1,3,5,8,3,2,0,0,-3,1,0.25,-2,-1.75,0.5,0.3333333333333333,1.0
2021,Los Angeles Lakers,Texas Tech,Mac McClung,187.96,83.91452,SG,2,24,3,6,0.5,1,3,0.333,1,1,1.0,0,3,3,1,1,1,3,5,8,3,2,0,0,-3,1,0.25,-2,-1.75,0.5,0.3333333333333333,1.0
2021,Cleveland Cavaliers,Kansas,Malik Newman,190.5,86.18248,PG,1,8,3,5,0.6,0,1,0.0,2,2,1.0,0,1,1,1,0,0,1,0,8,2,1,0,2,-3,2,0.0,1,1.0,0.6,0.0,1.0
2021,Atlanta Hawks,Arizona,Solomon Hill,198.12,102.511792,SF,13,139,3,20,0.15,2,13,0.154,0,0,0.0,6,17,23,12,4,2,1,16,8,17,11,0,-28,-27,0,11.95,-55,-43.05,0.15,0.15384615384615385,
2021,Dallas Mavericks,Oregon,Eugene Omoruyi,198.12,106.59412,SF,4,18,2,5,0.4,1,2,0.5,2,4,0.5,2,5,7,2,0,0,0,2,7,3,1,2,-2,0,0,2.65,-2,0.6499999999999999,0.4,0.5,0.5
2021,San Antonio Spurs,Mississippi State,Robert Woodard II,198.12,106.59412,SF,12,42,2,16,0.125,1,4,0.25,2,2,1.0,5,6,11,3,1,1,1,3,7,14,3,0,-24,-6,2,5.1,-28,-22.9,0.125,0.25,1.0
2021,Atlanta Hawks,Auburn,Sharife Cooper,185.42,79.83219199999998,PG,13,39,3,14,0.214,1,6,0.167,0,0,0.0,0,5,5,5,0,0,5,1,7,11,5,0,-16,-12,0,-0.05,-28,-28.05,0.21428571428571427,0.16666666666666666,
2021,Washington Wizards,Mississippi State,Craig Sword,190.5,88.904032,SG,3,19,3,4,0.75,0,1,0.0,0,0,0.0,0,0,0,1,4,0,1,7,6,1,1,0,4,-3,0,1.4,1,2.4,0.75,0.0,
2021,Memphis Grizzlies,Purdue,Dakota Mathias,193.04,90.7184,SG,6,16,2,6,0.333,2,6,0.333,0,0,0.0,0,2,2,1,1,0,0,1,6,4,4,0,-4,-6,0,1.2,-10,-8.8,0.3333333333333333,0.3333333333333333,
2021,Utah Jazz,Iona,Norvel Pelle,208.28,104.779752,C,3,19,3,5,0.6,0,0,0.0,0,0,0.0,3,3,6,0,0,1,2,1,6,2,0,0,2,0,0,1.7,2,3.7,0.6,,
2021,Phoenix Suns,Detroit Mercy,Paris Bass,203.2,90.7184,SF,2,7,2,6,0.333,0,2,0.0,2,2,1.0,2,2,4,0,1,0,2,2,6,4,2,0,-4,-6,2,0.9,-8,-7.1,0.3333333333333333,0.0,1.0
2021,Washington Wizards,San Diego State,Jordan Schakel,198.12,90.7184,SG,4,30,1,11,0.091,1,6,0.167,2,2,1.0,2,6,8,0,1,0,1,0,5,10,5,0,-18,-12,2,2.5,-28,-25.5,0.09090909090909091,0.16666666666666666,1.0
2021,Boston Celtics,Indiana,Juwan Morgan,200.66,105.233344,PF,2,31,2,3,0.667,1,2,0.5,0,0,0.0,2,2,4,1,0,0,0,3,5,1,1,0,2,0,0,1.6,2,3.6,0.6666666666666666,0.5,
2021,Boston Celtics,Indiana,Juwan Morgan,200.66,105.233344,PF,2,31,2,3,0.667,1,2,0.5,0,0,0.0,2,2,4,1,0,0,0,3,5,1,1,0,2,0,0,1.6,2,3.6,0.6666666666666666,0.5,
2021,Boston Celtics,Indiana,Juwan Morgan,200.66,105.233344,PF,2,31,2,3,0.667,1,2,0.5,0,0,0.0,2,2,4,1,0,0,0,3,5,1,1,0,2,0,0,1.6,2,3.6,0.6666666666666666,0.5,
2021,Boston Celtics,Indiana,Juwan Morgan,200.66,105.233344,PF,2,31,2,3,0.667,1,2,0.5,0,0,0.0,2,2,4,1,0,0,0,3,5,1,1,0,2,0,0,1.6,2,3.6,0.6666666666666666,0.5,
2021,Boston Celtics,Indiana,Juwan Morgan,200.66,105.233344,PF,2,31,2,3,0.667,1,2,0.5,0,0,0.0,2,2,4,1,0,0,0,3,5,1,1,0,2,0,0,1.6,2,3.6,0.6666666666666666,0.5,
2021,Boston Celtics,Indiana,Juwan Morgan,200.66,105.233344,PF,2,31,2,3,0.667,1,2,0.5,0,0,0.0,2,2,4,1,0,0,0,3,5,1,1,0,2,0,0,1.6,2,3.6,0.6666666666666666,0.5,
2021,Boston Celtics,Indiana,Juwan Morgan,200.66,105.233344,PF,2,31,2,3,0.667,1,2,0.5,0,0,0.0,2,2,4,1,0,0,0,3,5,1,1,0,2,0,0,1.6,2,3.6,0.6666666666666666,0.5,
2021,Boston Celtics,Indiana,Juwan Morgan,200.66,105.233344,PF,2,31,2,3,0.667,1,2,0.5,0,0,0.0,2,2,4,1,0,0,0,3,5,1,1,0,2,0,0,1.6,2,3.6,0.6666666666666666,0.5,
2021,Boston Celtics,Indiana,Juwan Morgan,200.66,105.233344,PF,2,31,2,3,0.667,1,2,0.5,0,0,0.0,2,2,4,1,0,0,0,3,5,1,1,0,2,0,0,1.6,2,3.6,0.6666666666666666,0.5,
2021,Minnesota Timberwolves,Colorado,McKinley Wright IV,180.34,87.089664,PG,5,19,2,3,0.667,1,2,0.5,0,0,0.0,0,0,0,3,0,0,1,1,5,1,1,0,2,0,0,0.2,2,2.2,0.6666666666666666,0.5,
2021,Utah Jazz,Yale,Miye Oni,195.58,93.439952,SG,16,44,2,9,0.222,1,8,0.125,0,1,0.0,1,6,7,5,0,0,1,7,5,7,7,1,-10,-18,-1,2.4,-29,-26.6,0.2222222222222222,0.125,0.0
2021,Dallas Mavericks,Georgia Tech,Moses Wright,203.2,102.511792,PF,4,15,1,4,0.25,0,1,0.0,3,3,1.0,1,2,3,2,0,1,0,0,5,3,1,0,-4,-3,3,2.0,-4,-2.0,0.25,0.0,1.0
2021,Dallas Mavericks,Georgia Tech,Moses Wright,203.2,102.511792,PF,4,15,1,4,0.25,0,1,0.0,3,3,1.0,1,2,3,2,0,1,0,0,5,3,1,0,-4,-3,3,2.0,-4,-2.0,0.25,0.0,1.0
2021,Dallas Mavericks,Georgia Tech,Moses Wright,203.2,102.511792,PF,4,15,1,4,0.25,0,1,0.0,3,3,1.0,1,2,3,2,0,1,0,0,5,3,1,0,-4,-3,3,2.0,-4,-2.0,0.25,0.0,1.0
2021,Dallas Mavericks,Georgia Tech,Moses Wright,203.2,102.511792,PF,4,15,1,4,0.25,0,1,0.0,3,3,1.0,1,2,3,2,0,1,0,0,5,3,1,0,-4,-3,3,2.0,-4,-2.0,0.25,0.0,1.0
2021,Dallas Mavericks,Georgia Tech,Moses Wright,203.2,102.511792,PF,4,15,1,4,0.25,0,1,0.0,3,3,1.0,1,2,3,2,0,1,0,0,5,3,1,0,-4,-3,3,2.0,-4,-2.0,0.25,0.0,1.0
2021,Dallas Mavericks,Georgia Tech,Moses Wright,203.2,102.511792,PF,4,15,1,4,0.25,0,1,0.0,3,3,1.0,1,2,3,2,0,1,0,0,5,3,1,0,-4,-3,3,2.0,-4,-2.0,0.25,0.0,1.0
2021,Dallas Mavericks,Georgia Tech,Moses Wright,203.2,102.511792,PF,4,15,1,4,0.25,0,1,0.0,3,3,1.0,1,2,3,2,0,1,0,0,5,3,1,0,-4,-3,3,2.0,-4,-2.0,0.25,0.0,1.0
2021,Dallas Mavericks,Georgia Tech,Moses Wright,203.2,102.511792,PF,4,15,1,4,0.25,0,1,0.0,3,3,1.0,1,2,3,2,0,1,0,0,5,3,1,0,-4,-3,3,2.0,-4,-2.0,0.25,0.0,1.0
2021,Dallas Mavericks,Georgia Tech,Moses Wright,203.2,102.511792,PF,4,15,1,4,0.25,0,1,0.0,3,3,1.0,1,2,3,2,0,1,0,0,5,3,1,0,-4,-3,3,2.0,-4,-2.0,0.25,0.0,1.0
2021,New York Knicks,Kansas,Wayne Selden,193.04,105.233344,SG,3,19,1,4,0.25,1,2,0.5,2,4,0.5,0,1,1,1,0,0,0,1,5,3,1,2,-4,0,0,0.45,-4,-3.55,0.25,0.5,0.5
2021,Utah Jazz,Kansas State,Xavier Sneed,195.58,97.52228,SF,9,39,2,10,0.2,1,8,0.125,0,0,0.0,2,4,6,1,0,0,0,2,5,8,7,0,-12,-18,0,2.15,-30,-27.85,0.2,0.125,
2021,Utah Jazz,Kansas State,Xavier Sneed,195.58,97.52228,SF,9,39,2,10,0.2,1,8,0.125,0,0,0.0,2,4,6,1,0,0,0,2,5,8,7,0,-12,-18,0,2.15,-30,-27.85,0.2,0.125,
2021,Utah Jazz,Kansas State,Xavier Sneed,195.58,97.52228,SF,9,39,2,10,0.2,1,8,0.125,0,0,0.0,2,4,6,1,0,0,0,2,5,8,7,0,-12,-18,0,2.15,-30,-27.85,0.2,0.125,
2021,Utah Jazz,Kansas State,Xavier Sneed,195.58,97.52228,SF,9,39,2,10,0.2,1,8,0.125,0,0,0.0,2,4,6,1,0,0,0,2,5,8,7,0,-12,-18,0,2.15,-30,-27.85,0.2,0.125,
2021,Utah Jazz,Kansas State,Xavier Sneed,195.58,97.52228,SF,9,39,2,10,0.2,1,8,0.125,0,0,0.0,2,4,6,1,0,0,0,2,5,8,7,0,-12,-18,0,2.15,-30,-27.85,0.2,0.125,
2021,Utah Jazz,Kansas State,Xavier Sneed,195.58,97.52228,SF,9,39,2,10,0.2,1,8,0.125,0,0,0.0,2,4,6,1,0,0,0,2,5,8,7,0,-12,-18,0,2.15,-30,-27.85,0.2,0.125,
2021,Utah Jazz,Kansas State,Xavier Sneed,195.58,97.52228,SF,9,39,2,10,0.2,1,8,0.125,0,0,0.0,2,4,6,1,0,0,0,2,5,8,7,0,-12,-18,0,2.15,-30,-27.85,0.2,0.125,
2021,Utah Jazz,Kansas State,Xavier Sneed,195.58,97.52228,SF,9,39,2,10,0.2,1,8,0.125,0,0,0.0,2,4,6,1,0,0,0,2,5,8,7,0,-12,-18,0,2.15,-30,-27.85,0.2,0.125,
2021,Utah Jazz,Kansas State,Xavier Sneed,195.58,97.52228,SF,9,39,2,10,0.2,1,8,0.125,0,0,0.0,2,4,6,1,0,0,0,2,5,8,7,0,-12,-18,0,2.15,-30,-27.85,0.2,0.125,
2021,Denver Nuggets,Texas Legends,Carlik Jones,182.88,78.92500799999999,PG,5,23,1,9,0.111,0,1,0.0,2,2,1.0,1,2,3,5,1,0,3,0,4,8,1,0,-14,-3,2,1.25,-15,-13.75,0.1111111111111111,0.0,1.0
2021,Denver Nuggets,Texas Legends,Carlik Jones,182.88,78.92500799999999,PG,5,23,1,9,0.111,0,1,0.0,2,2,1.0,1,2,3,5,1,0,3,0,4,8,1,0,-14,-3,2,1.25,-15,-13.75,0.1111111111111111,0.0,1.0
2021,Denver Nuggets,Texas Legends,Carlik Jones,182.88,78.92500799999999,PG,5,23,1,9,0.111,0,1,0.0,2,2,1.0,1,2,3,5,1,0,3,0,4,8,1,0,-14,-3,2,1.25,-15,-13.75,0.1111111111111111,0.0,1.0
2021,Denver Nuggets,Texas Legends,Carlik Jones,182.88,78.92500799999999,PG,5,23,1,9,0.111,0,1,0.0,2,2,1.0,1,2,3,5,1,0,3,0,4,8,1,0,-14,-3,2,1.25,-15,-13.75,0.1111111111111111,0.0,1.0
2021,Denver Nuggets,Texas Legends,Carlik Jones,182.88,78.92500799999999,PG,5,23,1,9,0.111,0,1,0.0,2,2,1.0,1,2,3,5,1,0,3,0,4,8,1,0,-14,-3,2,1.25,-15,-13.75,0.1111111111111111,0.0,1.0
2021,Denver Nuggets,Texas Legends,Carlik Jones,182.88,78.92500799999999,PG,5,23,1,9,0.111,0,1,0.0,2,2,1.0,1,2,3,5,1,0,3,0,4,8,1,0,-14,-3,2,1.25,-15,-13.75,0.1111111111111111,0.0,1.0
2021,Denver Nuggets,Texas Legends,Carlik Jones,182.88,78.92500799999999,PG,5,23,1,9,0.111,0,1,0.0,2,2,1.0,1,2,3,5,1,0,3,0,4,8,1,0,-14,-3,2,1.25,-15,-13.75,0.1111111111111111,0.0,1.0
2021,Denver Nuggets,Texas Legends,Carlik Jones,182.88,78.92500799999999,PG,5,23,1,9,0.111,0,1,0.0,2,2,1.0,1,2,3,5,1,0,3,0,4,8,1,0,-14,-3,2,1.25,-15,-13.75,0.1111111111111111,0.0,1.0
2021,Denver Nuggets,Texas Legends,Carlik Jones,182.88,78.92500799999999,PG,5,23,1,9,0.111,0,1,0.0,2,2,1.0,1,2,3,5,1,0,3,0,4,8,1,0,-14,-3,2,1.25,-15,-13.75,0.1111111111111111,0.0,1.0
2021,Phoenix Suns,Boise State,Chandler Hutchison,198.12,95.25432,SF,6,22,1,2,0.5,0,0,0.0,2,2,1.0,0,5,5,2,0,0,4,1,4,1,0,0,0,0,2,-0.3,2,1.7,0.5,,1.0
2021,New York Knicks,Houston,Damyean Dotson,195.58,95.25432,SG,2,21,2,4,0.5,0,1,0.0,0,0,0.0,0,2,2,1,0,0,0,0,4,2,1,0,0,-3,0,0.75,-3,-2.25,0.5,0.0,
2021,Los Angeles Lakers,UCLA,Darren Collison,182.88,72.57472,PG,3,37,2,7,0.286,0,3,0.0,0,0,0.0,0,4,4,2,1,0,1,5,4,5,3,0,-6,-9,0,1.25,-15,-13.75,0.2857142857142857,0.0,
2021,Los Angeles Lakers,New Mexico State,Jemerrio Jones,195.58,79.3786,SF,2,15,2,3,0.667,0,0,0.0,0,0,0.0,2,1,3,0,1,0,0,2,4,1,0,0,2,0,0,1.65,2,3.65,0.6666666666666666,,
2021,Oklahoma City Thunder,Tennessee,Scotty Hopson,200.66,92.532768,SG,1,18,2,4,0.5,0,1,0.0,0,0,0.0,0,1,1,1,0,0,2,1,4,2,1,0,0,-3,0,-0.55,-3,-3.55,0.5,0.0,
2021,Brooklyn Nets,Tulsa,Shaquille Harrison,193.04,88.45044,SG,2,23,2,6,0.333,0,2,0.0,0,0,0.0,1,3,4,3,1,1,2,3,4,4,2,0,-4,-6,0,1.85,-10,-8.15,0.3333333333333333,0.0,
2021,Detroit Pistons,,Deividas Sirvydis,203.2,86.18248,SG,3,27,1,10,0.1,1,7,0.143,0,0,0.0,0,6,6,1,3,1,0,4,3,9,6,0,-16,-15,0,3.55,-31,-27.45,0.1,0.14285714285714285,
2021,Sacramento Kings,,Emmanuel Mudiay,190.5,90.7184,PG,2,11,0,2,0.0,0,0,0.0,3,4,0.75,0,0,0,4,1,0,1,1,3,2,0,1,-4,0,2,0.95,-2,-1.05,0.0,,0.75
2021,Boston Celtics,Tennessee-Chattanooga,Matt Ryan,200.66,97.52228,SF,1,5,1,5,0.2,1,5,0.2,0,0,0.0,0,0,0,0,1,0,0,0,3,4,4,0,-6,-9,0,0.5,-15,-14.5,0.2,0.2,
2021,Oklahoma City Thunder,Arizona State,Rob Edwards,195.58,92.98636,SG,2,11,1,4,0.25,1,4,0.25,0,0,0.0,0,3,3,0,0,0,1,0,3,3,3,0,-4,-6,0,0.25,-10,-9.75,0.25,0.25,
2021,Philadelphia 76ers,Michigan State,Aaron Henry,195.58,95.25432,SF,6,17,1,5,0.2,0,1,0.0,0,0,0.0,0,1,1,0,0,2,2,2,2,4,1,0,-6,-3,0,0.15,-9,-8.85,0.2,0.0,
2021,Indiana Pacers,Old Dominion,Ahmad Caver,187.96,78.92500799999999,SG,1,1,1,1,1.0,0,0,0.0,0,0,0.0,0,0,0,0,0,0,0,0,2,0,0,0,2,0,0,0.0,2,2.0,1.0,,
2021,Memphis Grizzlies,Tulsa,DaQuan Jeffries,195.58,100.697424,SG,3,9,1,2,0.5,0,1,0.0,0,0,0.0,0,2,2,1,0,0,0,1,2,1,1,0,0,-3,0,0.7,-3,-2.3,0.5,0.0,
2021,Philadelphia 76ers,Tennessee,Jaden Springer,193.04,91.625584,SG,2,6,1,1,1.0,0,0,0.0,0,0,0.0,1,1,2,0,0,2,1,0,2,0,0,0,2,0,0,1.25,2,3.25,1.0,,
2021,Portland Trail Blazers,Cincinnati,Jarron Cumberland,195.58,92.98636,SG,3,12,1,2,0.5,0,1,0.0,0,0,0.0,1,2,3,1,0,0,0,2,2,1,1,0,0,-3,0,1.15,-3,-1.85,0.5,0.0,
2021,San Antonio Spurs,Molloy,Jaylen Morris,195.58,83.91452,SG,3,16,0,6,0.0,0,2,0.0,2,4,0.5,0,2,2,2,0,0,1,2,2,6,2,2,-12,-6,0,0.4,-18,-17.6,0.0,0.0,0.5
2021,Boston Celtics,Arkansas,Joe Johnson,200.66,108.86208,SG,1,2,1,1,1.0,0,0,0.0,0,0,0.0,0,0,0,0,0,0,0,0,2,0,0,0,2,0,0,0.0,2,2.0,1.0,,
2021,Washington Wizards,Gonzaga,Joel Ayayi,193.04,81.64656,SG,7,20,1,6,0.167,0,1,0.0,0,0,0.0,1,2,3,4,0,0,0,0,2,5,1,0,-8,-3,0,2.0,-11,-9.0,0.16666666666666666,0.0,
2021,Memphis Grizzlies,Murray State,Shaq Buchanan,190.5,86.18248,SG,2,10,1,4,0.25,0,2,0.0,0,0,0.0,1,1,2,2,1,0,2,1,2,3,2,0,-4,-6,0,0.7,-10,-9.3,0.25,0.0,
2021,Memphis Grizzlies,Stanford,Tyrell Terry,187.96,72.57472,PG,2,3,1,1,1.0,0,0,0.0,0,0,0.0,0,0,0,0,0,0,0,1,2,0,0,0,2,0,0,-0.05,2,1.95,1.0,,
2021,Dallas Mavericks,Colorado,George King,198.12,99.79024,SF,4,19,0,5,0.0,0,4,0.0,1,2,0.5,0,5,5,0,0,0,1,4,1,5,4,1,-10,-12,0,0.55,-22,-21.45,0.0,0.0,0.5
2021,Charlotte Hornets,Florida,Scottie Lewis,195.58,83.91452,SG,2,7,0,0,0.0,0,0,0.0,1,2,0.5,0,0,0,1,1,0,0,0,1,0,0,1,0,0,0,0.75,0,0.75,,,0.5
2021,Sacramento Kings,Denver,Ade Murkey,195.58,90.7184,SG,1,1,0,0,0.0,0,0,0.0,0,0,0.0,0,0,0,0,0,0,0,0,0,0,0,0,0,0,0,0.0,0,0.0,,,
2021,Houston Rockets,Vermont,Anthony Lamb,198.12,102.965384,SF,2,8,0,2,0.0,0,2,0.0,0,0,0.0,0,1,1,2,0,0,0,0,0,2,2,0,-4,-6,0,0.75,-10,-9.25,0.0,0.0,
2021,Charlotte Hornets,,Arnoldas Kulboka,208.28,94.800728,SF,2,5,0,1,0.0,0,1,0.0,0,0,0.0,0,0,0,0,0,0,0,1,0,1,1,0,-2,-3,0,-0.05,-5,-5.05,0.0,0.0,
2021,Atlanta Hawks,North Carolina State,Cat Barber,185.42,78.471416,PG,3,13,0,4,0.0,0,0,0.0,0,4,0.0,1,2,3,3,0,0,1,1,0,4,0,4,-8,0,-4,1.2,-12,-10.8,0.0,,0.0
2021,Toronto Raptors,Louisville,David Johnson,193.04,92.079176,SG,2,2,0,1,0.0,0,1,0.0,0,0,0.0,0,0,0,0,0,0,0,0,0,1,1,0,-2,-3,0,0.0,-5,-5.0,0.0,0.0,
2021,Indiana Pacers,Houston,DeJon Jarreau,195.58,83.91452,SG,1,1,0,0,0.0,0,0,0.0,0,0,0.0,0,0,0,0,0,0,0,0,0,0,0,0,0,0,0,0.0,0,0.0,,,
2021,Phoenix Suns,Lincoln Memorial,Emanuel Terry,205.74,99.79024,PF,3,18,0,5,0.0,0,0,0.0,0,0,0.0,8,7,15,2,1,0,5,4,0,5,0,0,-10,0,0,4.05,-10,-5.95,0.0,,
2021,New York Knicks,Southern Methodist,Feron Hunt,203.2,88.45044,SF,2,8,0,2,0.0,0,0,0.0,0,0,0.0,1,0,1,1,1,0,1,1,0,2,0,0,-4,0,0,0.7,-4,-3.3,0.0,,
2021,Dallas Mavericks,Cal-Santa Barbara,JaQuori McLaughlin,193.04,86.18248,PG,4,11,0,2,0.0,0,1,0.0,0,0,0.0,0,0,0,2,0,0,0,1,0,2,1,0,-4,-3,0,0.45,-7,-6.55,0.0,0.0,
2021,Washington Wizards,Wichita State,Jaime Echenique,208.28,117.026736,C,1,3,0,0,0.0,0,0,0.0,0,0,0.0,0,0,0,0,0,0,0,0,0,0,0,0,0,0,0,0.0,0,0.0,,,
2021,Milwaukee Bucks,Duke,Javin DeLaurier,208.28,106.140528,C,1,3,0,0,0.0,0,0,0.0,0,0,0.0,0,1,1,0,1,0,0,1,0,0,0,0,0,0,0,0.7,0,0.7,,,
2021,Los Angeles Lakers,Virginia,Jay Huff,215.9,108.86208,C,4,20,0,3,0.0,0,2,0.0,0,0,0.0,1,3,4,1,1,1,1,1,0,3,2,0,-6,-6,0,1.95,-12,-10.05,0.0,0.0,
2021,Detroit Pistons,West Virginia,Jaysean Paige,187.96,90.7184,PG,1,7,0,3,0.0,0,2,0.0,0,0,0.0,0,1,1,1,0,0,1,2,0,3,2,0,-6,-6,0,-0.1,-12,-12.1,0.0,0.0,
2021,Memphis Grizzlies,Michigan,Jon Teske,215.9,120.20188,C,3,8,0,1,0.0,0,0,0.0,0,2,0.0,0,2,2,1,1,0,0,1,0,1,0,2,-2,0,-2,1.2,-4,-2.8,0.0,,0.0
2021,Chicago Bulls,Oregon,Jordan Bell,200.66,97.975872,C,1,2,0,0,0.0,0,0,0.0,0,0,0.0,1,0,1,0,1,0,0,2,0,0,0,0,0,0,0,0.9,0,0.9,,,
2021,Washington Wizards,St. Louis,Jordan Goodwin,190.5,90.7184,SG,2,6,0,3,0.0,0,1,0.0,0,0,0.0,0,1,1,0,0,0,0,1,0,3,1,0,-6,-3,0,0.2,-9,-8.8,0.0,0.0,
2021,New York Knicks,Texas Tech,Matt Mooney,187.96,90.264808,SG,1,2,0,1,0.0,0,1,0.0,0,0,0.0,0,0,0,0,1,0,1,0,0,1,1,0,-2,-3,0,0.0,-5,-5.0,0.0,0.0,
2021,Indiana Pacers,Houston,Nate Hinton,195.58,95.25432,SG,2,2,0,1,0.0,0,0,0.0,0,0,0.0,0,0,0,0,0,0,1,0,0,1,0,0,-2,0,0,-0.5,-2,-2.5,0.0,,
2021,Toronto Raptors,Wisconsin,Sam Dekker,203.2,99.336648,PF,1,1,0,0,0.0,0,0,0.0,0,0,0.0,0,0,0,0,0,0,0,0,0,0,0,0,0,0,0,0.0,0,0.0,,,
2021,Detroit Pistons,Chicago St.,Trayvon Palmer,198.12,90.7184,SG,1,17,0,1,0.0,0,0,0.0,0,0,0.0,0,2,2,0,0,0,1,2,0,1,0,0,-2,0,0,-0.1,-2,-2.1,0.0,,
2021,New York Knicks,Montana State,Tyler Hall,195.58,94.800728,SG,1,2,0,0,0.0,0,0,0.0,0,0,0.0,0,0,0,0,0,0,0,0,0,0,0,0,0,0,0,0.0,0,0.0,,,
2021,Utah Jazz,Arizona St.,Zylan Cheatham,195.58,99.79024,SF,1,5,0,3,0.0,0,2,0.0,0,0,0.0,0,0,0,0,0,0,0,0,0,3,2,0,-6,-6,0,0.0,-12,-12.0,0.0,0.0,
2022,Boston Celtics,Duke,Jayson Tatum,203.2,95.25432,SF,74,2732,727,1559,0.466,240,686,0.35,531,622,0.854,78,571,649,342,78,51,213,160,2225,832,446,91,-210,-618,440,217.25,-388,-170.75,0.4663245670301475,0.3498542274052478,0.8536977491961415
2022,Philadelphia 76ers,Kansas,Joel Embiid,213.36,127.00576,C,66,2284,728,1328,0.548,66,200,0.33,661,771,0.857,113,557,670,274,66,112,226,205,2183,600,134,110,256,-204,551,230.0,603,833.0,0.5481927710843374,0.33,0.8573281452658884
2022,Oklahoma City Thunder,Kentucky,Shai Gilgeous-Alexander,198.12,88.45044,PG,68,2416,704,1381,0.51,58,168,0.345,669,739,0.905,59,270,329,371,112,65,192,192,2135,677,110,70,54,-156,599,172.65,497,669.65,0.5097755249818972,0.34523809523809523,0.9052774018944519
2022,Milwaukee Bucks,,Giannis Antetokounmpo,213.36,110.222856,PF,63,2024,707,1278,0.553,47,171,0.275,498,772,0.645,137,605,742,359,52,51,246,197,1959,571,124,274,272,-231,224,228.15,265,493.15,0.55320813771518,0.27485380116959063,0.6450777202072538
2022,Minnesota Timberwolves,Georgia,Anthony Edwards,193.04,102.0582,SG,79,2841,707,1541,0.459,213,578,0.369,319,422,0.756,47,411,458,350,125,58,259,186,1946,834,365,103,-254,-456,216,166.45,-494,-327.55,0.4587929915639195,0.3685121107266436,0.7559241706161137
2022,New York Knicks,Kentucky,Julius Randle,203.2,113.398,PF,77,2737,658,1432,0.459,218,636,0.343,402,531,0.757,141,626,767,316,49,21,216,233,1936,774,418,129,-232,-600,273,221.35,-559,-337.65,0.4594972067039106,0.34276729559748426,0.7570621468926554
2022,Cleveland Cavaliers,Louisville,Donovan Mitchell,185.42,97.52228,SG,68,2432,679,1402,0.484,245,635,0.386,319,368,0.867,63,226,289,301,99,27,180,168,1922,723,390,49,-88,-435,270,127.85,-253,-125.15,0.4843081312410842,0.3858267716535433,0.8668478260869565
2022,Atlanta Hawks,Oklahoma,Trae Young,185.42,74.389088,PG,73,2541,597,1390,0.429,154,460,0.335,566,639,0.886,56,161,217,741,80,9,300,104,1914,793,306,73,-392,-456,493,142.8,-355,-212.2,0.42949640287769786,0.3347826086956522,0.8857589984350548
2022,Chicago Bulls,UCLA,Zach LaVine,195.58,90.7184,SG,77,2768,673,1388,0.485,204,544,0.375,363,428,0.848,42,303,345,327,69,18,194,159,1913,715,340,65,-84,-408,298,117.05,-194,-76.95,0.48487031700288186,0.375,0.8481308411214953
2022,Portland Trail Blazers,Weber State,Damian Lillard,187.96,88.45044,PG,58,2107,556,1202,0.463,244,658,0.371,510,558,0.914,44,233,277,425,50,18,191,109,1866,646,414,48,-180,-510,462,119.55,-228,-108.45,0.46256239600665555,0.3708206686930091,0.9139784946236559
2022,Sacramento Kings,Kentucky,De'Aaron Fox,190.5,83.91452,PG,73,2435,682,1331,0.512,119,367,0.324,343,440,0.78,40,266,306,447,83,23,181,172,1826,649,248,97,66,-387,246,152.15,-75,77.15,0.512396694214876,0.3242506811989101,0.7795454545454545
2022,Chicago Bulls,Southern California,DeMar DeRozan,198.12,99.79024,SF,74,2682,657,1303,0.504,46,142,0.324,456,523,0.872,34,309,343,377,83,36,153,186,1816,646,96,67,22,-150,389,162.2,261,423.2,0.5042210283960092,0.323943661971831,0.8718929254302104
2022,Boston Celtics,California,Jaylen Brown,198.12,101.151016,SF,67,2405,679,1383,0.491,163,487,0.335,263,344,0.765,78,381,459,232,75,26,197,172,1784,704,324,81,-50,-483,182,135.65,-351,-215.35,0.4909616775126536,0.3347022587268994,0.7645348837209303
2022,Toronto Raptors,New Mexico State,Pascal Siakam,203.2,104.32616,PF,71,2652,630,1313,0.48,93,287,0.324,367,474,0.774,131,425,556,415,65,36,169,228,1720,683,194,107,-106,-303,260,230.1,-149,81.1,0.4798172124904798,0.3240418118466899,0.7742616033755274
2022,Utah Jazz,Arizona,Lauri Markkanen,213.36,108.86208,PF,66,2272,571,1145,0.499,200,511,0.391,349,399,0.875,130,440,570,123,42,38,127,137,1691,574,311,50,-6,-333,299,175.4,-40,135.4,0.49868995633187774,0.3913894324853229,0.87468671679198
2022,Houston Rockets,,Jalen Green,193.04,84.368112,SG,76,2602,566,1359,0.416,187,554,0.338,364,463,0.786,43,241,284,281,59,18,200,131,1683,793,367,99,-454,-540,265,83.95,-729,-645.05,0.41648270787343633,0.33754512635379064,0.7861771058315334
2022,Golden State Warriors,Michigan,Jordan Poole,193.04,87.996848,PG,82,2458,550,1278,0.43,214,637,0.336,361,415,0.87,32,193,225,369,63,21,252,214,1675,728,423,54,-356,-627,307,61.8,-676,-614.2,0.4303599374021909,0.3359497645211931,0.8698795180722891
2022,Brooklyn Nets,Villanova,Mikal Bridges,198.12,94.800728,SF,83,2963,593,1267,0.468,169,442,0.382,316,353,0.895,79,285,364,273,91,61,127,159,1671,674,273,37,-162,-312,279,183.55,-195,-11.449999999999989,0.468034727703236,0.38235294117647056,0.8951841359773371
2022,Brooklyn Nets,Villanova,Mikal Bridges,198.12,94.800728,SF,83,2963,593,1267,0.468,169,442,0.382,316,353,0.895,79,285,364,273,91,61,127,159,1671,674,273,37,-162,-312,279,183.55,-195,-11.449999999999989,0.468034727703236,0.38235294117647056,0.8951841359773371
2022,Brooklyn Nets,Villanova,Mikal Bridges,198.12,94.800728,SF,83,2963,593,1267,0.468,169,442,0.382,316,353,0.895,79,285,364,273,91,61,127,159,1671,674,273,37,-162,-312,279,183.55,-195,-11.449999999999989,0.468034727703236,0.38235294117647056,0.8951841359773371
2022,Brooklyn Nets,Villanova,Mikal Bridges,198.12,94.800728,SF,83,2963,593,1267,0.468,169,442,0.382,316,353,0.895,79,285,364,273,91,61,127,159,1671,674,273,37,-162,-312,279,183.55,-195,-11.449999999999989,0.468034727703236,0.38235294117647056,0.8951841359773371
2022,Brooklyn Nets,Villanova,Mikal Bridges,198.12,94.800728,SF,83,2963,593,1267,0.468,169,442,0.382,316,353,0.895,79,285,364,273,91,61,127,159,1671,674,273,37,-162,-312,279,183.55,-195,-11.449999999999989,0.468034727703236,0.38235294117647056,0.8951841359773371
2022,Brooklyn Nets,Villanova,Mikal Bridges,198.12,94.800728,SF,83,2963,593,1267,0.468,169,442,0.382,316,353,0.895,79,285,364,273,91,61,127,159,1671,674,273,37,-162,-312,279,183.55,-195,-11.449999999999989,0.468034727703236,0.38235294117647056,0.8951841359773371
2022,Brooklyn Nets,Villanova,Mikal Bridges,198.12,94.800728,SG,83,2963,593,1267,0.468,169,442,0.382,316,353,0.895,79,285,364,273,91,61,127,159,1671,674,273,37,-162,-312,279,183.55,-195,-11.449999999999989,0.468034727703236,0.38235294117647056,0.8951841359773371
2022,Brooklyn Nets,Villanova,Mikal Bridges,198.12,94.800728,SG,83,2963,593,1267,0.468,169,442,0.382,316,353,0.895,79,285,364,273,91,61,127,159,1671,674,273,37,-162,-312,279,183.55,-195,-11.449999999999989,0.468034727703236,0.38235294117647056,0.8951841359773371
2022,Brooklyn Nets,Villanova,Mikal Bridges,198.12,94.800728,SG,83,2963,593,1267,0.468,169,442,0.382,316,353,0.895,79,285,364,273,91,61,127,159,1671,674,273,37,-162,-312,279,183.55,-195,-11.449999999999989,0.468034727703236,0.38235294117647056,0.8951841359773371
2022,Golden State Warriors,Davidson,Stephen Curry,187.96,83.91452,PG,56,1941,559,1133,0.493,273,639,0.427,257,281,0.915,39,302,341,352,52,20,179,117,1648,574,366,24,-30,-279,233,123.65,-76,47.650000000000006,0.49338040600176525,0.4272300469483568,0.9145907473309609
2022,New York Knicks,Villanova,Jalen Brunson,187.96,86.18248,PG,68,2379,587,1195,0.491,134,322,0.416,325,392,0.829,40,201,241,421,61,15,142,152,1633,608,188,67,-42,-162,258,134.9,54,188.9,0.49121338912133894,0.4161490683229814,0.8290816326530612
2022,Dallas Mavericks,Duke,Kyrie Irving,187.96,88.45044,PG,60,2241,594,1203,0.494,188,496,0.379,247,273,0.905,59,245,304,331,66,45,128,165,1623,609,308,26,-30,-360,221,156.75,-169,-12.25,0.4937655860349127,0.3790322580645161,0.9047619047619048
2022,Dallas Mavericks,Duke,Kyrie Irving,187.96,88.45044,PG,60,2241,594,1203,0.494,188,496,0.379,247,273,0.905,59,245,304,331,66,45,128,165,1623,609,308,26,-30,-360,221,156.75,-169,-12.25,0.4937655860349127,0.3790322580645161,0.9047619047619048
2022,Dallas Mavericks,Duke,Kyrie Irving,187.96,88.45044,PG,60,2241,594,1203,0.494,188,496,0.379,247,273,0.905,59,245,304,331,66,45,128,165,1623,609,308,26,-30,-360,221,156.75,-169,-12.25,0.4937655860349127,0.3790322580645161,0.9047619047619048
2022,Dallas Mavericks,Duke,Kyrie Irving,187.96,88.45044,PG,60,2241,594,1203,0.494,188,496,0.379,247,273,0.905,59,245,304,331,66,45,128,165,1623,609,308,26,-30,-360,221,156.75,-169,-12.25,0.4937655860349127,0.3790322580645161,0.9047619047619048
2022,Dallas Mavericks,Duke,Kyrie Irving,187.96,88.45044,PG,60,2241,594,1203,0.494,188,496,0.379,247,273,0.905,59,245,304,331,66,45,128,165,1623,609,308,26,-30,-360,221,156.75,-169,-12.25,0.4937655860349127,0.3790322580645161,0.9047619047619048
2022,Dallas Mavericks,Duke,Kyrie Irving,187.96,88.45044,PG,60,2241,594,1203,0.494,188,496,0.379,247,273,0.905,59,245,304,331,66,45,128,165,1623,609,308,26,-30,-360,221,156.75,-169,-12.25,0.4937655860349127,0.3790322580645161,0.9047619047619048
2022,Dallas Mavericks,Duke,Kyrie Irving,187.96,88.45044,SG,60,2241,594,1203,0.494,188,496,0.379,247,273,0.905,59,245,304,331,66,45,128,165,1623,609,308,26,-30,-360,221,156.75,-169,-12.25,0.4937655860349127,0.3790322580645161,0.9047619047619048
2022,Dallas Mavericks,Duke,Kyrie Irving,187.96,88.45044,SG,60,2241,594,1203,0.494,188,496,0.379,247,273,0.905,59,245,304,331,66,45,128,165,1623,609,308,26,-30,-360,221,156.75,-169,-12.25,0.4937655860349127,0.3790322580645161,0.9047619047619048
2022,Dallas Mavericks,Duke,Kyrie Irving,187.96,88.45044,SG,60,2241,594,1203,0.494,188,496,0.379,247,273,0.905,59,245,304,331,66,45,128,165,1623,609,308,26,-30,-360,221,156.75,-169,-12.25,0.4937655860349127,0.3790322580645161,0.9047619047619048
2022,Memphis Grizzlies,Murray State,Ja Morant,187.96,78.92500799999999,PG,61,1948,566,1214,0.466,92,300,0.307,372,497,0.748,61,296,357,493,66,16,206,100,1596,648,208,125,-164,-348,247,160.75,-265,-104.25,0.46622734761120266,0.30666666666666664,0.7484909456740443
2022,Los Angeles Lakers,,LeBron James,205.74,113.398,PF,55,1954,609,1219,0.5,121,377,0.321,251,327,0.768,65,392,457,375,50,32,178,88,1590,610,256,76,-2,-405,175,171.85,-232,-60.150000000000006,0.4995898277276456,0.3209549071618037,0.7675840978593272
2022,New Orleans Pelicans,Lehigh,CJ McCollum,190.5,86.18248,PG,75,2649,587,1344,0.437,211,543,0.389,183,238,0.769,55,273,328,429,70,38,183,153,1568,757,332,55,-340,-363,128,157.85,-575,-417.15,0.4367559523809524,0.3885819521178637,0.7689075630252101
2022,Miami Heat,Kentucky,Bam Adebayo,205.74,115.66596,C,75,2598,602,1114,0.54,1,12,0.083,324,402,0.806,184,504,688,240,88,61,187,208,1529,512,11,78,180,-30,246,248.6,396,644.6,0.5403949730700179,0.08333333333333333,0.8059701492537313
2022,Atlanta Hawks,Washington,Dejounte Murray,195.58,81.64656,SG,74,2693,612,1319,0.464,133,387,0.344,158,190,0.832,53,336,389,448,112,19,160,106,1515,707,254,32,-190,-363,126,202.7,-427,-224.3,0.46398786959818045,0.34366925064599485,0.8315789473684211
2022,Sacramento Kings,Gonzaga,Domantas Sabonis,215.9,108.86208,C,79,2736,577,938,0.615,31,83,0.373,325,438,0.742,251,722,973,573,65,39,230,279,1510,361,52,113,432,-63,212,372.3,581,953.3,0.6151385927505331,0.37349397590361444,0.7420091324200914
2022,Golden State Warriors,Washington State,Klay Thompson,198.12,99.79024,SF,69,2279,546,1252,0.436,301,731,0.412,116,132,0.879,39,247,286,163,49,29,123,130,1509,706,430,16,-320,-387,100,93.0,-607,-514.0,0.43610223642172524,0.4117647058823529,0.8787878787878788
2022,Cleveland Cavaliers,Vanderbilt,Darius Garland,185.42,87.089664,PG,69,2447,522,1129,0.462,169,412,0.41,277,321,0.863,28,157,185,538,85,9,199,148,1490,607,243,44,-170,-222,233,127.85,-159,-31.150000000000006,0.46235606731620904,0.41019417475728154,0.8629283489096573
2022,Orlando Magic,Michigan,Franz Wagner,208.28,99.79024,SF,80,2609,542,1118,0.485,130,360,0.361,271,322,0.842,70,259,329,283,77,17,167,183,1485,576,230,51,-68,-300,220,124.85,-148,-23.150000000000006,0.4847942754919499,0.3611111111111111,0.8416149068322981
2022,Phoenix Suns,Kentucky,Devin Booker,195.58,93.439952,SG,53,1835,527,1067,0.494,111,316,0.351,306,358,0.855,46,194,240,293,51,18,145,159,1471,540,205,52,-26,-282,254,98.8,-54,44.8,0.4939081537019681,0.3512658227848101,0.8547486033519553
2022,Miami Heat,Marquette,Jimmy Butler,200.66,104.32616,PF,64,2138,479,888,0.539,36,103,0.35,472,555,0.85,141,234,375,340,117,21,101,80,1466,409,67,83,140,-93,389,228.5,436,664.5,0.5394144144144144,0.34951456310679613,0.8504504504504504
2022,Los Angeles Lakers,Kentucky,Anthony Davis,208.28,114.758776,C,56,1905,542,962,0.563,19,74,0.257,348,444,0.784,195,507,702,148,59,114,122,146,1451,420,55,96,244,-108,252,279.45,388,667.45,0.5634095634095634,0.25675675675675674,0.7837837837837838
2022,Orlando Magic,Duke,Paolo Banchero,208.28,113.398,PF,72,2430,479,1122,0.427,85,285,0.298,394,534,0.738,84,413,497,269,60,39,200,160,1437,643,200,140,-328,-345,254,154.0,-419,-265.0,0.4269162210338681,0.2982456140350877,0.7378277153558053
2022,New York Knicks,Duke,RJ Barrett,198.12,97.068688,SG,73,2476,510,1176,0.434,121,390,0.31,290,392,0.74,60,308,368,201,31,15,164,179,1431,666,269,102,-312,-444,188,89.3,-568,-478.7,0.4336734693877551,0.31025641025641026,0.7397959183673469
2022,San Antonio Spurs,Kentucky,Keldon Johnson,195.58,99.79024,SF,63,2063,503,1113,0.452,134,407,0.329,245,327,0.749,56,262,318,183,46,11,134,125,1385,610,273,82,-214,-417,163,94.5,-468,-373.5,0.4519317160826595,0.32923832923832924,0.7492354740061162
2022,Brooklyn Nets,Colorado,Spencer Dinwiddie,195.58,97.52228,SG,79,2725,460,1050,0.438,181,490,0.369,268,330,0.812,28,242,270,515,67,24,145,187,1369,590,309,62,-260,-384,206,166.9,-438,-271.1,0.4380952380952381,0.3693877551020408,0.8121212121212121
2022,Brooklyn Nets,Colorado,Spencer Dinwiddie,195.58,97.52228,SG,79,2725,460,1050,0.438,181,490,0.369,268,330,0.812,28,242,270,515,67,24,145,187,1369,590,309,62,-260,-384,206,166.9,-438,-271.1,0.4380952380952381,0.3693877551020408,0.8121212121212121
2022,Brooklyn Nets,Colorado,Spencer Dinwiddie,195.58,97.52228,SG,79,2725,460,1050,0.438,181,490,0.369,268,330,0.812,28,242,270,515,67,24,145,187,1369,590,309,62,-260,-384,206,166.9,-438,-271.1,0.4380952380952381,0.3693877551020408,0.8121212121212121
2022,Brooklyn Nets,Colorado,Spencer Dinwiddie,195.58,97.52228,SG,79,2725,460,1050,0.438,181,490,0.369,268,330,0.812,28,242,270,515,67,24,145,187,1369,590,309,62,-260,-384,206,166.9,-438,-271.1,0.4380952380952381,0.3693877551020408,0.8121212121212121
2022,Brooklyn Nets,Colorado,Spencer Dinwiddie,195.58,97.52228,SG,79,2725,460,1050,0.438,181,490,0.369,268,330,0.812,28,242,270,515,67,24,145,187,1369,590,309,62,-260,-384,206,166.9,-438,-271.1,0.4380952380952381,0.3693877551020408,0.8121212121212121
2022,Brooklyn Nets,Colorado,Spencer Dinwiddie,195.58,97.52228,SG,79,2725,460,1050,0.438,181,490,0.369,268,330,0.812,28,242,270,515,67,24,145,187,1369,590,309,62,-260,-384,206,166.9,-438,-271.1,0.4380952380952381,0.3693877551020408,0.8121212121212121
2022,Brooklyn Nets,Colorado,Spencer Dinwiddie,195.58,97.52228,PG,79,2725,460,1050,0.438,181,490,0.369,268,330,0.812,28,242,270,515,67,24,145,187,1369,590,309,62,-260,-384,206,166.9,-438,-271.1,0.4380952380952381,0.3693877551020408,0.8121212121212121
2022,Brooklyn Nets,Colorado,Spencer Dinwiddie,195.58,97.52228,PG,79,2725,460,1050,0.438,181,490,0.369,268,330,0.812,28,242,270,515,67,24,145,187,1369,590,309,62,-260,-384,206,166.9,-438,-271.1,0.4380952380952381,0.3693877551020408,0.8121212121212121
2022,Brooklyn Nets,Colorado,Spencer Dinwiddie,195.58,97.52228,PG,79,2725,460,1050,0.438,181,490,0.369,268,330,0.812,28,242,270,515,67,24,145,187,1369,590,309,62,-260,-384,206,166.9,-438,-271.1,0.4380952380952381,0.3693877551020408,0.8121212121212121
2022,Phoenix Suns,Texas,Kevin Durant,208.28,108.86208,PF,47,1672,483,862,0.56,93,230,0.404,307,334,0.919,17,296,313,235,34,67,156,99,1366,379,137,27,208,-132,280,108.8,356,464.8,0.5603248259860789,0.4043478260869565,0.9191616766467066
2022,Phoenix Suns,Texas,Kevin Durant,208.28,108.86208,PF,47,1672,483,862,0.56,93,230,0.404,307,334,0.919,17,296,313,235,34,67,156,99,1366,379,137,27,208,-132,280,108.8,356,464.8,0.5603248259860789,0.4043478260869565,0.9191616766467066
2022,Phoenix Suns,Texas,Kevin Durant,208.28,108.86208,PF,47,1672,483,862,0.56,93,230,0.404,307,334,0.919,17,296,313,235,34,67,156,99,1366,379,137,27,208,-132,280,108.8,356,464.8,0.5603248259860789,0.4043478260869565,0.9191616766467066
2022,Phoenix Suns,Texas,Kevin Durant,208.28,108.86208,PF,47,1672,483,862,0.56,93,230,0.404,307,334,0.919,17,296,313,235,34,67,156,99,1366,379,137,27,208,-132,280,108.8,356,464.8,0.5603248259860789,0.4043478260869565,0.9191616766467066
2022,Phoenix Suns,Texas,Kevin Durant,208.28,108.86208,PF,47,1672,483,862,0.56,93,230,0.404,307,334,0.919,17,296,313,235,34,67,156,99,1366,379,137,27,208,-132,280,108.8,356,464.8,0.5603248259860789,0.4043478260869565,0.9191616766467066
2022,Phoenix Suns,Texas,Kevin Durant,208.28,108.86208,PF,47,1672,483,862,0.56,93,230,0.404,307,334,0.919,17,296,313,235,34,67,156,99,1366,379,137,27,208,-132,280,108.8,356,464.8,0.5603248259860789,0.4043478260869565,0.9191616766467066
2022,Phoenix Suns,Texas,Kevin Durant,208.28,108.86208,PF,47,1672,483,862,0.56,93,230,0.404,307,334,0.919,17,296,313,235,34,67,156,99,1366,379,137,27,208,-132,280,108.8,356,464.8,0.5603248259860789,0.4043478260869565,0.9191616766467066
2022,Phoenix Suns,Texas,Kevin Durant,208.28,108.86208,PF,47,1672,483,862,0.56,93,230,0.404,307,334,0.919,17,296,313,235,34,67,156,99,1366,379,137,27,208,-132,280,108.8,356,464.8,0.5603248259860789,0.4043478260869565,0.9191616766467066
2022,Phoenix Suns,Texas,Kevin Durant,208.28,108.86208,PF,47,1672,483,862,0.56,93,230,0.404,307,334,0.919,17,296,313,235,34,67,156,99,1366,379,137,27,208,-132,280,108.8,356,464.8,0.5603248259860789,0.4043478260869565,0.9191616766467066
2022,Washington Wizards,Utah,Kyle Kuzma,205.74,100.243832,PF,64,2239,512,1142,0.448,160,481,0.333,173,237,0.73,55,408,463,239,36,29,190,145,1357,630,321,64,-236,-483,109,119.5,-610,-490.5,0.44833625218914186,0.33264033264033266,0.729957805907173
2022,Miami Heat,Kentucky,Tyler Herro,195.58,88.45044,SG,67,2335,487,1109,0.439,203,537,0.378,170,182,0.934,27,333,360,280,51,16,158,101,1347,622,334,12,-270,-393,158,116.2,-505,-388.8,0.43913435527502254,0.3780260707635009,0.9340659340659341
2022,Indiana Pacers,Oklahoma,Buddy Hield,193.04,99.79024,SF,80,2482,475,1038,0.458,288,677,0.425,106,129,0.822,67,333,400,225,92,26,139,156,1344,563,389,23,-176,-303,83,154.7,-396,-241.3,0.4576107899807322,0.4254062038404727,0.8217054263565892
2022,Toronto Raptors,Wichita State,Fred VanVleet,182.88,89.357624,PG,69,2535,437,1112,0.393,207,606,0.342,254,283,0.898,30,250,280,495,123,38,140,193,1335,675,399,29,-476,-576,225,202.1,-827,-624.9,0.39298561151079137,0.3415841584158416,0.8975265017667845
2022,Los Angeles Clippers,Fresno State,Paul George,203.2,99.79024,SF,56,1939,459,1004,0.457,158,426,0.371,256,294,0.871,45,297,342,288,83,20,176,159,1332,545,268,38,-172,-330,218,124.3,-284,-159.7,0.45717131474103584,0.37089201877934275,0.8707482993197279
2022,Charlotte Hornets,Louisville,Terry Rozier,185.42,86.18248,SG,63,2221,493,1188,0.415,165,505,0.327,178,220,0.809,51,208,259,319,74,16,134,119,1329,695,340,42,-404,-525,136,129.3,-793,-663.7,0.414983164983165,0.32673267326732675,0.8090909090909091
2022,Portland Trail Blazers,,Anfernee Simons,190.5,82.10015200000001,SG,62,2171,467,1045,0.447,212,562,0.377,160,179,0.894,18,143,161,253,42,14,128,142,1306,578,350,19,-222,-414,141,64.9,-495,-430.1,0.44688995215311006,0.37722419928825623,0.8938547486033519
2022,Indiana Pacers,Arizona,Bennedict Mathurin,195.58,95.25432,SG,78,2222,413,951,0.434,100,310,0.323,376,454,0.828,87,231,318,116,48,13,152,162,1302,538,210,78,-250,-330,298,76.65,-282,-205.35,0.434279705573081,0.3225806451612903,0.8281938325991189
2022,Denver Nuggets,Kentucky,Jamal Murray,193.04,97.52228,PG,65,2133,473,1041,0.454,172,432,0.398,180,216,0.833,48,209,257,400,66,16,145,103,1298,568,260,36,-190,-264,144,139.6,-310,-170.4,0.4543707973102786,0.39814814814814814,0.8333333333333334
2022,Portland Trail Blazers,Syracuse,Jerami Grant,203.2,95.25432,PF,63,2246,434,913,0.475,144,359,0.401,278,342,0.813,53,230,283,150,51,53,116,152,1290,479,215,64,-90,-213,214,107.9,-89,18.900000000000006,0.47535596933187296,0.4011142061281337,0.8128654970760234
2022,Milwaukee Bucks,UCLA,Jrue Holiday,195.58,92.98636,PG,67,2183,490,1023,0.479,158,411,0.384,152,177,0.859,79,262,341,495,79,25,197,116,1290,533,253,25,-86,-285,127,176.45,-244,-67.55000000000001,0.4789833822091887,0.3844282238442822,0.8587570621468926
2022,Cleveland Cavaliers,Southern California,Evan Mobley,210.82,97.52228,PF,79,2715,525,947,0.554,22,102,0.216,205,304,0.674,187,524,711,224,60,119,146,218,1277,422,80,99,206,-174,106,286.1,138,424.1,0.5543822597676874,0.21568627450980393,0.6743421052631579
2022,Utah Jazz,Missouri,Jordan Clarkson,195.58,87.996848,SG,61,1988,458,1031,0.444,155,459,0.338,200,245,0.816,72,174,246,270,33,13,186,120,1271,573,304,45,-230,-447,155,71.0,-522,-451.0,0.44422890397672166,0.33769063180827885,0.8163265306122449
2022,Los Angeles Lakers,Ohio State,D'Angelo Russell,193.04,87.543256,PG,71,2304,445,948,0.469,194,490,0.396,179,216,0.829,35,180,215,437,70,29,186,140,1263,503,296,37,-116,-306,142,121.25,-280,-158.75,0.4694092827004219,0.39591836734693875,0.8287037037037037
2022,Los Angeles Lakers,Ohio State,D'Angelo Russell,193.04,87.543256,PG,71,2304,445,948,0.469,194,490,0.396,179,216,0.829,35,180,215,437,70,29,186,140,1263,503,296,37,-116,-306,142,121.25,-280,-158.75,0.4694092827004219,0.39591836734693875,0.8287037037037037
2022,Los Angeles Lakers,Ohio State,D'Angelo Russell,193.04,87.543256,PG,71,2304,445,948,0.469,194,490,0.396,179,216,0.829,35,180,215,437,70,29,186,140,1263,503,296,37,-116,-306,142,121.25,-280,-158.75,0.4694092827004219,0.39591836734693875,0.8287037037037037
2022,Los Angeles Lakers,Ohio State,D'Angelo Russell,193.04,87.543256,PG,71,2304,445,948,0.469,194,490,0.396,179,216,0.829,35,180,215,437,70,29,186,140,1263,503,296,37,-116,-306,142,121.25,-280,-158.75,0.4694092827004219,0.39591836734693875,0.8287037037037037
2022,Los Angeles Lakers,Ohio State,D'Angelo Russell,193.04,87.543256,PG,71,2304,445,948,0.469,194,490,0.396,179,216,0.829,35,180,215,437,70,29,186,140,1263,503,296,37,-116,-306,142,121.25,-280,-158.75,0.4694092827004219,0.39591836734693875,0.8287037037037037
2022,Los Angeles Lakers,Ohio State,D'Angelo Russell,193.04,87.543256,PG,71,2304,445,948,0.469,194,490,0.396,179,216,0.829,35,180,215,437,70,29,186,140,1263,503,296,37,-116,-306,142,121.25,-280,-158.75,0.4694092827004219,0.39591836734693875,0.8287037037037037
2022,Los Angeles Lakers,Ohio State,D'Angelo Russell,193.04,87.543256,PG,71,2304,445,948,0.469,194,490,0.396,179,216,0.829,35,180,215,437,70,29,186,140,1263,503,296,37,-116,-306,142,121.25,-280,-158.75,0.4694092827004219,0.39591836734693875,0.8287037037037037
2022,Los Angeles Lakers,Ohio State,D'Angelo Russell,193.04,87.543256,PG,71,2304,445,948,0.469,194,490,0.396,179,216,0.829,35,180,215,437,70,29,186,140,1263,503,296,37,-116,-306,142,121.25,-280,-158.75,0.4694092827004219,0.39591836734693875,0.8287037037037037
2022,Los Angeles Lakers,Ohio State,D'Angelo Russell,193.04,87.543256,PG,71,2304,445,948,0.469,194,490,0.396,179,216,0.829,35,180,215,437,70,29,186,140,1263,503,296,37,-116,-306,142,121.25,-280,-158.75,0.4694092827004219,0.39591836734693875,0.8287037037037037
2022,Oklahoma City Thunder,,Josh Giddey,203.2,97.975872,PF,76,2367,539,1118,0.482,76,234,0.325,106,145,0.731,148,451,599,469,57,31,211,143,1260,579,158,39,-80,-246,67,235.35,-259,-23.650000000000006,0.4821109123434705,0.3247863247863248,0.7310344827586207
2022,Memphis Grizzlies,TCU,Desmond Bane,195.58,97.52228,SG,58,1841,450,939,0.479,166,407,0.408,181,205,0.883,43,248,291,254,56,22,126,150,1247,489,241,24,-78,-225,157,115.5,-146,-30.5,0.4792332268370607,0.40786240786240785,0.8829268292682927
2022,Milwaukee Bucks,Stanford,Brook Lopez,215.9,127.912944,C,78,2372,477,899,0.531,136,364,0.374,149,190,0.784,157,363,520,99,37,193,107,203,1239,422,228,41,110,-276,108,245.35,-58,187.35,0.5305895439377085,0.37362637362637363,0.7842105263157895
2022,Los Angeles Clippers,San Diego State,Kawhi Leonard,200.66,102.0582,SF,52,1748,446,871,0.512,104,250,0.416,243,279,0.871,57,281,338,204,72,28,88,84,1239,425,146,36,42,-126,207,151.55,123,274.55,0.5120551090700345,0.416,0.8709677419354839
2022,Sacramento Kings,North Carolina,Harrison Barnes,203.2,102.0582,PF,82,2662,374,791,0.473,132,353,0.374,350,413,0.847,87,279,366,128,57,10,86,103,1230,417,221,63,-86,-267,287,130.6,-66,64.6,0.47281921618204803,0.37393767705382436,0.847457627118644
2022,Philadelphia 76ers,Kentucky,Tyrese Maxey,187.96,90.7184,SG,60,2016,439,913,0.481,160,369,0.434,180,213,0.845,23,153,176,212,49,8,80,132,1218,474,209,33,-70,-147,147,84.65,-70,14.650000000000006,0.48083242059145676,0.43360433604336046,0.8450704225352113
2022,Philadelphia 76ers,Arizona State,James Harden,195.58,99.79024,PG,58,2135,371,842,0.441,161,418,0.385,313,361,0.867,40,314,354,618,71,31,195,112,1216,471,257,48,-200,-288,265,200.9,-223,-22.099999999999994,0.44061757719714967,0.38516746411483255,0.8670360110803325
2022,New York Knicks,Kentucky,Immanuel Quickley,187.96,86.18248,SG,81,2344,419,936,0.448,168,454,0.37,203,248,0.819,58,279,337,279,80,14,100,166,1209,517,286,45,-196,-354,158,157.2,-392,-234.8,0.44764957264957267,0.3700440528634361,0.8185483870967742
2022,Detroit Pistons,Purdue,Jaden Ivey,193.04,88.45044,SG,74,2304,409,983,0.416,120,350,0.343,266,356,0.747,73,215,288,387,61,17,237,242,1204,574,230,90,-330,-330,176,95.4,-484,-388.6,0.4160732451678535,0.34285714285714286,0.7471910112359551
2022,Phoenix Suns,Arizona,Deandre Ayton,213.36,113.398,C,67,2035,522,887,0.589,7,24,0.292,152,200,0.76,172,495,667,115,37,53,120,190,1203,365,17,48,314,-30,104,214.0,388,602.0,0.588500563697858,0.2916666666666667,0.76
2022,Toronto Raptors,Florida State,Scottie Barnes,203.2,102.0582,SF,77,2678,463,1016,0.456,63,224,0.281,190,246,0.772,179,333,512,371,83,61,154,170,1179,553,161,56,-180,-294,134,252.0,-340,-88.0,0.45570866141732286,0.28125,0.7723577235772358
2022,Memphis Grizzlies,Michigan State,Jaren Jackson Jr.,208.28,109.769264,C,63,1788,416,822,0.506,100,282,0.355,241,306,0.788,108,318,426,60,65,189,107,227,1173,406,182,65,20,-246,176,210.65,-50,160.65,0.5060827250608273,0.3546099290780142,0.7875816993464052
2022,Washington Wizards,Florida,Bradley Beal,193.04,93.893544,SG,50,1673,444,878,0.506,80,219,0.365,192,228,0.842,41,155,196,271,45,33,145,107,1160,434,139,36,20,-177,156,88.15,-1,87.15,0.5056947608200456,0.365296803652968,0.8421052631578947
2022,Indiana Pacers,Iowa State,Tyrese Haliburton,195.58,83.91452,PG,56,1883,412,841,0.49,161,402,0.4,175,201,0.871,33,172,205,585,91,25,141,69,1160,429,241,26,-34,-240,149,189.8,-125,64.80000000000001,0.48989298454221164,0.40049751243781095,0.8706467661691543
2022,Los Angeles Clippers,UCLA,Russell Westbrook,190.5,90.7184,PG,73,2126,432,991,0.436,89,286,0.311,206,314,0.656,89,334,423,551,76,33,255,162,1159,559,197,108,-254,-324,98,184.65,-480,-295.35,0.43592330978809285,0.3111888111888112,0.6560509554140127
2022,Los Angeles Clippers,UCLA,Russell Westbrook,190.5,90.7184,PG,73,2126,432,991,0.436,89,286,0.311,206,314,0.656,89,334,423,551,76,33,255,162,1159,559,197,108,-254,-324,98,184.65,-480,-295.35,0.43592330978809285,0.3111888111888112,0.6560509554140127
2022,Los Angeles Clippers,UCLA,Russell Westbrook,190.5,90.7184,PG,73,2126,432,991,0.436,89,286,0.311,206,314,0.656,89,334,423,551,76,33,255,162,1159,559,197,108,-254,-324,98,184.65,-480,-295.35,0.43592330978809285,0.3111888111888112,0.6560509554140127
2022,Los Angeles Clippers,UCLA,Russell Westbrook,190.5,90.7184,PG,73,2126,432,991,0.436,89,286,0.311,206,314,0.656,89,334,423,551,76,33,255,162,1159,559,197,108,-254,-324,98,184.65,-480,-295.35,0.43592330978809285,0.3111888111888112,0.6560509554140127
2022,Los Angeles Clippers,UCLA,Russell Westbrook,190.5,90.7184,PG,73,2126,432,991,0.436,89,286,0.311,206,314,0.656,89,334,423,551,76,33,255,162,1159,559,197,108,-254,-324,98,184.65,-480,-295.35,0.43592330978809285,0.3111888111888112,0.6560509554140127
2022,Los Angeles Clippers,UCLA,Russell Westbrook,190.5,90.7184,PG,73,2126,432,991,0.436,89,286,0.311,206,314,0.656,89,334,423,551,76,33,255,162,1159,559,197,108,-254,-324,98,184.65,-480,-295.35,0.43592330978809285,0.3111888111888112,0.6560509554140127
2022,Los Angeles Clippers,UCLA,Russell Westbrook,190.5,90.7184,PG,73,2126,432,991,0.436,89,286,0.311,206,314,0.656,89,334,423,551,76,33,255,162,1159,559,197,108,-254,-324,98,184.65,-480,-295.35,0.43592330978809285,0.3111888111888112,0.6560509554140127
2022,Los Angeles Clippers,UCLA,Russell Westbrook,190.5,90.7184,PG,73,2126,432,991,0.436,89,286,0.311,206,314,0.656,89,334,423,551,76,33,255,162,1159,559,197,108,-254,-324,98,184.65,-480,-295.35,0.43592330978809285,0.3111888111888112,0.6560509554140127
2022,Los Angeles Clippers,UCLA,Russell Westbrook,190.5,90.7184,PG,73,2126,432,991,0.436,89,286,0.311,206,314,0.656,89,334,423,551,76,33,255,162,1159,559,197,108,-254,-324,98,184.65,-480,-295.35,0.43592330978809285,0.3111888111888112,0.6560509554140127
2022,Toronto Raptors,Duke,Gary Trent Jr.,195.58,94.800728,SG,66,2118,405,935,0.433,166,450,0.369,172,205,0.839,30,143,173,106,104,14,55,102,1148,530,284,33,-250,-354,139,103.65,-465,-361.35,0.43315508021390375,0.3688888888888889,0.8390243902439024
2022,New Orleans Pelicans,Virginia,Trey Murphy III,203.2,93.439952,SF,79,2448,387,800,0.484,202,497,0.406,172,190,0.905,59,222,281,112,89,43,61,155,1148,413,295,18,-52,-279,154,140.75,-177,-36.25,0.48375,0.40643863179074446,0.9052631578947369
2022,Charlotte Hornets,Kentucky,P.J. Washington,200.66,104.32616,PF,73,2380,434,978,0.444,149,428,0.348,127,174,0.73,73,285,358,175,66,79,110,193,1144,544,279,47,-220,-390,80,159.35,-530,-370.65,0.4437627811860941,0.34813084112149534,0.7298850574712644
2022,Sacramento Kings,Maryland,Kevin Huerter,200.66,89.811216,SG,75,2203,420,866,0.485,205,510,0.402,95,131,0.725,42,209,251,221,80,24,97,181,1140,446,305,36,-52,-300,59,122.95,-293,-170.05,0.48498845265588914,0.4019607843137255,0.7251908396946565
2022,Houston Rockets,Southern California,Kevin Porter Jr.,193.04,92.079176,PG,59,2024,391,884,0.442,141,385,0.366,207,264,0.784,76,238,314,338,82,17,188,156,1130,493,244,57,-204,-309,150,129.7,-363,-233.3,0.4423076923076923,0.36623376623376624,0.7840909090909091
2022,Dallas Mavericks,UNLV,Christian Wood,205.74,97.068688,C,67,1738,396,769,0.515,105,279,0.376,217,281,0.772,87,404,491,121,30,72,121,169,1114,373,174,64,46,-207,153,156.8,-8,148.8,0.5149544863459038,0.3763440860215054,0.7722419928825622
2022,Indiana Pacers,Texas,Myles Turner,210.82,113.398,C,62,1825,402,733,0.548,93,249,0.373,216,276,0.783,88,378,466,89,36,140,103,215,1113,331,156,60,142,-189,156,186.5,109,295.5,0.548431105047749,0.37349397590361444,0.782608695652174
2022,New Orleans Pelicans,Duke,Brandon Ingram,203.2,86.18248,SF,45,1538,404,835,0.484,64,164,0.39,240,272,0.882,23,223,246,262,32,19,148,116,1112,431,100,32,-54,-108,208,78.45,46,124.45,0.48383233532934133,0.3902439024390244,0.8823529411764706
2022,Denver Nuggets,Arizona,Aaron Gordon,203.2,106.59412,PF,68,2055,429,761,0.564,60,173,0.347,191,314,0.608,164,282,446,203,54,51,98,129,1109,332,113,123,194,-159,68,200.3,103,303.3,0.5637319316688568,0.3468208092485549,0.60828025477707
2022,Philadelphia 76ers,Tennessee,Tobias Harris,200.66,102.511792,SF,74,2436,423,845,0.501,126,324,0.389,113,129,0.876,67,357,424,186,68,40,89,149,1085,422,198,16,2,-216,97,171.3,-117,54.30000000000001,0.5005917159763313,0.3888888888888889,0.875968992248062
2022,Denver Nuggets,Missouri,Michael Porter Jr.,208.28,98.883056,SF,62,1798,398,817,0.487,188,454,0.414,96,120,0.8,64,277,341,65,37,29,68,119,1080,419,266,24,-42,-234,72,110.55,-204,-93.45,0.48714810281517745,0.41409691629955947,0.8
2022,Atlanta Hawks,Villanova,Saddiq Bey,200.66,97.52228,SF,77,2129,353,836,0.422,151,418,0.361,205,238,0.861,98,264,362,118,70,13,71,123,1062,483,267,33,-260,-348,172,144.35,-436,-291.65,0.4222488038277512,0.361244019138756,0.8613445378151261
2022,Atlanta Hawks,Villanova,Saddiq Bey,200.66,97.52228,SF,77,2129,353,836,0.422,151,418,0.361,205,238,0.861,98,264,362,118,70,13,71,123,1062,483,267,33,-260,-348,172,144.35,-436,-291.65,0.4222488038277512,0.361244019138756,0.8613445378151261
2022,Atlanta Hawks,Villanova,Saddiq Bey,200.66,97.52228,SF,77,2129,353,836,0.422,151,418,0.361,205,238,0.861,98,264,362,118,70,13,71,123,1062,483,267,33,-260,-348,172,144.35,-436,-291.65,0.4222488038277512,0.361244019138756,0.8613445378151261
2022,Atlanta Hawks,Villanova,Saddiq Bey,200.66,97.52228,SF,77,2129,353,836,0.422,151,418,0.361,205,238,0.861,98,264,362,118,70,13,71,123,1062,483,267,33,-260,-348,172,144.35,-436,-291.65,0.4222488038277512,0.361244019138756,0.8613445378151261
2022,Atlanta Hawks,Villanova,Saddiq Bey,200.66,97.52228,SF,77,2129,353,836,0.422,151,418,0.361,205,238,0.861,98,264,362,118,70,13,71,123,1062,483,267,33,-260,-348,172,144.35,-436,-291.65,0.4222488038277512,0.361244019138756,0.8613445378151261
2022,Atlanta Hawks,Villanova,Saddiq Bey,200.66,97.52228,SF,77,2129,353,836,0.422,151,418,0.361,205,238,0.861,98,264,362,118,70,13,71,123,1062,483,267,33,-260,-348,172,144.35,-436,-291.65,0.4222488038277512,0.361244019138756,0.8613445378151261
2022,Atlanta Hawks,Villanova,Saddiq Bey,200.66,97.52228,SF,77,2129,353,836,0.422,151,418,0.361,205,238,0.861,98,264,362,118,70,13,71,123,1062,483,267,33,-260,-348,172,144.35,-436,-291.65,0.4222488038277512,0.361244019138756,0.8613445378151261
2022,Atlanta Hawks,Villanova,Saddiq Bey,200.66,97.52228,SF,77,2129,353,836,0.422,151,418,0.361,205,238,0.861,98,264,362,118,70,13,71,123,1062,483,267,33,-260,-348,172,144.35,-436,-291.65,0.4222488038277512,0.361244019138756,0.8613445378151261
2022,Atlanta Hawks,Villanova,Saddiq Bey,200.66,97.52228,SF,77,2129,353,836,0.422,151,418,0.361,205,238,0.861,98,264,362,118,70,13,71,123,1062,483,267,33,-260,-348,172,144.35,-436,-291.65,0.4222488038277512,0.361244019138756,0.8613445378151261
2022,Oklahoma City Thunder,Santa Clara,Jalen Williams,195.58,95.707912,SG,75,2276,414,794,0.521,73,205,0.356,155,191,0.812,84,253,337,248,103,35,123,191,1056,380,132,36,68,-177,119,165.2,10,175.2,0.5214105793450882,0.35609756097560974,0.8115183246073299
2022,Memphis Grizzlies,Oregon,Dillon Brooks,198.12,102.0582,SF,73,2214,392,991,0.396,143,439,0.326,120,154,0.779,45,199,244,189,65,16,104,240,1047,599,296,34,-414,-459,86,96.0,-787,-691.0,0.3955600403632694,0.32574031890660593,0.7792207792207793
2022,Sacramento Kings,Kentucky,Malik Monk,190.5,90.7184,SG,77,1719,357,796,0.448,143,398,0.359,184,207,0.889,32,171,203,298,49,20,146,125,1041,439,255,23,-164,-336,161,88.5,-339,-250.5,0.4484924623115578,0.3592964824120603,0.8888888888888888
2022,Atlanta Hawks,Virginia,De'Andre Hunter,203.2,100.243832,SF,67,2126,379,822,0.461,100,286,0.35,171,207,0.826,46,238,284,94,35,17,82,199,1029,443,186,36,-128,-258,135,81.05,-251,-169.95,0.4610705596107056,0.34965034965034963,0.8260869565217391
2022,Los Angeles Lakers,Florida State,Malik Beasley,193.04,84.821704,SG,81,2093,370,937,0.395,235,658,0.357,50,65,0.769,35,248,283,124,65,9,90,107,1025,567,423,15,-394,-564,35,97.15,-923,-825.85,0.39487726787620064,0.35714285714285715,0.7692307692307693
2022,Los Angeles Lakers,Florida State,Malik Beasley,193.04,84.821704,SG,81,2093,370,937,0.395,235,658,0.357,50,65,0.769,35,248,283,124,65,9,90,107,1025,567,423,15,-394,-564,35,97.15,-923,-825.85,0.39487726787620064,0.35714285714285715,0.7692307692307693
2022,Los Angeles Lakers,Florida State,Malik Beasley,193.04,84.821704,SG,81,2093,370,937,0.395,235,658,0.357,50,65,0.769,35,248,283,124,65,9,90,107,1025,567,423,15,-394,-564,35,97.15,-923,-825.85,0.39487726787620064,0.35714285714285715,0.7692307692307693
2022,Los Angeles Lakers,Florida State,Malik Beasley,193.04,84.821704,SG,81,2093,370,937,0.395,235,658,0.357,50,65,0.769,35,248,283,124,65,9,90,107,1025,567,423,15,-394,-564,35,97.15,-923,-825.85,0.39487726787620064,0.35714285714285715,0.7692307692307693
2022,Los Angeles Lakers,Florida State,Malik Beasley,193.04,84.821704,SG,81,2093,370,937,0.395,235,658,0.357,50,65,0.769,35,248,283,124,65,9,90,107,1025,567,423,15,-394,-564,35,97.15,-923,-825.85,0.39487726787620064,0.35714285714285715,0.7692307692307693
2022,Los Angeles Lakers,Florida State,Malik Beasley,193.04,84.821704,SG,81,2093,370,937,0.395,235,658,0.357,50,65,0.769,35,248,283,124,65,9,90,107,1025,567,423,15,-394,-564,35,97.15,-923,-825.85,0.39487726787620064,0.35714285714285715,0.7692307692307693
2022,Los Angeles Lakers,Florida State,Malik Beasley,193.04,84.821704,SG,81,2093,370,937,0.395,235,658,0.357,50,65,0.769,35,248,283,124,65,9,90,107,1025,567,423,15,-394,-564,35,97.15,-923,-825.85,0.39487726787620064,0.35714285714285715,0.7692307692307693
2022,Los Angeles Lakers,Florida State,Malik Beasley,193.04,84.821704,SG,81,2093,370,937,0.395,235,658,0.357,50,65,0.769,35,248,283,124,65,9,90,107,1025,567,423,15,-394,-564,35,97.15,-923,-825.85,0.39487726787620064,0.35714285714285715,0.7692307692307693
2022,Los Angeles Lakers,Florida State,Malik Beasley,193.04,84.821704,SG,81,2093,370,937,0.395,235,658,0.357,50,65,0.769,35,248,283,124,65,9,90,107,1025,567,423,15,-394,-564,35,97.15,-923,-825.85,0.39487726787620064,0.35714285714285715,0.7692307692307693
2022,Los Angeles Clippers,UCLA,Norman Powell,193.04,97.52228,SG,60,1567,340,710,0.479,114,287,0.397,225,277,0.812,24,151,175,109,50,18,101,125,1019,370,173,52,-60,-177,173,54.25,-64,-9.75,0.4788732394366197,0.397212543554007,0.8122743682310469
2022,Dallas Mavericks,Michigan,Tim Hardaway Jr.,195.58,92.98636,SF,71,2152,340,847,0.401,212,550,0.385,127,165,0.77,21,230,251,129,49,12,60,120,1019,507,338,38,-334,-378,89,94.75,-623,-528.25,0.4014167650531287,0.38545454545454544,0.7696969696969697
2022,Boston Celtics,Colorado,Derrick White,193.04,86.18248,SG,82,2319,350,758,0.462,149,391,0.381,168,192,0.875,52,241,293,321,54,76,95,177,1017,408,242,24,-116,-279,144,175.15,-251,-75.85,0.46174142480211083,0.38107416879795397,0.875
2022,Oklahoma City Thunder,Arizona State,Luguentz Dort,193.04,99.79024,SF,74,2272,339,873,0.388,135,409,0.33,200,259,0.772,128,216,344,154,75,23,92,243,1013,534,274,59,-390,-417,141,147.35,-666,-518.65,0.38831615120274915,0.33007334963325186,0.7722007722007722
2022,Houston Rockets,Auburn,Jabari Smith Jr.,210.82,99.79024,PF,79,2451,364,892,0.408,120,391,0.307,162,206,0.786,122,447,569,101,43,74,104,227,1010,528,271,44,-328,-453,118,193.15,-663,-469.85,0.4080717488789238,0.3069053708439898,0.7864077669902912
2022,Boston Celtics,Virginia,Malcolm Brogdon,193.04,103.872568,PG,67,1744,354,732,0.484,132,297,0.444,160,184,0.87,42,238,280,248,45,18,98,109,1000,378,165,24,-48,-99,136,119.55,-11,108.55,0.48360655737704916,0.4444444444444444,0.8695652173913043
2022,Milwaukee Bucks,Arkansas,Bobby Portis,210.82,113.398,PF,70,1818,398,803,0.496,95,257,0.37,96,125,0.768,154,518,672,105,29,16,81,115,987,405,162,29,-14,-201,67,209.0,-148,61.0,0.49564134495641343,0.36964980544747084,0.768
2022,Sacramento Kings,Iowa,Keegan Murray,203.2,102.0582,SF,80,2382,354,782,0.453,206,501,0.411,62,81,0.765,89,282,371,98,61,42,60,162,976,428,295,19,-148,-267,43,152.9,-372,-219.1,0.45268542199488493,0.4111776447105788,0.7654320987654321
2022,Charlotte Hornets,Kansas,Kelly Oubre Jr.,198.12,92.079176,SF,48,1548,353,819,0.431,108,339,0.319,158,208,0.76,65,184,249,54,68,18,64,141,972,466,231,50,-226,-369,108,95.95,-487,-391.05,0.43101343101343104,0.3185840707964602,0.7596153846153846
2022,Cleveland Cavaliers,Texas,Jarrett Allen,205.74,110.222856,C,68,2220,403,626,0.644,1,10,0.1,162,221,0.733,221,445,666,113,54,84,93,153,969,223,9,59,360,-24,103,264.85,439,703.85,0.6437699680511182,0.1,0.7330316742081447
2022,Brooklyn Nets,Georgia,Nic Claxton,210.82,97.52228,C,76,2271,414,587,0.705,0,2,0.0,133,246,0.541,184,518,702,144,65,189,96,212,961,173,2,113,482,-6,20,325.9,496,821.9,0.7052810902896082,0.0,0.540650406504065
2022,Minnesota Timberwolves,Washington,Jaden McDaniels,205.74,83.91452,SF,79,2417,370,716,0.517,107,269,0.398,106,144,0.736,92,215,307,148,74,76,112,272,953,346,162,38,48,-165,68,142.15,-49,93.15,0.5167597765363129,0.39776951672862454,0.7361111111111112
2022,Minnesota Timberwolves,,Rudy Gobert,215.9,117.026736,C,70,2148,360,546,0.659,0,3,0.0,219,340,0.644,231,583,814,87,56,95,122,210,939,186,3,121,348,-9,98,287.0,437,724.0,0.6593406593406593,0.0,0.6441176470588236
2022,Atlanta Hawks,Wake Forest,John Collins,205.74,102.511792,PF,71,2130,359,707,0.508,70,240,0.292,143,178,0.803,77,385,462,85,42,73,79,220,931,348,170,35,22,-300,108,163.0,-170,-7.0,0.5077793493635078,0.2916666666666667,0.8033707865168539
2022,Denver Nuggets,Miami,Bruce Brown,193.04,91.625584,SF,80,2279,358,741,0.483,91,254,0.358,116,153,0.758,63,265,328,268,87,51,123,190,923,383,163,37,-50,-216,79,162.75,-187,-24.25,0.48313090418353577,0.35826771653543305,0.7581699346405228
2022,Miami Heat,DePaul,Max Strus,195.58,97.52228,SF,80,2272,324,790,0.41,197,563,0.35,78,89,0.876,49,209,258,171,42,12,70,166,923,466,366,11,-284,-507,67,103.2,-724,-620.8,0.41012658227848103,0.34991119005328597,0.8764044943820225
2022,Cleveland Cavaliers,Michigan,Caris LeVert,198.12,92.98636,SG,74,2237,320,742,0.431,127,324,0.392,130,180,0.722,53,229,282,287,72,24,116,170,897,422,197,50,-204,-210,80,137.0,-334,-197.0,0.431266846361186,0.39197530864197533,0.7222222222222222
2022,Toronto Raptors,Utah,Jakob Poeltl,215.9,111.13004,C,72,1906,389,618,0.629,0,1,0.0,119,201,0.592,236,417,653,197,66,86,125,195,897,229,1,82,320,-3,37,275.25,354,629.25,0.6294498381877023,0.0,0.5920398009950248
2022,Toronto Raptors,Utah,Jakob Poeltl,215.9,111.13004,C,72,1906,389,618,0.629,0,1,0.0,119,201,0.592,236,417,653,197,66,86,125,195,897,229,1,82,320,-3,37,275.25,354,629.25,0.6294498381877023,0.0,0.5920398009950248
2022,Toronto Raptors,Utah,Jakob Poeltl,215.9,111.13004,C,72,1906,389,618,0.629,0,1,0.0,119,201,0.592,236,417,653,197,66,86,125,195,897,229,1,82,320,-3,37,275.25,354,629.25,0.6294498381877023,0.0,0.5920398009950248
2022,Toronto Raptors,Utah,Jakob Poeltl,215.9,111.13004,C,72,1906,389,618,0.629,0,1,0.0,119,201,0.592,236,417,653,197,66,86,125,195,897,229,1,82,320,-3,37,275.25,354,629.25,0.6294498381877023,0.0,0.5920398009950248
2022,Toronto Raptors,Utah,Jakob Poeltl,215.9,111.13004,C,72,1906,389,618,0.629,0,1,0.0,119,201,0.592,236,417,653,197,66,86,125,195,897,229,1,82,320,-3,37,275.25,354,629.25,0.6294498381877023,0.0,0.5920398009950248
2022,Toronto Raptors,Utah,Jakob Poeltl,215.9,111.13004,C,72,1906,389,618,0.629,0,1,0.0,119,201,0.592,236,417,653,197,66,86,125,195,897,229,1,82,320,-3,37,275.25,354,629.25,0.6294498381877023,0.0,0.5920398009950248
2022,Toronto Raptors,Utah,Jakob Poeltl,215.9,111.13004,C,72,1906,389,618,0.629,0,1,0.0,119,201,0.592,236,417,653,197,66,86,125,195,897,229,1,82,320,-3,37,275.25,354,629.25,0.6294498381877023,0.0,0.5920398009950248
2022,Toronto Raptors,Utah,Jakob Poeltl,215.9,111.13004,C,72,1906,389,618,0.629,0,1,0.0,119,201,0.592,236,417,653,197,66,86,125,195,897,229,1,82,320,-3,37,275.25,354,629.25,0.6294498381877023,0.0,0.5920398009950248
2022,Toronto Raptors,Utah,Jakob Poeltl,215.9,111.13004,C,72,1906,389,618,0.629,0,1,0.0,119,201,0.592,236,417,653,197,66,86,125,195,897,229,1,82,320,-3,37,275.25,354,629.25,0.6294498381877023,0.0,0.5920398009950248
2022,San Antonio Spurs,Duke,Tre Jones,185.42,83.91452,PG,68,1984,341,743,0.459,45,158,0.285,148,172,0.86,56,189,245,448,89,9,110,98,875,402,113,24,-122,-204,124,176.35,-202,-25.650000000000006,0.458950201884253,0.2848101265822785,0.8604651162790697
2022,Orlando Magic,Duke,Wendell Carter Jr.,208.28,122.46984,C,57,1690,322,613,0.525,80,225,0.356,144,195,0.738,120,377,497,132,30,33,106,159,868,291,145,51,62,-195,93,157.8,-40,117.80000000000001,0.5252854812398042,0.35555555555555557,0.7384615384615385
2022,Los Angeles Clippers,Duke,Mason Plumlee,213.36,115.212368,C,79,2053,329,484,0.68,0,0,0.0,199,313,0.636,229,471,700,245,46,47,117,217,857,155,0,114,348,0,85,270.65,433,703.65,0.6797520661157025,,0.6357827476038339
2022,Los Angeles Clippers,Duke,Mason Plumlee,213.36,115.212368,C,79,2053,329,484,0.68,0,0,0.0,199,313,0.636,229,471,700,245,46,47,117,217,857,155,0,114,348,0,85,270.65,433,703.65,0.6797520661157025,,0.6357827476038339
2022,Los Angeles Clippers,Duke,Mason Plumlee,213.36,115.212368,C,79,2053,329,484,0.68,0,0,0.0,199,313,0.636,229,471,700,245,46,47,117,217,857,155,0,114,348,0,85,270.65,433,703.65,0.6797520661157025,,0.6357827476038339
2022,Los Angeles Clippers,Duke,Mason Plumlee,213.36,115.212368,C,79,2053,329,484,0.68,0,0,0.0,199,313,0.636,229,471,700,245,46,47,117,217,857,155,0,114,348,0,85,270.65,433,703.65,0.6797520661157025,,0.6357827476038339
2022,Los Angeles Clippers,Duke,Mason Plumlee,213.36,115.212368,C,79,2053,329,484,0.68,0,0,0.0,199,313,0.636,229,471,700,245,46,47,117,217,857,155,0,114,348,0,85,270.65,433,703.65,0.6797520661157025,,0.6357827476038339
2022,Los Angeles Clippers,Duke,Mason Plumlee,213.36,115.212368,C,79,2053,329,484,0.68,0,0,0.0,199,313,0.636,229,471,700,245,46,47,117,217,857,155,0,114,348,0,85,270.65,433,703.65,0.6797520661157025,,0.6357827476038339
2022,Los Angeles Clippers,Duke,Mason Plumlee,213.36,115.212368,C,79,2053,329,484,0.68,0,0,0.0,199,313,0.636,229,471,700,245,46,47,117,217,857,155,0,114,348,0,85,270.65,433,703.65,0.6797520661157025,,0.6357827476038339
2022,Los Angeles Clippers,Duke,Mason Plumlee,213.36,115.212368,C,79,2053,329,484,0.68,0,0,0.0,199,313,0.636,229,471,700,245,46,47,117,217,857,155,0,114,348,0,85,270.65,433,703.65,0.6797520661157025,,0.6357827476038339
2022,Los Angeles Clippers,Duke,Mason Plumlee,213.36,115.212368,C,79,2053,329,484,0.68,0,0,0.0,199,313,0.636,229,471,700,245,46,47,117,217,857,155,0,114,348,0,85,270.65,433,703.65,0.6797520661157025,,0.6357827476038339
2022,Los Angeles Clippers,Indiana,Eric Gordon,190.5,97.52228,SG,69,1966,291,653,0.446,132,356,0.371,142,173,0.821,16,118,134,183,43,25,104,78,856,362,224,31,-142,-276,111,61.35,-307,-245.65,0.445635528330781,0.3707865168539326,0.8208092485549133
2022,Los Angeles Clippers,Indiana,Eric Gordon,190.5,97.52228,SG,69,1966,291,653,0.446,132,356,0.371,142,173,0.821,16,118,134,183,43,25,104,78,856,362,224,31,-142,-276,111,61.35,-307,-245.65,0.445635528330781,0.3707865168539326,0.8208092485549133
2022,Los Angeles Clippers,Indiana,Eric Gordon,190.5,97.52228,SG,69,1966,291,653,0.446,132,356,0.371,142,173,0.821,16,118,134,183,43,25,104,78,856,362,224,31,-142,-276,111,61.35,-307,-245.65,0.445635528330781,0.3707865168539326,0.8208092485549133
2022,Los Angeles Clippers,Indiana,Eric Gordon,190.5,97.52228,SG,69,1966,291,653,0.446,132,356,0.371,142,173,0.821,16,118,134,183,43,25,104,78,856,362,224,31,-142,-276,111,61.35,-307,-245.65,0.445635528330781,0.3707865168539326,0.8208092485549133
2022,Los Angeles Clippers,Indiana,Eric Gordon,190.5,97.52228,SG,69,1966,291,653,0.446,132,356,0.371,142,173,0.821,16,118,134,183,43,25,104,78,856,362,224,31,-142,-276,111,61.35,-307,-245.65,0.445635528330781,0.3707865168539326,0.8208092485549133
2022,Los Angeles Clippers,Indiana,Eric Gordon,190.5,97.52228,SG,69,1966,291,653,0.446,132,356,0.371,142,173,0.821,16,118,134,183,43,25,104,78,856,362,224,31,-142,-276,111,61.35,-307,-245.65,0.445635528330781,0.3707865168539326,0.8208092485549133
2022,Los Angeles Clippers,Indiana,Eric Gordon,190.5,97.52228,SG,69,1966,291,653,0.446,132,356,0.371,142,173,0.821,16,118,134,183,43,25,104,78,856,362,224,31,-142,-276,111,61.35,-307,-245.65,0.445635528330781,0.3707865168539326,0.8208092485549133
2022,Los Angeles Clippers,Indiana,Eric Gordon,190.5,97.52228,SG,69,1966,291,653,0.446,132,356,0.371,142,173,0.821,16,118,134,183,43,25,104,78,856,362,224,31,-142,-276,111,61.35,-307,-245.65,0.445635528330781,0.3707865168539326,0.8208092485549133
2022,Los Angeles Clippers,Indiana,Eric Gordon,190.5,97.52228,SG,69,1966,291,653,0.446,132,356,0.371,142,173,0.821,16,118,134,183,43,25,104,78,856,362,224,31,-142,-276,111,61.35,-307,-245.65,0.445635528330781,0.3707865168539326,0.8208092485549133
2022,Utah Jazz,Gonzaga,Kelly Olynyk,210.82,108.86208,C,68,1942,278,557,0.499,93,236,0.394,198,232,0.853,82,338,420,252,60,37,168,232,847,279,143,34,-2,-150,164,141.4,12,153.4,0.4991023339317774,0.3940677966101695,0.853448275862069
2022,Charlotte Hornets,,LaMelo Ball,200.66,81.64656,PG,36,1268,296,721,0.411,144,383,0.376,102,122,0.836,42,189,231,304,46,11,129,118,838,425,239,20,-258,-285,82,102.35,-461,-358.65,0.4105409153952843,0.37597911227154046,0.8360655737704918
2022,Orlando Magic,Washington,Markelle Fultz,193.04,94.800728,PG,60,1778,349,679,0.514,27,87,0.31,112,143,0.783,69,165,234,341,87,26,139,131,837,330,60,31,38,-99,81,141.45,20,161.45,0.5139911634756995,0.3103448275862069,0.7832167832167832
2022,Los Angeles Lakers,Oklahoma,Austin Reaves,195.58,89.357624,SG,64,1843,259,490,0.529,86,216,0.398,229,265,0.864,33,160,193,215,33,19,99,108,833,231,130,36,56,-132,193,81.35,117,198.35,0.5285714285714286,0.39814814814814814,0.8641509433962264
2022,Chicago Bulls,Florida State,Patrick Williams,200.66,97.52228,PF,82,2323,314,677,0.464,115,277,0.415,90,105,0.857,78,249,327,100,72,70,101,147,833,363,162,15,-98,-141,75,139.4,-164,-24.599999999999994,0.4638109305760709,0.4151624548736462,0.8571428571428571
2022,Memphis Grizzlies,Duke,Tyus Jones,187.96,88.904032,PG,80,1939,311,710,0.438,121,326,0.371,80,100,0.8,28,172,200,417,83,6,74,32,823,399,205,20,-176,-252,60,167.15,-368,-200.85,0.43802816901408453,0.37116564417177916,0.8
2022,Denver Nuggets,Georgia,Kentavious Caldwell-Pope,195.58,92.532768,SG,76,2381,292,632,0.462,135,319,0.423,103,125,0.824,35,173,208,183,112,35,86,145,822,340,184,22,-96,-147,81,129.75,-162,-32.25,0.4620253164556962,0.4231974921630094,0.824
2022,Washington Wizards,Gonzaga,Corey Kispert,198.12,101.604608,SF,74,2093,291,585,0.497,163,384,0.424,75,88,0.852,33,174,207,87,32,9,55,97,820,294,221,13,-6,-174,62,69.9,-118,-48.099999999999994,0.49743589743589745,0.4244791666666667,0.8522727272727273
2022,Phoenix Suns,Wake Forest,Chris Paul,182.88,79.3786,PG,59,1889,294,668,0.44,98,261,0.375,133,160,0.831,27,224,251,524,91,22,114,126,819,374,163,27,-160,-195,106,193.7,-249,-55.30000000000001,0.44011976047904194,0.37547892720306514,0.83125
2022,Los Angeles Clippers,,Ivica Zubac,213.36,108.86208,C,76,2169,326,514,0.634,0,2,0.0,166,238,0.697,236,520,756,77,29,98,117,219,818,188,2,72,276,-6,94,261.3,364,625.3,0.6342412451361867,0.0,0.6974789915966386
2022,New York Knicks,Houston,Quentin Grimes,195.58,95.25432,SG,71,2121,282,602,0.468,157,407,0.386,78,98,0.796,49,180,229,150,47,26,69,177,799,320,250,20,-76,-279,58,100.15,-297,-196.85,0.4684385382059801,0.3857493857493858,0.7959183673469388
2022,Minnesota Timberwolves,Ohio State,Mike Conley,185.42,79.3786,PG,67,2028,261,610,0.428,135,351,0.385,141,169,0.834,33,149,182,450,73,14,103,139,798,349,216,28,-176,-243,113,151.3,-306,-154.7,0.4278688524590164,0.38461538461538464,0.834319526627219
2022,Minnesota Timberwolves,Ohio State,Mike Conley,185.42,79.3786,PG,67,2028,261,610,0.428,135,351,0.385,141,169,0.834,33,149,182,450,73,14,103,139,798,349,216,28,-176,-243,113,151.3,-306,-154.7,0.4278688524590164,0.38461538461538464,0.834319526627219
2022,Minnesota Timberwolves,Ohio State,Mike Conley,185.42,79.3786,PG,67,2028,261,610,0.428,135,351,0.385,141,169,0.834,33,149,182,450,73,14,103,139,798,349,216,28,-176,-243,113,151.3,-306,-154.7,0.4278688524590164,0.38461538461538464,0.834319526627219
2022,Minnesota Timberwolves,Ohio State,Mike Conley,185.42,79.3786,PG,67,2028,261,610,0.428,135,351,0.385,141,169,0.834,33,149,182,450,73,14,103,139,798,349,216,28,-176,-243,113,151.3,-306,-154.7,0.4278688524590164,0.38461538461538464,0.834319526627219
2022,Minnesota Timberwolves,Ohio State,Mike Conley,185.42,79.3786,PG,67,2028,261,610,0.428,135,351,0.385,141,169,0.834,33,149,182,450,73,14,103,139,798,349,216,28,-176,-243,113,151.3,-306,-154.7,0.4278688524590164,0.38461538461538464,0.834319526627219
2022,Minnesota Timberwolves,Ohio State,Mike Conley,185.42,79.3786,PG,67,2028,261,610,0.428,135,351,0.385,141,169,0.834,33,149,182,450,73,14,103,139,798,349,216,28,-176,-243,113,151.3,-306,-154.7,0.4278688524590164,0.38461538461538464,0.834319526627219
2022,Minnesota Timberwolves,Ohio State,Mike Conley,185.42,79.3786,PG,67,2028,261,610,0.428,135,351,0.385,141,169,0.834,33,149,182,450,73,14,103,139,798,349,216,28,-176,-243,113,151.3,-306,-154.7,0.4278688524590164,0.38461538461538464,0.834319526627219
2022,Minnesota Timberwolves,Ohio State,Mike Conley,185.42,79.3786,PG,67,2028,261,610,0.428,135,351,0.385,141,169,0.834,33,149,182,450,73,14,103,139,798,349,216,28,-176,-243,113,151.3,-306,-154.7,0.4278688524590164,0.38461538461538464,0.834319526627219
2022,Minnesota Timberwolves,Ohio State,Mike Conley,185.42,79.3786,PG,67,2028,261,610,0.428,135,351,0.385,141,169,0.834,33,149,182,450,73,14,103,139,798,349,216,28,-176,-243,113,151.3,-306,-154.7,0.4278688524590164,0.38461538461538464,0.834319526627219
2022,Atlanta Hawks,Southern California,Onyeka Okongwu,205.74,108.86208,C,80,1849,317,497,0.638,4,13,0.308,153,196,0.781,217,359,576,81,56,107,81,251,791,180,9,43,274,-15,110,246.95,369,615.95,0.6378269617706237,0.3076923076923077,0.7806122448979592
2022,Portland Trail Blazers,Kentucky,Shaedon Sharpe,195.58,90.7184,SG,80,1779,306,648,0.472,102,283,0.36,75,105,0.714,63,173,236,94,38,24,83,136,789,342,181,30,-72,-237,45,80.95,-264,-183.05,0.4722222222222222,0.36042402826855124,0.7142857142857143
2022,Detroit Pistons,,Killian Hayes,195.58,88.45044,PG,76,2154,307,815,0.377,80,286,0.28,92,112,0.821,28,193,221,470,104,28,173,219,786,508,206,20,-402,-378,72,148.3,-708,-559.7,0.37668711656441717,0.27972027972027974,0.8214285714285714
2022,Orlando Magic,North Carolina,Cole Anthony,190.5,83.91452,PG,60,1552,277,610,0.454,75,206,0.364,152,170,0.894,47,241,288,235,37,31,91,158,781,333,131,18,-112,-168,134,123.1,-146,-22.900000000000006,0.4540983606557377,0.3640776699029126,0.8941176470588236
2022,Minnesota Timberwolves,Louisiana State,Naz Reid,205.74,119.748288,C,68,1251,310,577,0.537,75,217,0.346,86,127,0.677,73,260,333,77,42,53,92,176,781,267,142,41,86,-201,45,113.45,-70,43.45,0.537261698440208,0.3456221198156682,0.6771653543307087
2022,Philadelphia 76ers,Southern California,De'Anthony Melton,187.96,90.7184,SG,77,2150,277,651,0.425,157,403,0.39,69,87,0.793,69,243,312,197,126,41,102,191,780,374,246,18,-194,-267,51,167.45,-410,-242.55,0.4254992319508449,0.38957816377171217,0.7931034482758621
2022,Atlanta Hawks,,Clint Capela,208.28,116.119552,C,65,1730,350,536,0.653,0,1,0.0,79,131,0.603,258,459,717,58,45,79,54,139,779,186,1,52,328,-3,27,286.3,352,638.3,0.6529850746268657,0.0,0.6030534351145038
2022,Houston Rockets,Louisiana State,Tari Eason,203.2,97.52228,PF,82,1767,296,660,0.448,59,172,0.343,109,145,0.752,195,301,496,88,96,47,101,189,760,364,113,36,-136,-162,73,206.3,-225,-18.69999999999999,0.4484848484848485,0.3430232558139535,0.7517241379310344
2022,Philadelphia 76ers,San Diego State,Jalen McDaniels,205.74,92.98636,SF,80,1913,281,617,0.455,77,232,0.332,116,138,0.841,63,283,346,130,83,34,93,209,755,336,155,22,-110,-234,94,136.3,-250,-113.69999999999999,0.4554294975688817,0.33189655172413796,0.8405797101449275
2022,Philadelphia 76ers,San Diego State,Jalen McDaniels,205.74,92.98636,SF,80,1913,281,617,0.455,77,232,0.332,116,138,0.841,63,283,346,130,83,34,93,209,755,336,155,22,-110,-234,94,136.3,-250,-113.69999999999999,0.4554294975688817,0.33189655172413796,0.8405797101449275
2022,Philadelphia 76ers,San Diego State,Jalen McDaniels,205.74,92.98636,SF,80,1913,281,617,0.455,77,232,0.332,116,138,0.841,63,283,346,130,83,34,93,209,755,336,155,22,-110,-234,94,136.3,-250,-113.69999999999999,0.4554294975688817,0.33189655172413796,0.8405797101449275
2022,Philadelphia 76ers,San Diego State,Jalen McDaniels,205.74,92.98636,SF,80,1913,281,617,0.455,77,232,0.332,116,138,0.841,63,283,346,130,83,34,93,209,755,336,155,22,-110,-234,94,136.3,-250,-113.69999999999999,0.4554294975688817,0.33189655172413796,0.8405797101449275
2022,Philadelphia 76ers,San Diego State,Jalen McDaniels,205.74,92.98636,SF,80,1913,281,617,0.455,77,232,0.332,116,138,0.841,63,283,346,130,83,34,93,209,755,336,155,22,-110,-234,94,136.3,-250,-113.69999999999999,0.4554294975688817,0.33189655172413796,0.8405797101449275
2022,Philadelphia 76ers,San Diego State,Jalen McDaniels,205.74,92.98636,SF,80,1913,281,617,0.455,77,232,0.332,116,138,0.841,63,283,346,130,83,34,93,209,755,336,155,22,-110,-234,94,136.3,-250,-113.69999999999999,0.4554294975688817,0.33189655172413796,0.8405797101449275
2022,Philadelphia 76ers,San Diego State,Jalen McDaniels,205.74,92.98636,SF,80,1913,281,617,0.455,77,232,0.332,116,138,0.841,63,283,346,130,83,34,93,209,755,336,155,22,-110,-234,94,136.3,-250,-113.69999999999999,0.4554294975688817,0.33189655172413796,0.8405797101449275
2022,Philadelphia 76ers,San Diego State,Jalen McDaniels,205.74,92.98636,SF,80,1913,281,617,0.455,77,232,0.332,116,138,0.841,63,283,346,130,83,34,93,209,755,336,155,22,-110,-234,94,136.3,-250,-113.69999999999999,0.4554294975688817,0.33189655172413796,0.8405797101449275
2022,Philadelphia 76ers,San Diego State,Jalen McDaniels,205.74,92.98636,SF,80,1913,281,617,0.455,77,232,0.332,116,138,0.841,63,283,346,130,83,34,93,209,755,336,155,22,-110,-234,94,136.3,-250,-113.69999999999999,0.4554294975688817,0.33189655172413796,0.8405797101449275
2022,New Orleans Pelicans,Duke,Zion Williamson,198.12,128.820128,PF,29,956,285,469,0.608,7,19,0.368,177,248,0.714,58,144,202,133,32,16,99,65,754,184,12,71,202,-15,106,69.5,293,362.5,0.6076759061833689,0.3684210526315789,0.7137096774193549
2022,Milwaukee Bucks,Duke,Grayson Allen,193.04,89.811216,SG,72,1972,245,557,0.44,146,366,0.399,114,126,0.905,61,176,237,163,62,14,72,117,750,312,220,12,-134,-222,102,111.4,-254,-142.6,0.4398563734290844,0.3989071038251366,0.9047619047619048
2022,New York Knicks,Villanova,Josh Hart,193.04,97.52228,SF,76,2454,275,520,0.529,61,164,0.372,132,176,0.75,142,451,593,290,88,21,117,195,743,245,103,44,60,-126,88,242.5,22,264.5,0.5288461538461539,0.3719512195121951,0.75
2022,New York Knicks,Villanova,Josh Hart,193.04,97.52228,SF,76,2454,275,520,0.529,61,164,0.372,132,176,0.75,142,451,593,290,88,21,117,195,743,245,103,44,60,-126,88,242.5,22,264.5,0.5288461538461539,0.3719512195121951,0.75
2022,New York Knicks,Villanova,Josh Hart,193.04,97.52228,SF,76,2454,275,520,0.529,61,164,0.372,132,176,0.75,142,451,593,290,88,21,117,195,743,245,103,44,60,-126,88,242.5,22,264.5,0.5288461538461539,0.3719512195121951,0.75
2022,New York Knicks,Villanova,Josh Hart,193.04,97.52228,SF,76,2454,275,520,0.529,61,164,0.372,132,176,0.75,142,451,593,290,88,21,117,195,743,245,103,44,60,-126,88,242.5,22,264.5,0.5288461538461539,0.3719512195121951,0.75
2022,New York Knicks,Villanova,Josh Hart,193.04,97.52228,SF,76,2454,275,520,0.529,61,164,0.372,132,176,0.75,142,451,593,290,88,21,117,195,743,245,103,44,60,-126,88,242.5,22,264.5,0.5288461538461539,0.3719512195121951,0.75
2022,New York Knicks,Villanova,Josh Hart,193.04,97.52228,SF,76,2454,275,520,0.529,61,164,0.372,132,176,0.75,142,451,593,290,88,21,117,195,743,245,103,44,60,-126,88,242.5,22,264.5,0.5288461538461539,0.3719512195121951,0.75
2022,New York Knicks,Villanova,Josh Hart,193.04,97.52228,SF,76,2454,275,520,0.529,61,164,0.372,132,176,0.75,142,451,593,290,88,21,117,195,743,245,103,44,60,-126,88,242.5,22,264.5,0.5288461538461539,0.3719512195121951,0.75
2022,New York Knicks,Villanova,Josh Hart,193.04,97.52228,SF,76,2454,275,520,0.529,61,164,0.372,132,176,0.75,142,451,593,290,88,21,117,195,743,245,103,44,60,-126,88,242.5,22,264.5,0.5288461538461539,0.3719512195121951,0.75
2022,New York Knicks,Villanova,Josh Hart,193.04,97.52228,SF,76,2454,275,520,0.529,61,164,0.372,132,176,0.75,142,451,593,290,88,21,117,195,743,245,103,44,60,-126,88,242.5,22,264.5,0.5288461538461539,0.3719512195121951,0.75
2022,Indiana Pacers,Vanderbilt,Aaron Nesmith,195.58,97.52228,SF,73,1816,252,590,0.427,115,314,0.366,119,142,0.838,62,215,277,98,55,34,75,235,738,338,199,23,-172,-252,96,104.5,-328,-223.5,0.4271186440677966,0.3662420382165605,0.8380281690140845
2022,Charlotte Hornets,Butler,Gordon Hayward,200.66,102.0582,SF,50,1577,276,581,0.475,52,160,0.325,129,159,0.811,33,182,215,206,42,12,99,70,733,305,108,30,-58,-168,99,87.5,-127,-39.5,0.4750430292598967,0.325,0.8113207547169812
2022,San Antonio Spurs,Gonzaga,Zach Collins,210.82,113.398,C,63,1441,284,548,0.518,55,147,0.374,108,142,0.761,116,286,402,180,37,49,129,199,731,264,92,34,40,-111,74,143.05,3,146.05,0.5182481751824818,0.3741496598639456,0.7605633802816901
2022,Chicago Bulls,North Carolina,Coby White,195.58,88.45044,SG,74,1730,263,594,0.443,128,344,0.372,61,70,0.871,16,196,212,204,54,6,74,122,715,331,216,9,-136,-264,52,94.9,-348,-253.1,0.44276094276094274,0.37209302325581395,0.8714285714285714
2022,Los Angeles Clippers,Florida State,Terance Mann,195.58,97.52228,SG,81,1872,272,524,0.519,77,198,0.389,92,118,0.78,77,199,276,184,42,22,80,149,713,252,121,26,40,-132,66,118.8,-26,92.8,0.5190839694656488,0.3888888888888889,0.7796610169491526
2022,Toronto Raptors,Oregon,Chris Boucher,205.74,90.7184,PF,76,1523,261,529,0.493,62,189,0.328,128,168,0.762,157,264,421,29,47,64,41,143,712,268,127,40,-14,-195,88,179.6,-121,58.599999999999994,0.4933837429111531,0.328042328042328,0.7619047619047619
2022,Indiana Pacers,Gonzaga,Andrew Nembhard,190.5,86.636072,SG,75,2074,284,644,0.441,92,263,0.35,49,62,0.79,35,164,199,341,70,13,126,179,709,360,171,13,-152,-237,36,113.3,-353,-239.7,0.4409937888198758,0.34980988593155893,0.7903225806451613
2022,Los Angeles Lakers,Gonzaga,Rui Hachimura,203.2,104.32616,PF,63,1466,284,584,0.486,51,160,0.319,88,119,0.739,53,230,283,58,19,26,53,72,707,300,109,31,-32,-174,57,90.9,-149,-58.099999999999994,0.4863013698630137,0.31875,0.7394957983193278
2022,Los Angeles Lakers,Gonzaga,Rui Hachimura,203.2,104.32616,PF,63,1466,284,584,0.486,51,160,0.319,88,119,0.739,53,230,283,58,19,26,53,72,707,300,109,31,-32,-174,57,90.9,-149,-58.099999999999994,0.4863013698630137,0.31875,0.7394957983193278
2022,Los Angeles Lakers,Gonzaga,Rui Hachimura,203.2,104.32616,PF,63,1466,284,584,0.486,51,160,0.319,88,119,0.739,53,230,283,58,19,26,53,72,707,300,109,31,-32,-174,57,90.9,-149,-58.099999999999994,0.4863013698630137,0.31875,0.7394957983193278
2022,Los Angeles Lakers,Gonzaga,Rui Hachimura,203.2,104.32616,PF,63,1466,284,584,0.486,51,160,0.319,88,119,0.739,53,230,283,58,19,26,53,72,707,300,109,31,-32,-174,57,90.9,-149,-58.099999999999994,0.4863013698630137,0.31875,0.7394957983193278
2022,Los Angeles Lakers,Gonzaga,Rui Hachimura,203.2,104.32616,PF,63,1466,284,584,0.486,51,160,0.319,88,119,0.739,53,230,283,58,19,26,53,72,707,300,109,31,-32,-174,57,90.9,-149,-58.099999999999994,0.4863013698630137,0.31875,0.7394957983193278
2022,Los Angeles Lakers,Gonzaga,Rui Hachimura,203.2,104.32616,PF,63,1466,284,584,0.486,51,160,0.319,88,119,0.739,53,230,283,58,19,26,53,72,707,300,109,31,-32,-174,57,90.9,-149,-58.099999999999994,0.4863013698630137,0.31875,0.7394957983193278
2022,Los Angeles Lakers,Gonzaga,Rui Hachimura,203.2,104.32616,PF,63,1466,284,584,0.486,51,160,0.319,88,119,0.739,53,230,283,58,19,26,53,72,707,300,109,31,-32,-174,57,90.9,-149,-58.099999999999994,0.4863013698630137,0.31875,0.7394957983193278
2022,Los Angeles Lakers,Gonzaga,Rui Hachimura,203.2,104.32616,PF,63,1466,284,584,0.486,51,160,0.319,88,119,0.739,53,230,283,58,19,26,53,72,707,300,109,31,-32,-174,57,90.9,-149,-58.099999999999994,0.4863013698630137,0.31875,0.7394957983193278
2022,Los Angeles Lakers,Gonzaga,Rui Hachimura,203.2,104.32616,PF,63,1466,284,584,0.486,51,160,0.319,88,119,0.739,53,230,283,58,19,26,53,72,707,300,109,31,-32,-174,57,90.9,-149,-58.099999999999994,0.4863013698630137,0.31875,0.7394957983193278
2022,Washington Wizards,Arkansas,Daniel Gafford,208.28,106.140528,C,78,1604,289,395,0.732,0,0,0.0,127,187,0.679,163,270,433,84,33,99,85,187,705,106,0,60,366,0,67,184.15,433,617.15,0.7316455696202532,,0.679144385026738
2022,Minnesota Timberwolves,Washington,Jaylen Nowell,193.04,91.171992,SG,65,1252,280,625,0.448,67,232,0.289,77,99,0.778,36,134,170,132,42,5,65,101,704,345,165,22,-130,-294,55,70.45,-369,-298.55,0.448,0.28879310344827586,0.7777777777777778
2022,San Antonio Spurs,Florida State,Devin Vassell,195.58,90.7184,SG,38,1178,261,595,0.439,103,266,0.387,78,100,0.78,8,140,148,136,43,17,57,57,703,334,163,22,-146,-180,56,71.65,-270,-198.35,0.43865546218487395,0.38721804511278196,0.78
2022,Boston Celtics,Oklahoma State,Marcus Smart,193.04,99.79024,PG,61,1957,250,602,0.415,115,342,0.336,88,118,0.746,46,145,191,382,93,23,143,172,703,352,227,30,-204,-336,58,132.65,-482,-349.35,0.4152823920265781,0.3362573099415205,0.7457627118644068
2022,New Orleans Pelicans,Xavier,Naji Marshall,200.66,99.79024,SF,77,1792,247,571,0.433,66,218,0.303,138,175,0.789,48,231,279,189,54,14,97,113,698,324,152,37,-154,-258,101,108.85,-311,-202.15,0.43257443082311736,0.30275229357798167,0.7885714285714286
2022,Utah Jazz,Iowa State,Talen Horton-Tucker,193.04,106.140528,SG,65,1313,257,613,0.419,58,203,0.286,126,168,0.75,41,169,210,246,41,29,126,108,698,356,145,42,-198,-261,84,90.85,-375,-284.15,0.4192495921696574,0.2857142857142857,0.75
2022,Washington Wizards,,Deni Avdija,205.74,95.25432,SF,76,2020,253,579,0.437,69,232,0.297,122,165,0.739,74,413,487,211,65,29,123,209,697,326,163,43,-146,-282,79,168.05,-349,-180.95,0.4369602763385147,0.2974137931034483,0.7393939393939394
2022,Memphis Grizzlies,Loyola-Maryland,Santi Aldama,213.36,97.52228,PF,77,1682,247,525,0.47,94,266,0.353,108,144,0.75,85,286,371,97,45,48,60,143,696,278,172,36,-62,-234,72,147.6,-224,-76.4,0.4704761904761905,0.3533834586466165,0.75
2022,Denver Nuggets,Boston College,Reggie Jackson,187.96,94.347136,PG,68,1657,263,640,0.411,96,288,0.333,71,78,0.91,25,119,144,233,47,6,115,114,693,377,192,7,-228,-288,64,63.8,-452,-388.2,0.4109375,0.3333333333333333,0.9102564102564102
2022,Denver Nuggets,Boston College,Reggie Jackson,187.96,94.347136,PG,68,1657,263,640,0.411,96,288,0.333,71,78,0.91,25,119,144,233,47,6,115,114,693,377,192,7,-228,-288,64,63.8,-452,-388.2,0.4109375,0.3333333333333333,0.9102564102564102
2022,Denver Nuggets,Boston College,Reggie Jackson,187.96,94.347136,PG,68,1657,263,640,0.411,96,288,0.333,71,78,0.91,25,119,144,233,47,6,115,114,693,377,192,7,-228,-288,64,63.8,-452,-388.2,0.4109375,0.3333333333333333,0.9102564102564102
2022,Denver Nuggets,Boston College,Reggie Jackson,187.96,94.347136,PG,68,1657,263,640,0.411,96,288,0.333,71,78,0.91,25,119,144,233,47,6,115,114,693,377,192,7,-228,-288,64,63.8,-452,-388.2,0.4109375,0.3333333333333333,0.9102564102564102
2022,Denver Nuggets,Boston College,Reggie Jackson,187.96,94.347136,PG,68,1657,263,640,0.411,96,288,0.333,71,78,0.91,25,119,144,233,47,6,115,114,693,377,192,7,-228,-288,64,63.8,-452,-388.2,0.4109375,0.3333333333333333,0.9102564102564102
2022,Denver Nuggets,Boston College,Reggie Jackson,187.96,94.347136,PG,68,1657,263,640,0.411,96,288,0.333,71,78,0.91,25,119,144,233,47,6,115,114,693,377,192,7,-228,-288,64,63.8,-452,-388.2,0.4109375,0.3333333333333333,0.9102564102564102
2022,Denver Nuggets,Boston College,Reggie Jackson,187.96,94.347136,PG,68,1657,263,640,0.411,96,288,0.333,71,78,0.91,25,119,144,233,47,6,115,114,693,377,192,7,-228,-288,64,63.8,-452,-388.2,0.4109375,0.3333333333333333,0.9102564102564102
2022,Denver Nuggets,Boston College,Reggie Jackson,187.96,94.347136,PG,68,1657,263,640,0.411,96,288,0.333,71,78,0.91,25,119,144,233,47,6,115,114,693,377,192,7,-228,-288,64,63.8,-452,-388.2,0.4109375,0.3333333333333333,0.9102564102564102
2022,Denver Nuggets,Boston College,Reggie Jackson,187.96,94.347136,PG,68,1657,263,640,0.411,96,288,0.333,71,78,0.91,25,119,144,233,47,6,115,114,693,377,192,7,-228,-288,64,63.8,-452,-388.2,0.4109375,0.3333333333333333,0.9102564102564102
2022,Oklahoma City Thunder,Arkansas,Isaiah Joe,190.5,74.84268,SG,73,1395,224,508,0.441,161,394,0.409,82,100,0.82,27,148,175,88,48,8,39,105,691,284,233,18,-120,-216,64,75.75,-272,-196.25,0.4409448818897638,0.4086294416243655,0.82
2022,Chicago Bulls,Illinois,Ayo Dosunmu,195.58,90.7184,SG,80,2098,281,570,0.493,59,189,0.312,66,82,0.805,45,175,220,206,62,26,99,182,687,289,130,16,-16,-213,50,103.15,-179,-75.85,0.49298245614035086,0.31216931216931215,0.8048780487804879
2022,Utah Jazz,Alabama,Collin Sexton,187.96,86.18248,PG,48,1145,237,468,0.506,48,122,0.393,163,199,0.819,37,68,105,138,27,6,85,112,685,231,74,36,12,-78,127,38.4,61,99.4,0.5064102564102564,0.39344262295081966,0.8190954773869347
2022,Miami Heat,Nevada,Caleb Martin,195.58,92.98636,SF,71,2078,254,548,0.464,84,236,0.356,91,113,0.805,88,256,344,117,71,31,78,145,683,294,152,22,-80,-204,69,142.0,-215,-73.0,0.4635036496350365,0.3559322033898305,0.8053097345132744
2022,Utah Jazz,Auburn,Walker Kessler,213.36,111.13004,C,74,1703,298,414,0.72,1,3,0.333,82,159,0.516,231,389,620,69,26,173,58,169,679,116,2,77,364,-3,5,292.05,366,658.05,0.7198067632850241,0.3333333333333333,0.5157232704402516
2022,Golden State Warriors,Villanova,Donte DiVincenzo,193.04,92.079176,SG,72,1894,235,540,0.435,150,378,0.397,58,71,0.817,80,245,325,252,97,10,112,133,678,305,228,13,-140,-234,45,155.1,-329,-173.9,0.4351851851851852,0.3968253968253968,0.8169014084507042
2022,San Antonio Spurs,Ohio State,Malaki Branham,193.04,81.64656,SG,66,1550,269,611,0.44,77,255,0.302,58,70,0.829,28,153,181,127,33,7,76,115,673,342,178,12,-146,-303,46,60.25,-403,-342.75,0.4402618657937807,0.30196078431372547,0.8285714285714286
2022,Brooklyn Nets,Baylor,Royce O'Neale,198.12,102.511792,SF,76,2409,229,593,0.386,163,419,0.389,50,69,0.725,55,329,384,283,65,49,114,239,671,364,256,19,-270,-279,31,168.55,-518,-349.45,0.38617200674536256,0.38902147971360385,0.7246376811594203
2022,Cleveland Cavaliers,,Cedi Osman,200.66,104.32616,SF,77,1548,239,530,0.451,116,312,0.372,75,108,0.694,25,151,176,115,35,11,52,122,669,291,196,33,-104,-240,42,69.9,-302,-232.1,0.4509433962264151,0.3717948717948718,0.6944444444444444
2022,Golden State Warriors,,Jonathan Kuminga,200.66,102.0582,PF,67,1394,261,497,0.525,54,146,0.37,90,138,0.652,70,161,231,125,41,31,95,157,666,236,92,48,50,-114,42,87.15,-22,65.15,0.5251509054325956,0.3698630136986301,0.6521739130434783
2022,Los Angeles Clippers,Virginia Commonwealth,Bones Hyland,187.96,76.657048,PG,56,1086,228,571,0.399,117,315,0.371,86,102,0.843,20,115,135,172,39,15,82,96,659,343,198,16,-230,-243,70,62.95,-403,-340.05,0.39929947460595444,0.37142857142857144,0.8431372549019608
2022,Los Angeles Clippers,Virginia Commonwealth,Bones Hyland,187.96,76.657048,PG,56,1086,228,571,0.399,117,315,0.371,86,102,0.843,20,115,135,172,39,15,82,96,659,343,198,16,-230,-243,70,62.95,-403,-340.05,0.39929947460595444,0.37142857142857144,0.8431372549019608
2022,Los Angeles Clippers,Virginia Commonwealth,Bones Hyland,187.96,76.657048,PG,56,1086,228,571,0.399,117,315,0.371,86,102,0.843,20,115,135,172,39,15,82,96,659,343,198,16,-230,-243,70,62.95,-403,-340.05,0.39929947460595444,0.37142857142857144,0.8431372549019608
2022,Los Angeles Clippers,Virginia Commonwealth,Bones Hyland,187.96,76.657048,PG,56,1086,228,571,0.399,117,315,0.371,86,102,0.843,20,115,135,172,39,15,82,96,659,343,198,16,-230,-243,70,62.95,-403,-340.05,0.39929947460595444,0.37142857142857144,0.8431372549019608
2022,Los Angeles Clippers,Virginia Commonwealth,Bones Hyland,187.96,76.657048,PG,56,1086,228,571,0.399,117,315,0.371,86,102,0.843,20,115,135,172,39,15,82,96,659,343,198,16,-230,-243,70,62.95,-403,-340.05,0.39929947460595444,0.37142857142857144,0.8431372549019608
2022,Los Angeles Clippers,Virginia Commonwealth,Bones Hyland,187.96,76.657048,PG,56,1086,228,571,0.399,117,315,0.371,86,102,0.843,20,115,135,172,39,15,82,96,659,343,198,16,-230,-243,70,62.95,-403,-340.05,0.39929947460595444,0.37142857142857144,0.8431372549019608
2022,Los Angeles Clippers,Virginia Commonwealth,Bones Hyland,187.96,76.657048,PG,56,1086,228,571,0.399,117,315,0.371,86,102,0.843,20,115,135,172,39,15,82,96,659,343,198,16,-230,-243,70,62.95,-403,-340.05,0.39929947460595444,0.37142857142857144,0.8431372549019608
2022,Los Angeles Clippers,Virginia Commonwealth,Bones Hyland,187.96,76.657048,PG,56,1086,228,571,0.399,117,315,0.371,86,102,0.843,20,115,135,172,39,15,82,96,659,343,198,16,-230,-243,70,62.95,-403,-340.05,0.39929947460595444,0.37142857142857144,0.8431372549019608
2022,Los Angeles Clippers,Virginia Commonwealth,Bones Hyland,187.96,76.657048,PG,56,1086,228,571,0.399,117,315,0.371,86,102,0.843,20,115,135,172,39,15,82,96,659,343,198,16,-230,-243,70,62.95,-403,-340.05,0.39929947460595444,0.37142857142857144,0.8431372549019608
2022,San Antonio Spurs,Creighton,Doug McDermott,198.12,102.0582,SF,64,1314,239,523,0.457,123,298,0.413,53,70,0.757,23,115,138,91,13,6,58,118,654,284,175,17,-90,-156,36,37.6,-210,-172.4,0.4569789674952199,0.412751677852349,0.7571428571428571
2022,New Orleans Pelicans,Tennessee,Josh Richardson,198.12,90.7184,SG,65,1530,239,554,0.431,107,293,0.365,69,81,0.852,41,134,175,174,69,20,86,117,654,315,186,12,-152,-237,57,93.15,-332,-238.85,0.4314079422382672,0.3651877133105802,0.8518518518518519
2022,New Orleans Pelicans,Tennessee,Josh Richardson,198.12,90.7184,SG,65,1530,239,554,0.431,107,293,0.365,69,81,0.852,41,134,175,174,69,20,86,117,654,315,186,12,-152,-237,57,93.15,-332,-238.85,0.4314079422382672,0.3651877133105802,0.8518518518518519
2022,New Orleans Pelicans,Tennessee,Josh Richardson,198.12,90.7184,SG,65,1530,239,554,0.431,107,293,0.365,69,81,0.852,41,134,175,174,69,20,86,117,654,315,186,12,-152,-237,57,93.15,-332,-238.85,0.4314079422382672,0.3651877133105802,0.8518518518518519
2022,New Orleans Pelicans,Tennessee,Josh Richardson,198.12,90.7184,SG,65,1530,239,554,0.431,107,293,0.365,69,81,0.852,41,134,175,174,69,20,86,117,654,315,186,12,-152,-237,57,93.15,-332,-238.85,0.4314079422382672,0.3651877133105802,0.8518518518518519
2022,New Orleans Pelicans,Tennessee,Josh Richardson,198.12,90.7184,SG,65,1530,239,554,0.431,107,293,0.365,69,81,0.852,41,134,175,174,69,20,86,117,654,315,186,12,-152,-237,57,93.15,-332,-238.85,0.4314079422382672,0.3651877133105802,0.8518518518518519
2022,New Orleans Pelicans,Tennessee,Josh Richardson,198.12,90.7184,SG,65,1530,239,554,0.431,107,293,0.365,69,81,0.852,41,134,175,174,69,20,86,117,654,315,186,12,-152,-237,57,93.15,-332,-238.85,0.4314079422382672,0.3651877133105802,0.8518518518518519
2022,New Orleans Pelicans,Tennessee,Josh Richardson,198.12,90.7184,SG,65,1530,239,554,0.431,107,293,0.365,69,81,0.852,41,134,175,174,69,20,86,117,654,315,186,12,-152,-237,57,93.15,-332,-238.85,0.4314079422382672,0.3651877133105802,0.8518518518518519
2022,New Orleans Pelicans,Tennessee,Josh Richardson,198.12,90.7184,SG,65,1530,239,554,0.431,107,293,0.365,69,81,0.852,41,134,175,174,69,20,86,117,654,315,186,12,-152,-237,57,93.15,-332,-238.85,0.4314079422382672,0.3651877133105802,0.8518518518518519
2022,New Orleans Pelicans,Tennessee,Josh Richardson,198.12,90.7184,SG,65,1530,239,554,0.431,107,293,0.365,69,81,0.852,41,134,175,174,69,20,86,117,654,315,186,12,-152,-237,57,93.15,-332,-238.85,0.4314079422382672,0.3651877133105802,0.8518518518518519
2022,Los Angeles Lakers,Miami,Lonnie Walker IV,193.04,92.532768,SG,56,1297,236,527,0.448,91,249,0.365,91,106,0.858,14,95,109,64,30,17,46,71,654,291,158,15,-110,-201,76,43.7,-235,-191.3,0.4478178368121442,0.3654618473895582,0.8584905660377359
2022,Detroit Pistons,Colorado,Alec Burks,198.12,97.068688,SG,51,1122,200,459,0.436,99,239,0.414,153,188,0.814,19,139,158,114,38,8,58,98,652,259,140,35,-118,-123,118,61.85,-123,-61.15,0.4357298474945534,0.41422594142259417,0.8138297872340425
2022,Milwaukee Bucks,West Virginia,Jevon Carter,185.42,90.7184,PG,81,1812,239,565,0.423,142,337,0.421,31,38,0.816,35,167,202,197,66,29,78,158,651,326,195,7,-174,-159,24,109.1,-309,-199.9,0.4230088495575221,0.42136498516320475,0.8157894736842105
2022,Brooklyn Nets,North Carolina,Cameron Johnson,203.2,95.25432,PF,42,1200,223,474,0.47,103,255,0.404,101,120,0.842,34,151,185,78,50,14,37,83,650,251,152,19,-56,-147,82,83.6,-121,-37.400000000000006,0.4704641350210971,0.403921568627451,0.8416666666666667
2022,Brooklyn Nets,North Carolina,Cameron Johnson,203.2,95.25432,PF,42,1200,223,474,0.47,103,255,0.404,101,120,0.842,34,151,185,78,50,14,37,83,650,251,152,19,-56,-147,82,83.6,-121,-37.400000000000006,0.4704641350210971,0.403921568627451,0.8416666666666667
2022,Brooklyn Nets,North Carolina,Cameron Johnson,203.2,95.25432,PF,42,1200,223,474,0.47,103,255,0.404,101,120,0.842,34,151,185,78,50,14,37,83,650,251,152,19,-56,-147,82,83.6,-121,-37.400000000000006,0.4704641350210971,0.403921568627451,0.8416666666666667
2022,Brooklyn Nets,North Carolina,Cameron Johnson,203.2,95.25432,PF,42,1200,223,474,0.47,103,255,0.404,101,120,0.842,34,151,185,78,50,14,37,83,650,251,152,19,-56,-147,82,83.6,-121,-37.400000000000006,0.4704641350210971,0.403921568627451,0.8416666666666667
2022,Brooklyn Nets,North Carolina,Cameron Johnson,203.2,95.25432,PF,42,1200,223,474,0.47,103,255,0.404,101,120,0.842,34,151,185,78,50,14,37,83,650,251,152,19,-56,-147,82,83.6,-121,-37.400000000000006,0.4704641350210971,0.403921568627451,0.8416666666666667
2022,Brooklyn Nets,North Carolina,Cameron Johnson,203.2,95.25432,PF,42,1200,223,474,0.47,103,255,0.404,101,120,0.842,34,151,185,78,50,14,37,83,650,251,152,19,-56,-147,82,83.6,-121,-37.400000000000006,0.4704641350210971,0.403921568627451,0.8416666666666667
2022,Brooklyn Nets,North Carolina,Cameron Johnson,203.2,95.25432,PF,42,1200,223,474,0.47,103,255,0.404,101,120,0.842,34,151,185,78,50,14,37,83,650,251,152,19,-56,-147,82,83.6,-121,-37.400000000000006,0.4704641350210971,0.403921568627451,0.8416666666666667
2022,Brooklyn Nets,North Carolina,Cameron Johnson,203.2,95.25432,PF,42,1200,223,474,0.47,103,255,0.404,101,120,0.842,34,151,185,78,50,14,37,83,650,251,152,19,-56,-147,82,83.6,-121,-37.400000000000006,0.4704641350210971,0.403921568627451,0.8416666666666667
2022,Brooklyn Nets,North Carolina,Cameron Johnson,203.2,95.25432,PF,42,1200,223,474,0.47,103,255,0.404,101,120,0.842,34,151,185,78,50,14,37,83,650,251,152,19,-56,-147,82,83.6,-121,-37.400000000000006,0.4704641350210971,0.403921568627451,0.8416666666666667
2022,Indiana Pacers,Arizona,T.J. McConnell,185.42,86.18248,PG,75,1526,283,521,0.543,26,59,0.441,58,68,0.853,45,189,234,397,81,10,143,105,650,238,33,10,90,-21,48,137.75,117,254.75,0.5431861804222649,0.4406779661016949,0.8529411764705882
2022,New Orleans Pelicans,Alabama,Herbert Jones,200.66,93.439952,PF,66,1951,235,501,0.469,56,167,0.335,123,161,0.764,97,172,269,162,103,42,88,208,649,266,111,38,-62,-165,85,150.1,-142,8.099999999999994,0.469061876247505,0.33532934131736525,0.7639751552795031
2022,San Antonio Spurs,Ohio State,Keita Bates-Diop,203.2,103.872568,PF,67,1453,236,465,0.508,56,142,0.394,119,150,0.793,65,183,248,103,46,20,56,63,647,229,86,31,14,-90,88,105.85,12,117.85,0.5075268817204301,0.39436619718309857,0.7933333333333333
2022,Minnesota Timberwolves,UCLA,Kyle Anderson,205.74,104.32616,PF,69,1957,252,495,0.509,43,105,0.41,100,136,0.735,66,302,368,335,78,63,103,146,647,243,62,36,18,-57,64,203.95,25,228.95,0.509090909090909,0.4095238095238095,0.7352941176470589
2022,Indiana Pacers,Maryland,Jalen Smith,205.74,97.52228,C,68,1279,242,508,0.476,54,191,0.283,104,137,0.759,129,265,394,66,21,60,72,153,642,266,137,33,-48,-249,71,144.1,-226,-81.9,0.4763779527559055,0.28272251308900526,0.7591240875912408
2022,Miami Heat,California-Santa Barbara,Gabe Vincent,187.96,90.7184,PG,68,1759,228,567,0.402,117,350,0.334,68,78,0.872,27,118,145,167,62,5,92,154,641,339,233,10,-222,-348,58,64.55,-512,-447.45,0.4021164021164021,0.3342857142857143,0.8717948717948718
2022,Boston Celtics,Tennessee,Grant Williams,198.12,107.047712,PF,79,2045,216,476,0.454,115,291,0.395,94,122,0.77,87,276,363,131,41,31,82,192,641,260,176,28,-88,-183,66,130.65,-205,-74.35,0.453781512605042,0.3951890034364261,0.7704918032786885
2022,Atlanta Hawks,Duke,AJ Griffin,198.12,99.79024,SF,72,1401,248,533,0.465,101,259,0.39,42,47,0.894,37,116,153,73,42,12,42,87,639,285,158,5,-74,-171,37,67.4,-208,-140.6,0.4652908067542214,0.38996138996138996,0.8936170212765957
2022,Philadelphia 76ers,Iowa State,Georges Niang,200.66,104.32616,PF,78,1512,222,502,0.442,154,384,0.401,39,45,0.867,19,166,185,77,30,14,54,145,637,280,230,6,-116,-228,33,58.0,-311,-253.0,0.44223107569721115,0.4010416666666667,0.8666666666666667
2022,Philadelphia 76ers,Southern Methodist,Shake Milton,195.58,92.98636,SG,76,1567,241,503,0.479,56,148,0.378,99,116,0.853,39,152,191,240,25,13,94,123,637,262,92,17,-42,-108,82,83.35,-68,15.349999999999994,0.47912524850894633,0.3783783783783784,0.853448275862069
2022,Washington Wizards,Iowa State,Monte Morris,187.96,83.007336,PG,62,1696,247,515,0.48,78,204,0.382,64,77,0.831,26,184,210,326,43,13,60,75,636,268,126,13,-42,-144,51,134.75,-135,-0.25,0.4796116504854369,0.38235294117647056,0.8311688311688312
2022,Orlando Magic,Oregon,Bol Bol,218.44,99.79024,PF,70,1505,261,478,0.546,30,113,0.265,82,108,0.759,69,336,405,69,30,85,112,92,634,217,83,26,88,-159,56,132.65,-15,117.65,0.5460251046025104,0.26548672566371684,0.7592592592592593
2022,Golden State Warriors,Kansas,Andrew Wiggins,200.66,89.357624,SF,37,1190,250,529,0.473,89,225,0.396,44,72,0.611,61,125,186,85,45,28,48,107,633,279,136,28,-58,-141,16,90.15,-183,-92.85,0.4725897920604915,0.39555555555555555,0.6111111111111112
2022,Los Angeles Lakers,Kentucky,Jarred Vanderbilt,203.2,97.068688,PF,78,1880,247,451,0.548,29,90,0.322,96,139,0.691,170,412,582,184,83,21,97,190,619,204,61,43,86,-96,53,228.0,43,271.0,0.5476718403547672,0.32222222222222224,0.6906474820143885
2022,Los Angeles Lakers,Kentucky,Jarred Vanderbilt,203.2,97.068688,PF,78,1880,247,451,0.548,29,90,0.322,96,139,0.691,170,412,582,184,83,21,97,190,619,204,61,43,86,-96,53,228.0,43,271.0,0.5476718403547672,0.32222222222222224,0.6906474820143885
2022,Los Angeles Lakers,Kentucky,Jarred Vanderbilt,203.2,97.068688,PF,78,1880,247,451,0.548,29,90,0.322,96,139,0.691,170,412,582,184,83,21,97,190,619,204,61,43,86,-96,53,228.0,43,271.0,0.5476718403547672,0.32222222222222224,0.6906474820143885
2022,Los Angeles Lakers,Kentucky,Jarred Vanderbilt,203.2,97.068688,PF,78,1880,247,451,0.548,29,90,0.322,96,139,0.691,170,412,582,184,83,21,97,190,619,204,61,43,86,-96,53,228.0,43,271.0,0.5476718403547672,0.32222222222222224,0.6906474820143885
2022,Los Angeles Lakers,Kentucky,Jarred Vanderbilt,203.2,97.068688,PF,78,1880,247,451,0.548,29,90,0.322,96,139,0.691,170,412,582,184,83,21,97,190,619,204,61,43,86,-96,53,228.0,43,271.0,0.5476718403547672,0.32222222222222224,0.6906474820143885
2022,Los Angeles Lakers,Kentucky,Jarred Vanderbilt,203.2,97.068688,PF,78,1880,247,451,0.548,29,90,0.322,96,139,0.691,170,412,582,184,83,21,97,190,619,204,61,43,86,-96,53,228.0,43,271.0,0.5476718403547672,0.32222222222222224,0.6906474820143885
2022,Los Angeles Lakers,Kentucky,Jarred Vanderbilt,203.2,97.068688,PF,78,1880,247,451,0.548,29,90,0.322,96,139,0.691,170,412,582,184,83,21,97,190,619,204,61,43,86,-96,53,228.0,43,271.0,0.5476718403547672,0.32222222222222224,0.6906474820143885
2022,Los Angeles Lakers,Kentucky,Jarred Vanderbilt,203.2,97.068688,PF,78,1880,247,451,0.548,29,90,0.322,96,139,0.691,170,412,582,184,83,21,97,190,619,204,61,43,86,-96,53,228.0,43,271.0,0.5476718403547672,0.32222222222222224,0.6906474820143885
2022,Los Angeles Lakers,Kentucky,Jarred Vanderbilt,203.2,97.068688,PF,78,1880,247,451,0.548,29,90,0.322,96,139,0.691,170,412,582,184,83,21,97,190,619,204,61,43,86,-96,53,228.0,43,271.0,0.5476718403547672,0.32222222222222224,0.6906474820143885
2022,Golden State Warriors,Michigan State,Draymond Green,198.12,104.32616,PF,73,2298,250,474,0.527,40,131,0.305,77,108,0.713,66,459,525,500,74,60,204,229,617,224,91,31,52,-153,46,226.3,-55,171.3,0.5274261603375527,0.3053435114503817,0.7129629629629629
2022,Boston Celtics,Florida,Al Horford,205.74,108.86208,C,63,1921,228,479,0.476,145,325,0.446,15,21,0.714,73,317,390,189,30,61,37,121,616,251,180,6,-46,-105,9,183.95,-142,41.94999999999999,0.4759916492693111,0.4461538461538462,0.7142857142857143
2022,Miami Heat,Villanova,Kyle Lowry,182.88,88.904032,PG,55,1718,196,485,0.404,107,310,0.345,116,135,0.859,43,182,225,281,57,21,103,143,615,289,203,19,-186,-288,97,117.6,-377,-259.4,0.4041237113402062,0.34516129032258064,0.8592592592592593
2022,San Antonio Spurs,Baylor,Jeremy Sochan,203.2,104.32616,PF,56,1458,250,552,0.453,33,134,0.246,81,116,0.698,95,200,295,142,43,23,97,138,614,302,101,35,-104,-204,46,110.6,-262,-151.4,0.4528985507246377,0.2462686567164179,0.6982758620689655
2022,Detroit Pistons,Memphis,Jalen Duren,210.82,113.398,C,67,1670,258,398,0.648,0,2,0.0,96,157,0.611,229,366,595,75,44,59,92,182,612,140,2,61,236,-6,35,221.15,265,486.15,0.6482412060301508,0.0,0.6114649681528662
2022,Brooklyn Nets,Louisiana State,Cam Thomas,190.5,95.25432,SG,57,948,201,456,0.441,51,133,0.383,151,174,0.868,8,87,95,78,20,7,63,55,604,255,82,23,-108,-93,128,24.5,-73,-48.5,0.4407894736842105,0.38345864661654133,0.867816091954023
2022,Phoenix Suns,Drexel,Damion Lee,195.58,95.25432,SG,74,1506,200,452,0.442,110,247,0.445,94,104,0.904,39,186,225,99,30,7,78,118,604,252,137,10,-104,-81,84,64.35,-101,-36.650000000000006,0.4424778761061947,0.44534412955465585,0.9038461538461539
2022,Minnesota Timberwolves,Kentucky,Karl-Anthony Towns,213.36,112.490816,PF,29,957,212,428,0.495,60,164,0.366,118,135,0.874,48,188,236,140,20,17,86,111,602,216,104,17,-8,-132,101,75.95,-39,36.95,0.4953271028037383,0.36585365853658536,0.8740740740740741
2022,Orlando Magic,Michigan,Moritz Wagner,210.82,111.13004,C,57,1109,198,396,0.5,51,163,0.313,153,182,0.841,69,190,259,84,37,13,68,136,600,198,112,29,0,-183,124,87.2,-59,28.200000000000003,0.5,0.3128834355828221,0.8406593406593407
2022,Phoenix Suns,South Carolina Upstate,Torrey Craig,200.66,100.243832,PF,79,1948,228,500,0.456,100,253,0.395,32,45,0.711,145,281,426,117,50,62,73,179,588,272,153,13,-88,-159,19,182.55,-228,-45.44999999999999,0.456,0.3952569169960474,0.7111111111111111
2022,Denver Nuggets,Indiana,Thomas Bryant,208.28,112.490816,C,59,1082,230,369,0.623,26,59,0.441,93,126,0.738,86,253,339,31,16,30,38,102,579,139,33,33,182,-21,60,112.9,221,333.9,0.6233062330623306,0.4406779661016949,0.7380952380952381
2022,Denver Nuggets,Indiana,Thomas Bryant,208.28,112.490816,C,59,1082,230,369,0.623,26,59,0.441,93,126,0.738,86,253,339,31,16,30,38,102,579,139,33,33,182,-21,60,112.9,221,333.9,0.6233062330623306,0.4406779661016949,0.7380952380952381
2022,Denver Nuggets,Indiana,Thomas Bryant,208.28,112.490816,C,59,1082,230,369,0.623,26,59,0.441,93,126,0.738,86,253,339,31,16,30,38,102,579,139,33,33,182,-21,60,112.9,221,333.9,0.6233062330623306,0.4406779661016949,0.7380952380952381
2022,Denver Nuggets,Indiana,Thomas Bryant,208.28,112.490816,C,59,1082,230,369,0.623,26,59,0.441,93,126,0.738,86,253,339,31,16,30,38,102,579,139,33,33,182,-21,60,112.9,221,333.9,0.6233062330623306,0.4406779661016949,0.7380952380952381
2022,Denver Nuggets,Indiana,Thomas Bryant,208.28,112.490816,C,59,1082,230,369,0.623,26,59,0.441,93,126,0.738,86,253,339,31,16,30,38,102,579,139,33,33,182,-21,60,112.9,221,333.9,0.6233062330623306,0.4406779661016949,0.7380952380952381
2022,Denver Nuggets,Indiana,Thomas Bryant,208.28,112.490816,C,59,1082,230,369,0.623,26,59,0.441,93,126,0.738,86,253,339,31,16,30,38,102,579,139,33,33,182,-21,60,112.9,221,333.9,0.6233062330623306,0.4406779661016949,0.7380952380952381
2022,Denver Nuggets,Indiana,Thomas Bryant,208.28,112.490816,C,59,1082,230,369,0.623,26,59,0.441,93,126,0.738,86,253,339,31,16,30,38,102,579,139,33,33,182,-21,60,112.9,221,333.9,0.6233062330623306,0.4406779661016949,0.7380952380952381
2022,Denver Nuggets,Indiana,Thomas Bryant,208.28,112.490816,C,59,1082,230,369,0.623,26,59,0.441,93,126,0.738,86,253,339,31,16,30,38,102,579,139,33,33,182,-21,60,112.9,221,333.9,0.6233062330623306,0.4406779661016949,0.7380952380952381
2022,Denver Nuggets,Indiana,Thomas Bryant,208.28,112.490816,C,59,1082,230,369,0.623,26,59,0.441,93,126,0.738,86,253,339,31,16,30,38,102,579,139,33,33,182,-21,60,112.9,221,333.9,0.6233062330623306,0.4406779661016949,0.7380952380952381
2022,Golden State Warriors,UCLA,Kevon Looney,205.74,100.697424,C,82,1958,242,384,0.63,0,1,0.0,94,155,0.606,274,486,760,207,52,50,45,225,578,142,1,61,200,-3,33,327.5,230,557.5,0.6302083333333334,0.0,0.6064516129032258
2022,Detroit Pistons,Washington,Isaiah Stewart,203.2,113.398,C,50,1414,195,441,0.442,67,205,0.327,110,149,0.738,115,288,403,70,20,34,68,133,567,246,138,39,-102,-213,71,133.35,-244,-110.65,0.4421768707482993,0.32682926829268294,0.738255033557047
2022,Brooklyn Nets,Virginia,Joe Harris,198.12,99.79024,SF,74,1527,201,440,0.457,142,333,0.426,18,28,0.643,23,141,164,101,34,13,41,140,562,239,191,10,-76,-147,8,68.0,-215,-147.0,0.45681818181818185,0.4264264264264264,0.6428571428571429
2022,Sacramento Kings,Kentucky,Trey Lyles,205.74,106.140528,PF,74,1247,187,408,0.458,87,240,0.363,101,124,0.815,68,232,300,66,27,31,64,97,562,221,153,23,-68,-198,78,100.65,-188,-87.35,0.4583333333333333,0.3625,0.8145161290322581
2022,Brooklyn Nets,Duke,Seth Curry,185.42,83.91452,SG,61,1211,208,449,0.463,94,232,0.405,51,55,0.927,13,87,100,99,36,7,51,96,561,241,138,4,-66,-132,47,44.2,-151,-106.8,0.46325167037861914,0.4051724137931034,0.9272727272727272
2022,Memphis Grizzlies,Gonzaga,Brandon Clarke,203.2,97.52228,PF,56,1090,229,349,0.656,1,6,0.167,99,137,0.723,92,218,310,72,34,37,55,131,558,120,5,38,218,-12,61,119.95,267,386.95,0.6561604584527221,0.16666666666666666,0.7226277372262774
2022,Brooklyn Nets,Florida,Dorian Finney-Smith,200.66,99.79024,PF,66,2009,196,501,0.391,114,338,0.337,45,59,0.763,114,202,316,100,55,36,62,144,551,305,224,14,-218,-330,31,139.8,-517,-377.2,0.3912175648702595,0.33727810650887574,0.7627118644067796
2022,Brooklyn Nets,Florida,Dorian Finney-Smith,200.66,99.79024,PF,66,2009,196,501,0.391,114,338,0.337,45,59,0.763,114,202,316,100,55,36,62,144,551,305,224,14,-218,-330,31,139.8,-517,-377.2,0.3912175648702595,0.33727810650887574,0.7627118644067796
2022,Brooklyn Nets,Florida,Dorian Finney-Smith,200.66,99.79024,PF,66,2009,196,501,0.391,114,338,0.337,45,59,0.763,114,202,316,100,55,36,62,144,551,305,224,14,-218,-330,31,139.8,-517,-377.2,0.3912175648702595,0.33727810650887574,0.7627118644067796
2022,Brooklyn Nets,Florida,Dorian Finney-Smith,200.66,99.79024,PF,66,2009,196,501,0.391,114,338,0.337,45,59,0.763,114,202,316,100,55,36,62,144,551,305,224,14,-218,-330,31,139.8,-517,-377.2,0.3912175648702595,0.33727810650887574,0.7627118644067796
2022,Brooklyn Nets,Florida,Dorian Finney-Smith,200.66,99.79024,PF,66,2009,196,501,0.391,114,338,0.337,45,59,0.763,114,202,316,100,55,36,62,144,551,305,224,14,-218,-330,31,139.8,-517,-377.2,0.3912175648702595,0.33727810650887574,0.7627118644067796
2022,Brooklyn Nets,Florida,Dorian Finney-Smith,200.66,99.79024,PF,66,2009,196,501,0.391,114,338,0.337,45,59,0.763,114,202,316,100,55,36,62,144,551,305,224,14,-218,-330,31,139.8,-517,-377.2,0.3912175648702595,0.33727810650887574,0.7627118644067796
2022,Brooklyn Nets,Florida,Dorian Finney-Smith,200.66,99.79024,PF,66,2009,196,501,0.391,114,338,0.337,45,59,0.763,114,202,316,100,55,36,62,144,551,305,224,14,-218,-330,31,139.8,-517,-377.2,0.3912175648702595,0.33727810650887574,0.7627118644067796
2022,Brooklyn Nets,Florida,Dorian Finney-Smith,200.66,99.79024,PF,66,2009,196,501,0.391,114,338,0.337,45,59,0.763,114,202,316,100,55,36,62,144,551,305,224,14,-218,-330,31,139.8,-517,-377.2,0.3912175648702595,0.33727810650887574,0.7627118644067796
2022,Brooklyn Nets,Florida,Dorian Finney-Smith,200.66,99.79024,PF,66,2009,196,501,0.391,114,338,0.337,45,59,0.763,114,202,316,100,55,36,62,144,551,305,224,14,-218,-330,31,139.8,-517,-377.2,0.3912175648702595,0.33727810650887574,0.7627118644067796
2022,New Orleans Pelicans,Georgia Tech,Jose Alvarado,182.88,81.19296800000001,PG,61,1310,201,489,0.411,83,247,0.336,65,80,0.813,28,113,141,186,67,10,81,125,550,288,164,15,-174,-243,50,80.5,-367,-286.5,0.4110429447852761,0.3360323886639676,0.8125
2022,Dallas Mavericks,Arizona,Josh Green,200.66,90.7184,SG,60,1539,205,382,0.537,68,169,0.402,68,94,0.723,55,127,182,103,42,5,72,156,546,177,101,26,56,-99,42,64.7,-1,63.7,0.5366492146596858,0.40236686390532544,0.723404255319149
2022,Memphis Grizzlies,Duke,Luke Kennard,195.58,93.439952,SG,59,1315,188,382,0.492,133,269,0.494,37,39,0.949,15,143,158,91,32,5,46,82,546,194,136,2,-12,-9,35,57.4,14,71.4,0.49214659685863876,0.4944237918215613,0.9487179487179487
2022,Memphis Grizzlies,Duke,Luke Kennard,195.58,93.439952,SG,59,1315,188,382,0.492,133,269,0.494,37,39,0.949,15,143,158,91,32,5,46,82,546,194,136,2,-12,-9,35,57.4,14,71.4,0.49214659685863876,0.4944237918215613,0.9487179487179487
2022,Memphis Grizzlies,Duke,Luke Kennard,195.58,93.439952,SG,59,1315,188,382,0.492,133,269,0.494,37,39,0.949,15,143,158,91,32,5,46,82,546,194,136,2,-12,-9,35,57.4,14,71.4,0.49214659685863876,0.4944237918215613,0.9487179487179487
2022,Memphis Grizzlies,Duke,Luke Kennard,195.58,93.439952,SG,59,1315,188,382,0.492,133,269,0.494,37,39,0.949,15,143,158,91,32,5,46,82,546,194,136,2,-12,-9,35,57.4,14,71.4,0.49214659685863876,0.4944237918215613,0.9487179487179487
2022,Memphis Grizzlies,Duke,Luke Kennard,195.58,93.439952,SG,59,1315,188,382,0.492,133,269,0.494,37,39,0.949,15,143,158,91,32,5,46,82,546,194,136,2,-12,-9,35,57.4,14,71.4,0.49214659685863876,0.4944237918215613,0.9487179487179487
2022,Memphis Grizzlies,Duke,Luke Kennard,195.58,93.439952,SG,59,1315,188,382,0.492,133,269,0.494,37,39,0.949,15,143,158,91,32,5,46,82,546,194,136,2,-12,-9,35,57.4,14,71.4,0.49214659685863876,0.4944237918215613,0.9487179487179487
2022,Memphis Grizzlies,Duke,Luke Kennard,195.58,93.439952,SG,59,1315,188,382,0.492,133,269,0.494,37,39,0.949,15,143,158,91,32,5,46,82,546,194,136,2,-12,-9,35,57.4,14,71.4,0.49214659685863876,0.4944237918215613,0.9487179487179487
2022,Memphis Grizzlies,Duke,Luke Kennard,195.58,93.439952,SG,59,1315,188,382,0.492,133,269,0.494,37,39,0.949,15,143,158,91,32,5,46,82,546,194,136,2,-12,-9,35,57.4,14,71.4,0.49214659685863876,0.4944237918215613,0.9487179487179487
2022,Memphis Grizzlies,Duke,Luke Kennard,195.58,93.439952,SG,59,1315,188,382,0.492,133,269,0.494,37,39,0.949,15,143,158,91,32,5,46,82,546,194,136,2,-12,-9,35,57.4,14,71.4,0.49214659685863876,0.4944237918215613,0.9487179487179487
2022,Indiana Pacers,Louisville,Jordan Nwora,205.74,102.0582,SF,62,1188,194,445,0.436,86,211,0.408,68,86,0.791,51,178,229,88,24,14,66,74,542,251,125,18,-114,-117,50,74.3,-181,-106.7,0.43595505617977526,0.4075829383886256,0.7906976744186046
2022,Indiana Pacers,Louisville,Jordan Nwora,205.74,102.0582,SF,62,1188,194,445,0.436,86,211,0.408,68,86,0.791,51,178,229,88,24,14,66,74,542,251,125,18,-114,-117,50,74.3,-181,-106.7,0.43595505617977526,0.4075829383886256,0.7906976744186046
2022,Indiana Pacers,Louisville,Jordan Nwora,205.74,102.0582,SF,62,1188,194,445,0.436,86,211,0.408,68,86,0.791,51,178,229,88,24,14,66,74,542,251,125,18,-114,-117,50,74.3,-181,-106.7,0.43595505617977526,0.4075829383886256,0.7906976744186046
2022,Indiana Pacers,Louisville,Jordan Nwora,205.74,102.0582,SF,62,1188,194,445,0.436,86,211,0.408,68,86,0.791,51,178,229,88,24,14,66,74,542,251,125,18,-114,-117,50,74.3,-181,-106.7,0.43595505617977526,0.4075829383886256,0.7906976744186046
2022,Indiana Pacers,Louisville,Jordan Nwora,205.74,102.0582,SF,62,1188,194,445,0.436,86,211,0.408,68,86,0.791,51,178,229,88,24,14,66,74,542,251,125,18,-114,-117,50,74.3,-181,-106.7,0.43595505617977526,0.4075829383886256,0.7906976744186046
2022,Indiana Pacers,Louisville,Jordan Nwora,205.74,102.0582,SF,62,1188,194,445,0.436,86,211,0.408,68,86,0.791,51,178,229,88,24,14,66,74,542,251,125,18,-114,-117,50,74.3,-181,-106.7,0.43595505617977526,0.4075829383886256,0.7906976744186046
2022,Indiana Pacers,Louisville,Jordan Nwora,205.74,102.0582,SF,62,1188,194,445,0.436,86,211,0.408,68,86,0.791,51,178,229,88,24,14,66,74,542,251,125,18,-114,-117,50,74.3,-181,-106.7,0.43595505617977526,0.4075829383886256,0.7906976744186046
2022,Indiana Pacers,Louisville,Jordan Nwora,205.74,102.0582,SF,62,1188,194,445,0.436,86,211,0.408,68,86,0.791,51,178,229,88,24,14,66,74,542,251,125,18,-114,-117,50,74.3,-181,-106.7,0.43595505617977526,0.4075829383886256,0.7906976744186046
2022,Indiana Pacers,Louisville,Jordan Nwora,205.74,102.0582,SF,62,1188,194,445,0.436,86,211,0.408,68,86,0.791,51,178,229,88,24,14,66,74,542,251,125,18,-114,-117,50,74.3,-181,-106.7,0.43595505617977526,0.4075829383886256,0.7906976744186046
2022,Los Angeles Lakers,Oregon,Troy Brown Jr.,200.66,97.52228,SF,76,1860,200,465,0.43,107,281,0.381,34,39,0.872,62,246,308,95,59,16,49,120,541,265,174,5,-130,-201,29,123.25,-302,-178.75,0.43010752688172044,0.3807829181494662,0.8717948717948718
2022,San Antonio Spurs,Kansas,Devonte' Graham,185.42,88.45044,PG,73,1338,161,431,0.374,119,338,0.352,98,131,0.748,19,103,122,196,45,16,53,79,539,270,219,33,-218,-300,65,84.3,-453,-368.7,0.37354988399071926,0.3520710059171598,0.7480916030534351
2022,San Antonio Spurs,Kansas,Devonte' Graham,185.42,88.45044,PG,73,1338,161,431,0.374,119,338,0.352,98,131,0.748,19,103,122,196,45,16,53,79,539,270,219,33,-218,-300,65,84.3,-453,-368.7,0.37354988399071926,0.3520710059171598,0.7480916030534351
2022,San Antonio Spurs,Kansas,Devonte' Graham,185.42,88.45044,PG,73,1338,161,431,0.374,119,338,0.352,98,131,0.748,19,103,122,196,45,16,53,79,539,270,219,33,-218,-300,65,84.3,-453,-368.7,0.37354988399071926,0.3520710059171598,0.7480916030534351
2022,San Antonio Spurs,Kansas,Devonte' Graham,185.42,88.45044,PG,73,1338,161,431,0.374,119,338,0.352,98,131,0.748,19,103,122,196,45,16,53,79,539,270,219,33,-218,-300,65,84.3,-453,-368.7,0.37354988399071926,0.3520710059171598,0.7480916030534351
2022,San Antonio Spurs,Kansas,Devonte' Graham,185.42,88.45044,PG,73,1338,161,431,0.374,119,338,0.352,98,131,0.748,19,103,122,196,45,16,53,79,539,270,219,33,-218,-300,65,84.3,-453,-368.7,0.37354988399071926,0.3520710059171598,0.7480916030534351
2022,San Antonio Spurs,Kansas,Devonte' Graham,185.42,88.45044,PG,73,1338,161,431,0.374,119,338,0.352,98,131,0.748,19,103,122,196,45,16,53,79,539,270,219,33,-218,-300,65,84.3,-453,-368.7,0.37354988399071926,0.3520710059171598,0.7480916030534351
2022,San Antonio Spurs,Kansas,Devonte' Graham,185.42,88.45044,PG,73,1338,161,431,0.374,119,338,0.352,98,131,0.748,19,103,122,196,45,16,53,79,539,270,219,33,-218,-300,65,84.3,-453,-368.7,0.37354988399071926,0.3520710059171598,0.7480916030534351
2022,San Antonio Spurs,Kansas,Devonte' Graham,185.42,88.45044,PG,73,1338,161,431,0.374,119,338,0.352,98,131,0.748,19,103,122,196,45,16,53,79,539,270,219,33,-218,-300,65,84.3,-453,-368.7,0.37354988399071926,0.3520710059171598,0.7480916030534351
2022,San Antonio Spurs,Kansas,Devonte' Graham,185.42,88.45044,PG,73,1338,161,431,0.374,119,338,0.352,98,131,0.748,19,103,122,196,45,16,53,79,539,270,219,33,-218,-300,65,84.3,-453,-368.7,0.37354988399071926,0.3520710059171598,0.7480916030534351
2022,Charlotte Hornets,Kentucky,Nick Richards,213.36,111.13004,C,65,1218,197,313,0.629,1,1,1.0,137,183,0.749,147,269,416,38,11,71,59,154,532,116,0,46,162,3,91,154.05,256,410.05,0.6293929712460063,1.0,0.7486338797814208
2022,Phoenix Suns,Georgia Tech,Josh Okogie,193.04,96.615096,SG,72,1351,162,414,0.391,66,197,0.335,139,192,0.724,109,142,251,105,56,34,63,114,529,252,131,53,-180,-195,86,124.05,-289,-164.95,0.391304347826087,0.3350253807106599,0.7239583333333334
2022,Orlando Magic,Gonzaga,Jalen Suggs,195.58,92.98636,SG,53,1246,186,444,0.419,66,202,0.327,86,119,0.723,55,106,161,155,67,27,94,120,524,258,136,33,-144,-210,53,86.75,-301,-214.25,0.4189189189189189,0.32673267326732675,0.7226890756302521
2022,Detroit Pistons,Kentucky,Hamidou Diallo,195.58,91.625584,SF,56,996,215,375,0.573,5,21,0.238,87,148,0.588,57,137,194,55,53,16,71,124,522,160,16,61,110,-33,26,69.3,103,172.3,0.5733333333333334,0.23809523809523808,0.5878378378378378
2022,Phoenix Suns,Washington,Terrence Ross,200.66,93.439952,SG,63,1331,200,465,0.43,95,258,0.368,27,34,0.794,22,132,154,95,35,10,43,97,522,265,163,7,-130,-204,20,63.9,-314,-250.1,0.43010752688172044,0.3682170542635659,0.7941176470588235
2022,Phoenix Suns,Washington,Terrence Ross,200.66,93.439952,SG,63,1331,200,465,0.43,95,258,0.368,27,34,0.794,22,132,154,95,35,10,43,97,522,265,163,7,-130,-204,20,63.9,-314,-250.1,0.43010752688172044,0.3682170542635659,0.7941176470588235
2022,Phoenix Suns,Washington,Terrence Ross,200.66,93.439952,SG,63,1331,200,465,0.43,95,258,0.368,27,34,0.794,22,132,154,95,35,10,43,97,522,265,163,7,-130,-204,20,63.9,-314,-250.1,0.43010752688172044,0.3682170542635659,0.7941176470588235
2022,Phoenix Suns,Washington,Terrence Ross,200.66,93.439952,SG,63,1331,200,465,0.43,95,258,0.368,27,34,0.794,22,132,154,95,35,10,43,97,522,265,163,7,-130,-204,20,63.9,-314,-250.1,0.43010752688172044,0.3682170542635659,0.7941176470588235
2022,Phoenix Suns,Washington,Terrence Ross,200.66,93.439952,SG,63,1331,200,465,0.43,95,258,0.368,27,34,0.794,22,132,154,95,35,10,43,97,522,265,163,7,-130,-204,20,63.9,-314,-250.1,0.43010752688172044,0.3682170542635659,0.7941176470588235
2022,Phoenix Suns,Washington,Terrence Ross,200.66,93.439952,SG,63,1331,200,465,0.43,95,258,0.368,27,34,0.794,22,132,154,95,35,10,43,97,522,265,163,7,-130,-204,20,63.9,-314,-250.1,0.43010752688172044,0.3682170542635659,0.7941176470588235
2022,Phoenix Suns,Washington,Terrence Ross,200.66,93.439952,SG,63,1331,200,465,0.43,95,258,0.368,27,34,0.794,22,132,154,95,35,10,43,97,522,265,163,7,-130,-204,20,63.9,-314,-250.1,0.43010752688172044,0.3682170542635659,0.7941176470588235
2022,Phoenix Suns,Washington,Terrence Ross,200.66,93.439952,SG,63,1331,200,465,0.43,95,258,0.368,27,34,0.794,22,132,154,95,35,10,43,97,522,265,163,7,-130,-204,20,63.9,-314,-250.1,0.43010752688172044,0.3682170542635659,0.7941176470588235
2022,Phoenix Suns,Washington,Terrence Ross,200.66,93.439952,SG,63,1331,200,465,0.43,95,258,0.368,27,34,0.794,22,132,154,95,35,10,43,97,522,265,163,7,-130,-204,20,63.9,-314,-250.1,0.43010752688172044,0.3682170542635659,0.7941176470588235
2022,Portland Trail Blazers,Oregon State,Drew Eubanks,208.28,111.13004,C,78,1584,214,334,0.641,7,18,0.389,83,125,0.664,132,286,418,103,40,102,67,169,518,120,11,42,188,-12,41,192.3,217,409.3,0.6407185628742516,0.3888888888888889,0.664
2022,Oklahoma City Thunder,Florida,Tre Mann,190.5,80.73937600000001,PG,67,1183,197,501,0.393,81,257,0.315,42,55,0.764,27,128,155,120,40,11,62,99,517,304,176,13,-214,-285,29,65.05,-470,-404.95,0.3932135728542914,0.3151750972762646,0.7636363636363637
2022,Boston Celtics,Virginia,Sam Hauser,200.66,98.429464,SF,80,1290,180,396,0.455,140,335,0.418,12,17,0.706,35,169,204,71,29,21,30,99,512,216,195,5,-72,-165,7,82.55,-230,-147.45,0.45454545454545453,0.417910447761194,0.7058823529411765
2022,Miami Heat,UCLA,Kevin Love,203.2,113.851592,PF,62,1239,165,424,0.389,99,296,0.334,80,91,0.879,59,340,399,116,16,12,70,97,509,259,197,11,-188,-294,69,117.65,-413,-295.35,0.3891509433962264,0.3344594594594595,0.8791208791208791
2022,Miami Heat,UCLA,Kevin Love,203.2,113.851592,PF,62,1239,165,424,0.389,99,296,0.334,80,91,0.879,59,340,399,116,16,12,70,97,509,259,197,11,-188,-294,69,117.65,-413,-295.35,0.3891509433962264,0.3344594594594595,0.8791208791208791
2022,Miami Heat,UCLA,Kevin Love,203.2,113.851592,PF,62,1239,165,424,0.389,99,296,0.334,80,91,0.879,59,340,399,116,16,12,70,97,509,259,197,11,-188,-294,69,117.65,-413,-295.35,0.3891509433962264,0.3344594594594595,0.8791208791208791
2022,Miami Heat,UCLA,Kevin Love,203.2,113.851592,PF,62,1239,165,424,0.389,99,296,0.334,80,91,0.879,59,340,399,116,16,12,70,97,509,259,197,11,-188,-294,69,117.65,-413,-295.35,0.3891509433962264,0.3344594594594595,0.8791208791208791
2022,Miami Heat,UCLA,Kevin Love,203.2,113.851592,PF,62,1239,165,424,0.389,99,296,0.334,80,91,0.879,59,340,399,116,16,12,70,97,509,259,197,11,-188,-294,69,117.65,-413,-295.35,0.3891509433962264,0.3344594594594595,0.8791208791208791
2022,Miami Heat,UCLA,Kevin Love,203.2,113.851592,PF,62,1239,165,424,0.389,99,296,0.334,80,91,0.879,59,340,399,116,16,12,70,97,509,259,197,11,-188,-294,69,117.65,-413,-295.35,0.3891509433962264,0.3344594594594595,0.8791208791208791
2022,Miami Heat,UCLA,Kevin Love,203.2,113.851592,PF,62,1239,165,424,0.389,99,296,0.334,80,91,0.879,59,340,399,116,16,12,70,97,509,259,197,11,-188,-294,69,117.65,-413,-295.35,0.3891509433962264,0.3344594594594595,0.8791208791208791
2022,Miami Heat,UCLA,Kevin Love,203.2,113.851592,PF,62,1239,165,424,0.389,99,296,0.334,80,91,0.879,59,340,399,116,16,12,70,97,509,259,197,11,-188,-294,69,117.65,-413,-295.35,0.3891509433962264,0.3344594594594595,0.8791208791208791
2022,Miami Heat,UCLA,Kevin Love,203.2,113.851592,PF,62,1239,165,424,0.389,99,296,0.334,80,91,0.879,59,340,399,116,16,12,70,97,509,259,197,11,-188,-294,69,117.65,-413,-295.35,0.3891509433962264,0.3344594594594595,0.8791208791208791
2022,Toronto Raptors,Memphis,Precious Achiuwa,203.2,102.0582,C,55,1141,196,404,0.485,29,108,0.269,87,124,0.702,100,228,328,50,31,30,59,102,508,208,79,37,-24,-150,50,115.4,-124,-8.599999999999994,0.48514851485148514,0.26851851851851855,0.7016129032258065
2022,Dallas Mavericks,Stanford,Dwight Powell,208.28,108.86208,C,76,1458,197,269,0.732,0,5,0.0,112,168,0.667,149,165,314,69,48,26,65,209,506,72,5,56,250,-15,56,127.05,291,418.05,0.7323420074349443,0.0,0.6666666666666666
2022,Detroit Pistons,Duke,Marvin Bagley III,208.28,106.59412,C,42,990,202,382,0.529,19,66,0.288,81,108,0.75,94,175,269,36,19,30,46,81,504,180,47,27,44,-84,54,97.2,14,111.2,0.5287958115183246,0.2878787878787879,0.75
2022,Milwaukee Bucks,Texas A&M,Khris Middleton,200.66,100.697424,SF,33,801,177,406,0.436,51,162,0.315,92,102,0.902,28,112,140,163,23,5,71,68,497,229,111,10,-104,-180,82,57.85,-202,-144.15,0.43596059113300495,0.3148148148148148,0.9019607843137255
2022,New York Knicks,Dayton,Obi Toppin,205.74,99.79024,PF,67,1051,187,419,0.446,85,247,0.344,38,47,0.809,29,158,187,66,23,12,38,68,497,232,162,9,-90,-231,29,65.6,-292,-226.4,0.44630071599045346,0.3441295546558704,0.8085106382978723
2022,Washington Wizards,Oakland,Kendrick Nunn,190.5,86.18248,SG,70,963,191,450,0.424,79,223,0.354,35,41,0.854,15,94,109,90,28,7,66,66,496,259,144,6,-136,-195,29,34.7,-302,-267.3,0.42444444444444446,0.3542600896860987,0.8536585365853658
2022,Washington Wizards,Oakland,Kendrick Nunn,190.5,86.18248,SG,70,963,191,450,0.424,79,223,0.354,35,41,0.854,15,94,109,90,28,7,66,66,496,259,144,6,-136,-195,29,34.7,-302,-267.3,0.42444444444444446,0.3542600896860987,0.8536585365853658
2022,Washington Wizards,Oakland,Kendrick Nunn,190.5,86.18248,SG,70,963,191,450,0.424,79,223,0.354,35,41,0.854,15,94,109,90,28,7,66,66,496,259,144,6,-136,-195,29,34.7,-302,-267.3,0.42444444444444446,0.3542600896860987,0.8536585365853658
2022,Washington Wizards,Oakland,Kendrick Nunn,190.5,86.18248,SG,70,963,191,450,0.424,79,223,0.354,35,41,0.854,15,94,109,90,28,7,66,66,496,259,144,6,-136,-195,29,34.7,-302,-267.3,0.42444444444444446,0.3542600896860987,0.8536585365853658
2022,Washington Wizards,Oakland,Kendrick Nunn,190.5,86.18248,SG,70,963,191,450,0.424,79,223,0.354,35,41,0.854,15,94,109,90,28,7,66,66,496,259,144,6,-136,-195,29,34.7,-302,-267.3,0.42444444444444446,0.3542600896860987,0.8536585365853658
2022,Washington Wizards,Oakland,Kendrick Nunn,190.5,86.18248,SG,70,963,191,450,0.424,79,223,0.354,35,41,0.854,15,94,109,90,28,7,66,66,496,259,144,6,-136,-195,29,34.7,-302,-267.3,0.42444444444444446,0.3542600896860987,0.8536585365853658
2022,Washington Wizards,Oakland,Kendrick Nunn,190.5,86.18248,SG,70,963,191,450,0.424,79,223,0.354,35,41,0.854,15,94,109,90,28,7,66,66,496,259,144,6,-136,-195,29,34.7,-302,-267.3,0.42444444444444446,0.3542600896860987,0.8536585365853658
2022,Washington Wizards,Oakland,Kendrick Nunn,190.5,86.18248,SG,70,963,191,450,0.424,79,223,0.354,35,41,0.854,15,94,109,90,28,7,66,66,496,259,144,6,-136,-195,29,34.7,-302,-267.3,0.42444444444444446,0.3542600896860987,0.8536585365853658
2022,Washington Wizards,Oakland,Kendrick Nunn,190.5,86.18248,SG,70,963,191,450,0.424,79,223,0.354,35,41,0.854,15,94,109,90,28,7,66,66,496,259,144,6,-136,-195,29,34.7,-302,-267.3,0.42444444444444446,0.3542600896860987,0.8536585365853658
2022,Phoenix Suns,Murray State,Cameron Payne,185.42,83.007336,PG,48,968,188,453,0.415,68,185,0.368,49,64,0.766,12,94,106,214,33,8,81,88,493,265,117,15,-154,-147,34,58.6,-267,-208.4,0.41501103752759383,0.3675675675675676,0.765625
2022,Minnesota Timberwolves,Baylor,Taurean Prince,198.12,98.883056,PF,54,1193,177,379,0.467,74,194,0.381,65,77,0.844,15,117,132,84,28,15,69,123,493,202,120,12,-50,-138,53,38.6,-135,-96.4,0.46701846965699206,0.38144329896907214,0.8441558441558441
2022,Cleveland Cavaliers,Auburn,Isaac Okoro,195.58,102.0582,SF,76,1653,175,354,0.494,62,171,0.363,78,103,0.757,52,135,187,87,56,30,42,158,490,179,109,25,-8,-141,53,95.6,-96,-0.4000000000000057,0.4943502824858757,0.36257309941520466,0.7572815533980582
2022,Oklahoma City Thunder,Maryland,Aaron Wiggins,195.58,86.18248,SG,70,1297,186,363,0.512,48,122,0.393,59,71,0.831,68,142,210,80,39,15,55,110,479,177,74,12,18,-78,47,83.5,-13,70.5,0.512396694214876,0.39344262295081966,0.8309859154929577
2022,Los Angeles Clippers,,Nicolas Batum,203.2,104.32616,PF,78,1710,160,381,0.42,124,317,0.391,34,48,0.708,62,237,299,121,54,44,50,149,478,221,193,14,-122,-207,20,137.05,-309,-171.95,0.4199475065616798,0.3911671924290221,0.7083333333333334
2022,Charlotte Hornets,North Carolina State,Dennis Smith Jr.,187.96,92.98636,PG,54,1390,186,452,0.412,24,111,0.216,78,106,0.736,27,140,167,261,75,25,82,122,474,266,87,28,-160,-189,50,116.65,-299,-182.35,0.41150442477876104,0.21621621621621623,0.7358490566037735
2022,Utah Jazz,Kansas,Ochai Agbaji,195.58,97.52228,SG,59,1209,165,386,0.427,81,228,0.355,56,69,0.812,43,78,121,67,16,15,41,99,467,221,147,13,-112,-198,43,47.8,-267,-219.2,0.4274611398963731,0.35526315789473684,0.8115942028985508
2022,Memphis Grizzlies,Colorado State,David Roddy,193.04,115.66596,PF,70,1259,180,420,0.429,65,212,0.307,41,65,0.631,50,143,193,59,29,19,57,107,466,240,147,24,-120,-246,17,65.65,-349,-283.35,0.42857142857142855,0.30660377358490565,0.6307692307692307
2022,Milwaukee Bucks,Notre Dame,Pat Connaughton,195.58,94.800728,SF,61,1443,165,421,0.392,109,322,0.339,27,41,0.659,50,233,283,77,37,11,33,69,466,256,213,14,-182,-312,13,106.55,-481,-374.45,0.3919239904988123,0.3385093167701863,0.6585365853658537
2022,Portland Trail Blazers,Louisiana State,Trendon Watford,203.2,107.501304,PF,62,1182,181,323,0.56,25,64,0.391,72,100,0.72,42,196,238,130,32,12,71,118,459,142,39,28,78,-42,44,83.1,80,163.1,0.5603715170278638,0.390625,0.72
2022,Phoenix Suns,St. Mary's,Jock Landale,210.82,115.66596,C,69,979,178,337,0.528,21,84,0.25,79,105,0.752,119,161,280,68,16,30,59,126,456,159,63,26,38,-126,53,103.95,-35,68.95,0.5281899109792285,0.25,0.7523809523809524
2022,Indiana Pacers,Kentucky,Isaiah Jackson,205.74,92.98636,C,63,1042,179,318,0.563,2,14,0.143,95,146,0.651,113,169,282,51,31,93,51,154,455,139,12,51,80,-30,44,140.3,94,234.3,0.5628930817610063,0.14285714285714285,0.6506849315068494
2022,Sacramento Kings,Baylor,Davion Mitchell,182.88,91.625584,PG,80,1447,181,399,0.454,63,197,0.32,25,31,0.806,16,89,105,185,44,15,62,112,450,218,134,6,-74,-213,19,69.4,-268,-198.6,0.45363408521303256,0.3197969543147208,0.8064516129032258
2022,Detroit Pistons,Memphis,James Wiseman,213.36,108.86208,C,45,867,189,339,0.558,4,20,0.2,68,97,0.701,73,194,267,30,7,27,51,108,450,150,16,29,78,-36,39,78.6,81,159.6,0.5575221238938053,0.2,0.7010309278350515
2022,Detroit Pistons,Memphis,James Wiseman,213.36,108.86208,C,45,867,189,339,0.558,4,20,0.2,68,97,0.701,73,194,267,30,7,27,51,108,450,150,16,29,78,-36,39,78.6,81,159.6,0.5575221238938053,0.2,0.7010309278350515
2022,Detroit Pistons,Memphis,James Wiseman,213.36,108.86208,C,45,867,189,339,0.558,4,20,0.2,68,97,0.701,73,194,267,30,7,27,51,108,450,150,16,29,78,-36,39,78.6,81,159.6,0.5575221238938053,0.2,0.7010309278350515
2022,Detroit Pistons,Memphis,James Wiseman,213.36,108.86208,C,45,867,189,339,0.558,4,20,0.2,68,97,0.701,73,194,267,30,7,27,51,108,450,150,16,29,78,-36,39,78.6,81,159.6,0.5575221238938053,0.2,0.7010309278350515
2022,Detroit Pistons,Memphis,James Wiseman,213.36,108.86208,C,45,867,189,339,0.558,4,20,0.2,68,97,0.701,73,194,267,30,7,27,51,108,450,150,16,29,78,-36,39,78.6,81,159.6,0.5575221238938053,0.2,0.7010309278350515
2022,Detroit Pistons,Memphis,James Wiseman,213.36,108.86208,C,45,867,189,339,0.558,4,20,0.2,68,97,0.701,73,194,267,30,7,27,51,108,450,150,16,29,78,-36,39,78.6,81,159.6,0.5575221238938053,0.2,0.7010309278350515
2022,Detroit Pistons,Memphis,James Wiseman,213.36,108.86208,C,45,867,189,339,0.558,4,20,0.2,68,97,0.701,73,194,267,30,7,27,51,108,450,150,16,29,78,-36,39,78.6,81,159.6,0.5575221238938053,0.2,0.7010309278350515
2022,Detroit Pistons,Memphis,James Wiseman,213.36,108.86208,C,45,867,189,339,0.558,4,20,0.2,68,97,0.701,73,194,267,30,7,27,51,108,450,150,16,29,78,-36,39,78.6,81,159.6,0.5575221238938053,0.2,0.7010309278350515
2022,Detroit Pistons,Memphis,James Wiseman,213.36,108.86208,C,45,867,189,339,0.558,4,20,0.2,68,97,0.701,73,194,267,30,7,27,51,108,450,150,16,29,78,-36,39,78.6,81,159.6,0.5575221238938053,0.2,0.7010309278350515
2022,Miami Heat,Indiana,Victor Oladipo,190.5,96.615096,SG,42,1106,160,403,0.397,70,212,0.33,59,79,0.747,16,112,128,146,57,12,87,99,449,243,142,20,-166,-216,39,58.55,-343,-284.45,0.3970223325062035,0.330188679245283,0.7468354430379747
2022,New Orleans Pelicans,Wyoming,Larry Nance Jr.,203.2,111.13004,C,65,1381,186,305,0.61,14,42,0.333,55,79,0.696,106,248,354,119,56,37,42,133,441,119,28,24,134,-42,31,163.6,123,286.6,0.6098360655737705,0.3333333333333333,0.6962025316455697
2022,Denver Nuggets,Georgetown,Jeff Green,203.2,106.59412,PF,56,1091,160,328,0.488,30,104,0.288,87,117,0.744,38,106,144,69,18,17,46,99,437,168,74,30,-16,-132,57,52.3,-91,-38.7,0.4878048780487805,0.28846153846153844,0.7435897435897436
2022,New York Knicks,Western Kentucky,Mitchell Robinson,213.36,108.86208,C,59,1589,188,280,0.671,0,0,0.0,59,122,0.484,267,288,555,53,56,109,41,160,435,92,0,63,192,0,-4,272.75,188,460.75,0.6714285714285714,,0.48360655737704916
2022,Sacramento Kings,Mississippi,Terence Davis,193.04,91.171992,SG,64,841,154,364,0.423,89,243,0.366,34,43,0.791,20,119,139,67,43,12,53,104,431,210,154,9,-112,-195,25,52.3,-282,-229.7,0.4230769230769231,0.3662551440329218,0.7906976744186046
2022,Detroit Pistons,Texas,Cory Joseph,190.5,90.7184,PG,62,1227,150,351,0.427,70,180,0.389,57,72,0.792,21,85,106,217,34,9,56,88,427,201,110,15,-102,-120,42,75.1,-180,-104.9,0.42735042735042733,0.3888888888888889,0.7916666666666666
2022,Oklahoma City Thunder,TCU,Kenrich Williams,198.12,95.25432,PF,53,1206,179,346,0.517,50,134,0.373,17,39,0.436,97,164,261,105,45,14,32,112,425,167,84,22,24,-102,-5,123.65,-83,40.650000000000006,0.5173410404624278,0.373134328358209,0.4358974358974359
2022,Dallas Mavericks,,Jaden Hardy,190.5,89.811216,SG,48,708,146,333,0.438,63,156,0.404,65,79,0.823,11,78,89,65,17,7,46,64,420,187,93,14,-82,-90,51,27.05,-121,-93.95,0.43843843843843844,0.40384615384615385,0.8227848101265823
2022,Golden State Warriors,Vermont,Anthony Lamb,198.12,102.965384,SF,62,1195,148,314,0.471,73,199,0.367,46,60,0.767,56,159,215,96,28,20,54,134,415,166,126,14,-36,-159,32,82.05,-163,-80.95,0.4713375796178344,0.36683417085427134,0.7666666666666667
2022,Chicago Bulls,Arkansas,Patrick Beverley,187.96,81.64656,SG,67,1817,144,360,0.4,80,239,0.335,47,65,0.723,44,203,247,194,63,41,60,187,415,216,159,18,-144,-237,29,133.9,-352,-218.1,0.4,0.33472803347280333,0.7230769230769231
2022,Chicago Bulls,Arkansas,Patrick Beverley,187.96,81.64656,SG,67,1817,144,360,0.4,80,239,0.335,47,65,0.723,44,203,247,194,63,41,60,187,415,216,159,18,-144,-237,29,133.9,-352,-218.1,0.4,0.33472803347280333,0.7230769230769231
2022,Chicago Bulls,Arkansas,Patrick Beverley,187.96,81.64656,SG,67,1817,144,360,0.4,80,239,0.335,47,65,0.723,44,203,247,194,63,41,60,187,415,216,159,18,-144,-237,29,133.9,-352,-218.1,0.4,0.33472803347280333,0.7230769230769231
2022,Chicago Bulls,Arkansas,Patrick Beverley,187.96,81.64656,SG,67,1817,144,360,0.4,80,239,0.335,47,65,0.723,44,203,247,194,63,41,60,187,415,216,159,18,-144,-237,29,133.9,-352,-218.1,0.4,0.33472803347280333,0.7230769230769231
2022,Chicago Bulls,Arkansas,Patrick Beverley,187.96,81.64656,SG,67,1817,144,360,0.4,80,239,0.335,47,65,0.723,44,203,247,194,63,41,60,187,415,216,159,18,-144,-237,29,133.9,-352,-218.1,0.4,0.33472803347280333,0.7230769230769231
2022,Chicago Bulls,Arkansas,Patrick Beverley,187.96,81.64656,SG,67,1817,144,360,0.4,80,239,0.335,47,65,0.723,44,203,247,194,63,41,60,187,415,216,159,18,-144,-237,29,133.9,-352,-218.1,0.4,0.33472803347280333,0.7230769230769231
2022,Chicago Bulls,Arkansas,Patrick Beverley,187.96,81.64656,PG,67,1817,144,360,0.4,80,239,0.335,47,65,0.723,44,203,247,194,63,41,60,187,415,216,159,18,-144,-237,29,133.9,-352,-218.1,0.4,0.33472803347280333,0.7230769230769231
2022,Chicago Bulls,Arkansas,Patrick Beverley,187.96,81.64656,PG,67,1817,144,360,0.4,80,239,0.335,47,65,0.723,44,203,247,194,63,41,60,187,415,216,159,18,-144,-237,29,133.9,-352,-218.1,0.4,0.33472803347280333,0.7230769230769231
2022,Chicago Bulls,Arkansas,Patrick Beverley,187.96,81.64656,PG,67,1817,144,360,0.4,80,239,0.335,47,65,0.723,44,203,247,194,63,41,60,187,415,216,159,18,-144,-237,29,133.9,-352,-218.1,0.4,0.33472803347280333,0.7230769230769231
2022,Washington Wizards,St. Louis,Jordan Goodwin,190.5,90.7184,PG,62,1105,158,353,0.448,38,118,0.322,53,69,0.768,57,148,205,168,58,26,57,95,407,195,80,16,-74,-126,37,116.25,-163,-46.75,0.4475920679886686,0.3220338983050847,0.7681159420289855
2022,New York Knicks,,Isaiah Hartenstein,213.36,113.398,C,82,1628,175,327,0.535,8,37,0.216,48,71,0.676,209,327,536,102,53,64,66,213,406,152,29,23,46,-63,25,226.6,8,234.6,0.5351681957186545,0.21621621621621623,0.676056338028169
2022,Chicago Bulls,Connecticut,Andre Drummond,210.82,126.552168,C,67,849,166,274,0.606,0,3,0.0,67,125,0.536,138,306,444,33,45,27,75,117,399,108,3,58,116,-9,9,146.4,116,262.4,0.6058394160583942,0.0,0.536
2022,Indiana Pacers,Syracuse,Oshae Brissett,200.66,95.25432,PF,65,1083,123,319,0.386,48,155,0.31,104,145,0.717,62,156,218,44,33,13,34,79,398,196,107,41,-146,-177,63,83.05,-260,-176.95,0.38557993730407525,0.3096774193548387,0.7172413793103448
2022,Orlando Magic,Michigan State,Gary Harris,193.04,95.25432,SG,48,1184,138,307,0.45,94,218,0.431,27,30,0.9,21,77,98,59,45,12,28,93,397,169,124,3,-62,-90,24,54.35,-128,-73.65,0.4495114006514658,0.43119266055045874,0.9
2022,Atlanta Hawks,Duke,Jalen Johnson,203.2,99.336648,SF,70,1042,158,322,0.491,30,104,0.288,49,78,0.628,51,231,282,83,38,34,41,113,395,164,74,29,-12,-132,20,113.85,-124,-10.150000000000006,0.4906832298136646,0.28846153846153844,0.6282051282051282
2022,Portland Trail Blazers,Duke,Cam Reddish,200.66,98.429464,SF,40,990,139,312,0.446,45,144,0.313,64,75,0.853,18,70,88,57,39,14,47,72,387,173,99,11,-68,-162,53,40.15,-177,-136.85,0.44551282051282054,0.3125,0.8533333333333334
2022,Portland Trail Blazers,Duke,Cam Reddish,200.66,98.429464,SF,40,990,139,312,0.446,45,144,0.313,64,75,0.853,18,70,88,57,39,14,47,72,387,173,99,11,-68,-162,53,40.15,-177,-136.85,0.44551282051282054,0.3125,0.8533333333333334
2022,Portland Trail Blazers,Duke,Cam Reddish,200.66,98.429464,SF,40,990,139,312,0.446,45,144,0.313,64,75,0.853,18,70,88,57,39,14,47,72,387,173,99,11,-68,-162,53,40.15,-177,-136.85,0.44551282051282054,0.3125,0.8533333333333334
2022,Portland Trail Blazers,Duke,Cam Reddish,200.66,98.429464,SF,40,990,139,312,0.446,45,144,0.313,64,75,0.853,18,70,88,57,39,14,47,72,387,173,99,11,-68,-162,53,40.15,-177,-136.85,0.44551282051282054,0.3125,0.8533333333333334
2022,Portland Trail Blazers,Duke,Cam Reddish,200.66,98.429464,SF,40,990,139,312,0.446,45,144,0.313,64,75,0.853,18,70,88,57,39,14,47,72,387,173,99,11,-68,-162,53,40.15,-177,-136.85,0.44551282051282054,0.3125,0.8533333333333334
2022,Portland Trail Blazers,Duke,Cam Reddish,200.66,98.429464,SF,40,990,139,312,0.446,45,144,0.313,64,75,0.853,18,70,88,57,39,14,47,72,387,173,99,11,-68,-162,53,40.15,-177,-136.85,0.44551282051282054,0.3125,0.8533333333333334
2022,Portland Trail Blazers,Duke,Cam Reddish,200.66,98.429464,SF,40,990,139,312,0.446,45,144,0.313,64,75,0.853,18,70,88,57,39,14,47,72,387,173,99,11,-68,-162,53,40.15,-177,-136.85,0.44551282051282054,0.3125,0.8533333333333334
2022,Portland Trail Blazers,Duke,Cam Reddish,200.66,98.429464,SF,40,990,139,312,0.446,45,144,0.313,64,75,0.853,18,70,88,57,39,14,47,72,387,173,99,11,-68,-162,53,40.15,-177,-136.85,0.44551282051282054,0.3125,0.8533333333333334
2022,Portland Trail Blazers,Duke,Cam Reddish,200.66,98.429464,SF,40,990,139,312,0.446,45,144,0.313,64,75,0.853,18,70,88,57,39,14,47,72,387,173,99,11,-68,-162,53,40.15,-177,-136.85,0.44551282051282054,0.3125,0.8533333333333334
2022,Charlotte Hornets,Duke,Mark Williams,213.36,108.86208,C,43,828,160,251,0.637,0,0,0.0,67,97,0.691,93,211,304,18,28,45,40,94,387,91,0,30,138,0,37,115.55,175,290.55,0.6374501992031872,,0.6907216494845361
2022,Los Angeles Clippers,Kentucky,John Wall,190.5,95.25432,PG,34,755,138,338,0.408,33,109,0.303,77,113,0.681,14,78,92,178,27,12,80,59,386,200,76,36,-124,-129,41,47.55,-212,-164.45,0.40828402366863903,0.30275229357798167,0.6814159292035398
2022,Boston Celtics,Bucknell,Mike Muscala,210.82,108.86208,C,63,945,131,292,0.449,81,207,0.391,40,52,0.769,37,166,203,50,15,24,23,98,383,161,126,12,-60,-135,28,75.6,-167,-91.4,0.4486301369863014,0.391304347826087,0.7692307692307693
2022,Boston Celtics,Bucknell,Mike Muscala,210.82,108.86208,C,63,945,131,292,0.449,81,207,0.391,40,52,0.769,37,166,203,50,15,24,23,98,383,161,126,12,-60,-135,28,75.6,-167,-91.4,0.4486301369863014,0.391304347826087,0.7692307692307693
2022,Boston Celtics,Bucknell,Mike Muscala,210.82,108.86208,C,63,945,131,292,0.449,81,207,0.391,40,52,0.769,37,166,203,50,15,24,23,98,383,161,126,12,-60,-135,28,75.6,-167,-91.4,0.4486301369863014,0.391304347826087,0.7692307692307693
2022,Boston Celtics,Bucknell,Mike Muscala,210.82,108.86208,C,63,945,131,292,0.449,81,207,0.391,40,52,0.769,37,166,203,50,15,24,23,98,383,161,126,12,-60,-135,28,75.6,-167,-91.4,0.4486301369863014,0.391304347826087,0.7692307692307693
2022,Boston Celtics,Bucknell,Mike Muscala,210.82,108.86208,C,63,945,131,292,0.449,81,207,0.391,40,52,0.769,37,166,203,50,15,24,23,98,383,161,126,12,-60,-135,28,75.6,-167,-91.4,0.4486301369863014,0.391304347826087,0.7692307692307693
2022,Boston Celtics,Bucknell,Mike Muscala,210.82,108.86208,C,63,945,131,292,0.449,81,207,0.391,40,52,0.769,37,166,203,50,15,24,23,98,383,161,126,12,-60,-135,28,75.6,-167,-91.4,0.4486301369863014,0.391304347826087,0.7692307692307693
2022,Boston Celtics,Bucknell,Mike Muscala,210.82,108.86208,C,63,945,131,292,0.449,81,207,0.391,40,52,0.769,37,166,203,50,15,24,23,98,383,161,126,12,-60,-135,28,75.6,-167,-91.4,0.4486301369863014,0.391304347826087,0.7692307692307693
2022,Boston Celtics,Bucknell,Mike Muscala,210.82,108.86208,C,63,945,131,292,0.449,81,207,0.391,40,52,0.769,37,166,203,50,15,24,23,98,383,161,126,12,-60,-135,28,75.6,-167,-91.4,0.4486301369863014,0.391304347826087,0.7692307692307693
2022,Boston Celtics,Bucknell,Mike Muscala,210.82,108.86208,C,63,945,131,292,0.449,81,207,0.391,40,52,0.769,37,166,203,50,15,24,23,98,383,161,126,12,-60,-135,28,75.6,-167,-91.4,0.4486301369863014,0.391304347826087,0.7692307692307693
2022,Toronto Raptors,Memphis,Will Barton,195.58,82.10015200000001,SG,56,993,138,364,0.379,66,180,0.367,37,47,0.787,15,122,137,112,28,13,48,56,379,226,114,10,-176,-144,27,59.7,-293,-233.3,0.3791208791208791,0.36666666666666664,0.7872340425531915
2022,Toronto Raptors,Memphis,Will Barton,195.58,82.10015200000001,SG,56,993,138,364,0.379,66,180,0.367,37,47,0.787,15,122,137,112,28,13,48,56,379,226,114,10,-176,-144,27,59.7,-293,-233.3,0.3791208791208791,0.36666666666666664,0.7872340425531915
2022,Toronto Raptors,Memphis,Will Barton,195.58,82.10015200000001,SG,56,993,138,364,0.379,66,180,0.367,37,47,0.787,15,122,137,112,28,13,48,56,379,226,114,10,-176,-144,27,59.7,-293,-233.3,0.3791208791208791,0.36666666666666664,0.7872340425531915
2022,Toronto Raptors,Memphis,Will Barton,195.58,82.10015200000001,SG,56,993,138,364,0.379,66,180,0.367,37,47,0.787,15,122,137,112,28,13,48,56,379,226,114,10,-176,-144,27,59.7,-293,-233.3,0.3791208791208791,0.36666666666666664,0.7872340425531915
2022,Toronto Raptors,Memphis,Will Barton,195.58,82.10015200000001,SG,56,993,138,364,0.379,66,180,0.367,37,47,0.787,15,122,137,112,28,13,48,56,379,226,114,10,-176,-144,27,59.7,-293,-233.3,0.3791208791208791,0.36666666666666664,0.7872340425531915
2022,Toronto Raptors,Memphis,Will Barton,195.58,82.10015200000001,SG,56,993,138,364,0.379,66,180,0.367,37,47,0.787,15,122,137,112,28,13,48,56,379,226,114,10,-176,-144,27,59.7,-293,-233.3,0.3791208791208791,0.36666666666666664,0.7872340425531915
2022,Toronto Raptors,Memphis,Will Barton,195.58,82.10015200000001,SG,56,993,138,364,0.379,66,180,0.367,37,47,0.787,15,122,137,112,28,13,48,56,379,226,114,10,-176,-144,27,59.7,-293,-233.3,0.3791208791208791,0.36666666666666664,0.7872340425531915
2022,Toronto Raptors,Memphis,Will Barton,195.58,82.10015200000001,SG,56,993,138,364,0.379,66,180,0.367,37,47,0.787,15,122,137,112,28,13,48,56,379,226,114,10,-176,-144,27,59.7,-293,-233.3,0.3791208791208791,0.36666666666666664,0.7872340425531915
2022,Toronto Raptors,Memphis,Will Barton,195.58,82.10015200000001,SG,56,993,138,364,0.379,66,180,0.367,37,47,0.787,15,122,137,112,28,13,48,56,379,226,114,10,-176,-144,27,59.7,-293,-233.3,0.3791208791208791,0.36666666666666664,0.7872340425531915
2022,Brooklyn Nets,Xavier,Edmond Sumner,193.04,88.904032,SG,53,736,124,269,0.461,31,87,0.356,99,108,0.917,13,66,79,68,31,10,50,83,378,145,56,9,-42,-75,90,31.35,-27,4.350000000000001,0.46096654275092935,0.3563218390804598,0.9166666666666666
2022,Chicago Bulls,Texas A&M,Alex Caruso,195.58,84.368112,PG,67,1575,130,286,0.455,55,151,0.364,59,73,0.808,42,154,196,193,98,46,77,159,374,156,96,14,-52,-123,45,133.3,-130,3.3000000000000114,0.45454545454545453,0.36423841059602646,0.8082191780821918
2022,Houston Rockets,Arizona State,Josh Christopher,193.04,97.52228,SG,64,786,153,329,0.465,21,89,0.236,45,60,0.75,20,51,71,73,33,15,60,59,372,176,68,15,-46,-141,30,32.05,-157,-124.95,0.46504559270516715,0.23595505617977527,0.75
2022,Los Angeles Lakers,Kentucky,Wenyen Gabriel,205.74,92.98636,C,68,1024,155,260,0.596,10,36,0.278,52,84,0.619,116,170,286,36,26,35,46,144,372,105,26,32,100,-48,20,109.8,72,181.8,0.5961538461538461,0.2777777777777778,0.6190476190476191
2022,Washington Wizards,Utah,Delon Wright,195.58,83.91452,PG,50,1221,138,291,0.474,41,119,0.345,52,60,0.867,58,122,180,194,92,17,44,59,369,153,78,8,-30,-111,44,137.55,-97,40.55000000000001,0.4742268041237113,0.3445378151260504,0.8666666666666667
2022,Golden State Warriors,Alabama,JaMychal Green,205.74,102.965384,PF,57,797,136,252,0.54,42,111,0.378,52,67,0.776,72,133,205,51,25,23,52,105,366,116,69,15,40,-81,37,74.75,-4,70.75,0.5396825396825397,0.3783783783783784,0.7761194029850746
2022,Memphis Grizzlies,Indiana-Purdue Fort Wayne,John Konchar,195.58,95.25432,SF,72,1494,138,320,0.431,60,177,0.339,28,36,0.778,64,246,310,100,77,25,37,112,364,182,117,8,-88,-171,20,145.4,-239,-93.6,0.43125,0.3389830508474576,0.7777777777777778
2022,Minnesota Timberwolves,Virginia Tech,Nickeil Alexander-Walker,195.58,92.98636,SG,59,884,131,295,0.444,61,159,0.384,40,60,0.667,15,86,101,108,32,21,55,88,363,164,98,20,-66,-111,20,50.6,-157,-106.4,0.4440677966101695,0.3836477987421384,0.6666666666666666
2022,Minnesota Timberwolves,Virginia Tech,Nickeil Alexander-Walker,195.58,92.98636,SG,59,884,131,295,0.444,61,159,0.384,40,60,0.667,15,86,101,108,32,21,55,88,363,164,98,20,-66,-111,20,50.6,-157,-106.4,0.4440677966101695,0.3836477987421384,0.6666666666666666
2022,Minnesota Timberwolves,Virginia Tech,Nickeil Alexander-Walker,195.58,92.98636,SG,59,884,131,295,0.444,61,159,0.384,40,60,0.667,15,86,101,108,32,21,55,88,363,164,98,20,-66,-111,20,50.6,-157,-106.4,0.4440677966101695,0.3836477987421384,0.6666666666666666
2022,Minnesota Timberwolves,Virginia Tech,Nickeil Alexander-Walker,195.58,92.98636,SG,59,884,131,295,0.444,61,159,0.384,40,60,0.667,15,86,101,108,32,21,55,88,363,164,98,20,-66,-111,20,50.6,-157,-106.4,0.4440677966101695,0.3836477987421384,0.6666666666666666
2022,Minnesota Timberwolves,Virginia Tech,Nickeil Alexander-Walker,195.58,92.98636,SG,59,884,131,295,0.444,61,159,0.384,40,60,0.667,15,86,101,108,32,21,55,88,363,164,98,20,-66,-111,20,50.6,-157,-106.4,0.4440677966101695,0.3836477987421384,0.6666666666666666
2022,Minnesota Timberwolves,Virginia Tech,Nickeil Alexander-Walker,195.58,92.98636,SG,59,884,131,295,0.444,61,159,0.384,40,60,0.667,15,86,101,108,32,21,55,88,363,164,98,20,-66,-111,20,50.6,-157,-106.4,0.4440677966101695,0.3836477987421384,0.6666666666666666
2022,Minnesota Timberwolves,Virginia Tech,Nickeil Alexander-Walker,195.58,92.98636,SG,59,884,131,295,0.444,61,159,0.384,40,60,0.667,15,86,101,108,32,21,55,88,363,164,98,20,-66,-111,20,50.6,-157,-106.4,0.4440677966101695,0.3836477987421384,0.6666666666666666
2022,Minnesota Timberwolves,Virginia Tech,Nickeil Alexander-Walker,195.58,92.98636,SG,59,884,131,295,0.444,61,159,0.384,40,60,0.667,15,86,101,108,32,21,55,88,363,164,98,20,-66,-111,20,50.6,-157,-106.4,0.4440677966101695,0.3836477987421384,0.6666666666666666
2022,Minnesota Timberwolves,Virginia Tech,Nickeil Alexander-Walker,195.58,92.98636,SG,59,884,131,295,0.444,61,159,0.384,40,60,0.667,15,86,101,108,32,21,55,88,363,164,98,20,-66,-111,20,50.6,-157,-106.4,0.4440677966101695,0.3836477987421384,0.6666666666666666
2022,Indiana Pacers,Oregon,Chris Duarte,195.58,86.18248,SF,46,897,123,333,0.369,55,174,0.316,61,72,0.847,19,96,115,64,25,9,41,65,362,210,119,11,-174,-192,50,42.75,-316,-273.25,0.36936936936936937,0.3160919540229885,0.8472222222222222
2022,Memphis Grizzlies,Pittsburgh,Steven Adams,210.82,120.20188,C,42,1133,157,263,0.597,0,1,0.0,47,129,0.364,214,271,485,97,36,46,79,98,361,106,1,82,102,-3,-35,195.6,64,259.6,0.596958174904943,0.0,0.3643410852713178
2022,Denver Nuggets,Kansas,Christian Braun,198.12,99.79024,SG,76,1181,143,289,0.495,34,96,0.354,40,64,0.625,48,133,181,59,41,17,35,101,360,146,62,24,-6,-84,16,78.45,-74,4.450000000000003,0.49480968858131485,0.3541666666666667,0.625
2022,Portland Trail Blazers,North Carolina,Nassir Little,195.58,99.79024,SF,54,976,134,303,0.442,58,158,0.367,33,46,0.717,27,114,141,50,20,20,36,66,359,169,100,13,-70,-126,20,53.2,-176,-122.8,0.44224422442244227,0.3670886075949367,0.717391304347826
2022,Detroit Pistons,Michigan,Isaiah Livers,198.12,105.233344,PF,52,1199,120,288,0.417,74,203,0.365,32,39,0.821,28,115,143,41,28,28,30,103,346,168,129,7,-96,-165,25,60.85,-236,-175.15,0.4166666666666667,0.3645320197044335,0.8205128205128205
2022,Phoenix Suns,Wichita State,Landry Shamet,193.04,86.18248,SG,40,807,113,300,0.377,75,199,0.377,45,51,0.882,11,56,67,93,26,5,36,61,346,187,124,6,-148,-147,39,37.2,-256,-218.8,0.37666666666666665,0.3768844221105528,0.8823529411764706
2022,Cleveland Cavaliers,Penn State,Lamar Stevens,198.12,104.32616,SF,62,1121,129,288,0.448,30,95,0.316,40,57,0.702,48,159,207,33,27,19,27,79,328,159,65,17,-60,-105,23,77.55,-142,-64.45,0.4479166666666667,0.3157894736842105,0.7017543859649122
2022,Utah Jazz,,Simone Fontecchio,200.66,94.800728,SF,52,766,115,312,0.369,63,191,0.33,35,44,0.795,31,55,86,42,15,8,39,62,328,197,128,9,-164,-195,26,28.65,-333,-304.35,0.3685897435897436,0.3298429319371728,0.7954545454545454
2022,Los Angeles Lakers,Texas,Mo Bamba,213.36,104.779752,C,49,768,117,241,0.485,48,124,0.387,41,62,0.661,58,167,225,46,13,43,30,105,323,124,76,21,-14,-84,20,90.0,-78,12.0,0.4854771784232365,0.3870967741935484,0.6612903225806451
2022,Los Angeles Lakers,Texas,Mo Bamba,213.36,104.779752,C,49,768,117,241,0.485,48,124,0.387,41,62,0.661,58,167,225,46,13,43,30,105,323,124,76,21,-14,-84,20,90.0,-78,12.0,0.4854771784232365,0.3870967741935484,0.6612903225806451
2022,Los Angeles Lakers,Texas,Mo Bamba,213.36,104.779752,C,49,768,117,241,0.485,48,124,0.387,41,62,0.661,58,167,225,46,13,43,30,105,323,124,76,21,-14,-84,20,90.0,-78,12.0,0.4854771784232365,0.3870967741935484,0.6612903225806451
2022,Los Angeles Lakers,Texas,Mo Bamba,213.36,104.779752,C,49,768,117,241,0.485,48,124,0.387,41,62,0.661,58,167,225,46,13,43,30,105,323,124,76,21,-14,-84,20,90.0,-78,12.0,0.4854771784232365,0.3870967741935484,0.6612903225806451
2022,Los Angeles Lakers,Texas,Mo Bamba,213.36,104.779752,C,49,768,117,241,0.485,48,124,0.387,41,62,0.661,58,167,225,46,13,43,30,105,323,124,76,21,-14,-84,20,90.0,-78,12.0,0.4854771784232365,0.3870967741935484,0.6612903225806451
2022,Los Angeles Lakers,Texas,Mo Bamba,213.36,104.779752,C,49,768,117,241,0.485,48,124,0.387,41,62,0.661,58,167,225,46,13,43,30,105,323,124,76,21,-14,-84,20,90.0,-78,12.0,0.4854771784232365,0.3870967741935484,0.6612903225806451
2022,Los Angeles Lakers,Texas,Mo Bamba,213.36,104.779752,C,49,768,117,241,0.485,48,124,0.387,41,62,0.661,58,167,225,46,13,43,30,105,323,124,76,21,-14,-84,20,90.0,-78,12.0,0.4854771784232365,0.3870967741935484,0.6612903225806451
2022,Los Angeles Lakers,Texas,Mo Bamba,213.36,104.779752,C,49,768,117,241,0.485,48,124,0.387,41,62,0.661,58,167,225,46,13,43,30,105,323,124,76,21,-14,-84,20,90.0,-78,12.0,0.4854771784232365,0.3870967741935484,0.6612903225806451
2022,Los Angeles Lakers,Texas,Mo Bamba,213.36,104.779752,C,49,768,117,241,0.485,48,124,0.387,41,62,0.661,58,167,225,46,13,43,30,105,323,124,76,21,-14,-84,20,90.0,-78,12.0,0.4854771784232365,0.3870967741935484,0.6612903225806451
2022,Brooklyn Nets,George Washington,Yuta Watanabe,203.2,97.52228,SF,58,928,114,232,0.491,60,135,0.444,34,47,0.723,30,111,141,48,25,17,22,80,322,118,75,13,-8,-45,21,60.75,-32,28.75,0.49137931034482757,0.4444444444444444,0.723404255319149
2022,Sacramento Kings,Southern California,Chimezie Metu,205.74,102.0582,PF,66,689,129,219,0.589,9,38,0.237,54,73,0.74,47,151,198,40,22,21,32,81,321,90,29,19,78,-60,35,72.7,53,125.7,0.589041095890411,0.23684210526315788,0.7397260273972602
2022,Philadelphia 76ers,Louisville,Montrezl Harrell,200.66,108.86208,C,57,681,125,209,0.598,0,6,0.0,70,101,0.693,67,92,159,33,17,25,35,75,320,84,6,31,82,-18,39,64.5,103,167.5,0.5980861244019139,0.0,0.693069306930693
2022,Chicago Bulls,UNLV,Derrick Jones Jr.,198.12,95.25432,PF,64,893,115,230,0.5,27,80,0.338,62,84,0.738,60,93,153,34,29,37,25,86,319,115,53,22,0,-78,40,77.95,-38,39.95,0.5,0.3375,0.7380952380952381
2022,Milwaukee Bucks,,Joe Ingles,205.74,99.79024,SF,46,1044,108,248,0.435,83,203,0.409,18,21,0.857,13,115,128,150,33,6,55,74,317,140,120,3,-64,-111,15,61.05,-160,-98.95,0.43548387096774194,0.4088669950738916,0.8571428571428571
2022,Phoenix Suns,North Carolina State,T.J. Warren,203.2,99.79024,PF,42,687,132,270,0.489,22,67,0.328,28,35,0.8,26,95,121,40,22,12,20,65,314,138,45,7,-12,-69,21,50.5,-60,-9.5,0.4888888888888889,0.3283582089552239,0.8
2022,Phoenix Suns,North Carolina State,T.J. Warren,203.2,99.79024,PF,42,687,132,270,0.489,22,67,0.328,28,35,0.8,26,95,121,40,22,12,20,65,314,138,45,7,-12,-69,21,50.5,-60,-9.5,0.4888888888888889,0.3283582089552239,0.8
2022,Phoenix Suns,North Carolina State,T.J. Warren,203.2,99.79024,PF,42,687,132,270,0.489,22,67,0.328,28,35,0.8,26,95,121,40,22,12,20,65,314,138,45,7,-12,-69,21,50.5,-60,-9.5,0.4888888888888889,0.3283582089552239,0.8
2022,Phoenix Suns,North Carolina State,T.J. Warren,203.2,99.79024,PF,42,687,132,270,0.489,22,67,0.328,28,35,0.8,26,95,121,40,22,12,20,65,314,138,45,7,-12,-69,21,50.5,-60,-9.5,0.4888888888888889,0.3283582089552239,0.8
2022,Phoenix Suns,North Carolina State,T.J. Warren,203.2,99.79024,PF,42,687,132,270,0.489,22,67,0.328,28,35,0.8,26,95,121,40,22,12,20,65,314,138,45,7,-12,-69,21,50.5,-60,-9.5,0.4888888888888889,0.3283582089552239,0.8
2022,Phoenix Suns,North Carolina State,T.J. Warren,203.2,99.79024,PF,42,687,132,270,0.489,22,67,0.328,28,35,0.8,26,95,121,40,22,12,20,65,314,138,45,7,-12,-69,21,50.5,-60,-9.5,0.4888888888888889,0.3283582089552239,0.8
2022,Phoenix Suns,North Carolina State,T.J. Warren,203.2,99.79024,SF,42,687,132,270,0.489,22,67,0.328,28,35,0.8,26,95,121,40,22,12,20,65,314,138,45,7,-12,-69,21,50.5,-60,-9.5,0.4888888888888889,0.3283582089552239,0.8
2022,Phoenix Suns,North Carolina State,T.J. Warren,203.2,99.79024,SF,42,687,132,270,0.489,22,67,0.328,28,35,0.8,26,95,121,40,22,12,20,65,314,138,45,7,-12,-69,21,50.5,-60,-9.5,0.4888888888888889,0.3283582089552239,0.8
2022,Phoenix Suns,North Carolina State,T.J. Warren,203.2,99.79024,SF,42,687,132,270,0.489,22,67,0.328,28,35,0.8,26,95,121,40,22,12,20,65,314,138,45,7,-12,-69,21,50.5,-60,-9.5,0.4888888888888889,0.3283582089552239,0.8
2022,Golden State Warriors,Virginia,Ty Jerome,195.58,88.45044,SG,45,816,118,242,0.488,35,90,0.389,38,41,0.927,7,71,78,135,23,5,30,64,309,124,55,3,-12,-60,35,50.8,-37,13.799999999999997,0.48760330578512395,0.3888888888888889,0.926829268292683
2022,Golden State Warriors,Arkansas,Moses Moody,195.58,95.707912,SG,63,817,108,227,0.476,49,135,0.363,37,53,0.698,28,77,105,51,18,7,34,54,302,119,86,16,-22,-111,21,38.8,-112,-73.2,0.47577092511013214,0.362962962962963,0.6981132075471698
2022,Detroit Pistons,,R.J. Hampton,193.04,79.3786,SG,47,750,102,237,0.43,41,116,0.353,57,76,0.75,18,69,87,54,27,9,42,51,302,135,75,19,-66,-102,38,34.2,-130,-95.8,0.43037974683544306,0.35344827586206895,0.75
2022,Detroit Pistons,,R.J. Hampton,193.04,79.3786,SG,47,750,102,237,0.43,41,116,0.353,57,76,0.75,18,69,87,54,27,9,42,51,302,135,75,19,-66,-102,38,34.2,-130,-95.8,0.43037974683544306,0.35344827586206895,0.75
2022,Detroit Pistons,,R.J. Hampton,193.04,79.3786,SG,47,750,102,237,0.43,41,116,0.353,57,76,0.75,18,69,87,54,27,9,42,51,302,135,75,19,-66,-102,38,34.2,-130,-95.8,0.43037974683544306,0.35344827586206895,0.75
2022,Detroit Pistons,,R.J. Hampton,193.04,79.3786,SG,47,750,102,237,0.43,41,116,0.353,57,76,0.75,18,69,87,54,27,9,42,51,302,135,75,19,-66,-102,38,34.2,-130,-95.8,0.43037974683544306,0.35344827586206895,0.75
2022,Detroit Pistons,,R.J. Hampton,193.04,79.3786,SG,47,750,102,237,0.43,41,116,0.353,57,76,0.75,18,69,87,54,27,9,42,51,302,135,75,19,-66,-102,38,34.2,-130,-95.8,0.43037974683544306,0.35344827586206895,0.75
2022,Detroit Pistons,,R.J. Hampton,193.04,79.3786,SG,47,750,102,237,0.43,41,116,0.353,57,76,0.75,18,69,87,54,27,9,42,51,302,135,75,19,-66,-102,38,34.2,-130,-95.8,0.43037974683544306,0.35344827586206895,0.75
2022,Detroit Pistons,,R.J. Hampton,193.04,79.3786,SG,47,750,102,237,0.43,41,116,0.353,57,76,0.75,18,69,87,54,27,9,42,51,302,135,75,19,-66,-102,38,34.2,-130,-95.8,0.43037974683544306,0.35344827586206895,0.75
2022,Detroit Pistons,,R.J. Hampton,193.04,79.3786,SG,47,750,102,237,0.43,41,116,0.353,57,76,0.75,18,69,87,54,27,9,42,51,302,135,75,19,-66,-102,38,34.2,-130,-95.8,0.43037974683544306,0.35344827586206895,0.75
2022,Detroit Pistons,,R.J. Hampton,193.04,79.3786,SG,47,750,102,237,0.43,41,116,0.353,57,76,0.75,18,69,87,54,27,9,42,51,302,135,75,19,-66,-102,38,34.2,-130,-95.8,0.43037974683544306,0.35344827586206895,0.75
2022,San Antonio Spurs,Indiana,Romeo Langford,195.58,97.975872,SG,43,844,121,259,0.467,16,61,0.262,39,56,0.696,57,57,114,50,24,13,30,67,297,138,45,17,-34,-87,22,55.4,-99,-43.6,0.4671814671814672,0.26229508196721313,0.6964285714285714
2022,Portland Trail Blazers,Washington,Matisse Thybulle,195.58,91.171992,SF,71,1200,110,253,0.435,54,148,0.365,19,28,0.679,40,100,140,53,83,32,24,113,293,143,94,9,-66,-120,10,98.1,-176,-77.9,0.43478260869565216,0.36486486486486486,0.6785714285714286
2022,Portland Trail Blazers,Washington,Matisse Thybulle,195.58,91.171992,SF,71,1200,110,253,0.435,54,148,0.365,19,28,0.679,40,100,140,53,83,32,24,113,293,143,94,9,-66,-120,10,98.1,-176,-77.9,0.43478260869565216,0.36486486486486486,0.6785714285714286
2022,Portland Trail Blazers,Washington,Matisse Thybulle,195.58,91.171992,SF,71,1200,110,253,0.435,54,148,0.365,19,28,0.679,40,100,140,53,83,32,24,113,293,143,94,9,-66,-120,10,98.1,-176,-77.9,0.43478260869565216,0.36486486486486486,0.6785714285714286
2022,Portland Trail Blazers,Washington,Matisse Thybulle,195.58,91.171992,SF,71,1200,110,253,0.435,54,148,0.365,19,28,0.679,40,100,140,53,83,32,24,113,293,143,94,9,-66,-120,10,98.1,-176,-77.9,0.43478260869565216,0.36486486486486486,0.6785714285714286
2022,Portland Trail Blazers,Washington,Matisse Thybulle,195.58,91.171992,SF,71,1200,110,253,0.435,54,148,0.365,19,28,0.679,40,100,140,53,83,32,24,113,293,143,94,9,-66,-120,10,98.1,-176,-77.9,0.43478260869565216,0.36486486486486486,0.6785714285714286
2022,Portland Trail Blazers,Washington,Matisse Thybulle,195.58,91.171992,SF,71,1200,110,253,0.435,54,148,0.365,19,28,0.679,40,100,140,53,83,32,24,113,293,143,94,9,-66,-120,10,98.1,-176,-77.9,0.43478260869565216,0.36486486486486486,0.6785714285714286
2022,Portland Trail Blazers,Washington,Matisse Thybulle,195.58,91.171992,SG,71,1200,110,253,0.435,54,148,0.365,19,28,0.679,40,100,140,53,83,32,24,113,293,143,94,9,-66,-120,10,98.1,-176,-77.9,0.43478260869565216,0.36486486486486486,0.6785714285714286
2022,Portland Trail Blazers,Washington,Matisse Thybulle,195.58,91.171992,SG,71,1200,110,253,0.435,54,148,0.365,19,28,0.679,40,100,140,53,83,32,24,113,293,143,94,9,-66,-120,10,98.1,-176,-77.9,0.43478260869565216,0.36486486486486486,0.6785714285714286
2022,Portland Trail Blazers,Washington,Matisse Thybulle,195.58,91.171992,SG,71,1200,110,253,0.435,54,148,0.365,19,28,0.679,40,100,140,53,83,32,24,113,293,143,94,9,-66,-120,10,98.1,-176,-77.9,0.43478260869565216,0.36486486486486486,0.6785714285714286
2022,Utah Jazz,Connecticut,Rudy Gay,203.2,113.398,PF,56,816,109,287,0.38,33,130,0.254,42,49,0.857,33,130,163,57,19,18,37,68,293,178,97,7,-138,-192,35,59.85,-295,-235.15,0.3797909407665505,0.25384615384615383,0.8571428571428571
2022,Oklahoma City Thunder,Villanova,Jeremiah Robinson-Earl,203.2,108.86208,PF,43,814,110,248,0.444,37,111,0.333,35,42,0.833,71,109,180,43,24,11,19,71,292,138,74,7,-56,-111,28,77.95,-139,-61.05,0.4435483870967742,0.3333333333333333,0.8333333333333334
2022,Brooklyn Nets,Louisiana State,Ben Simmons,208.28,108.86208,PG,42,1105,133,235,0.566,0,2,0.0,25,57,0.439,40,223,263,256,54,24,97,139,291,102,2,32,62,-6,-7,123.3,49,172.3,0.5659574468085107,0.0,0.43859649122807015
2022,Utah Jazz,Providence,Kris Dunn,190.5,92.98636,PG,22,568,116,216,0.537,17,36,0.472,41,53,0.774,9,91,100,124,25,10,35,58,290,100,19,12,32,-6,29,55.35,55,110.35,0.5370370370370371,0.4722222222222222,0.7735849056603774
2022,Oklahoma City Thunder,Arkansas,Jaylin Williams,205.74,108.86208,C,49,914,102,234,0.436,46,113,0.407,38,54,0.704,44,197,241,76,28,12,37,111,288,132,67,16,-60,-63,22,86.2,-101,-14.799999999999997,0.4358974358974359,0.40707964601769914,0.7037037037037037
2022,Los Angeles Clippers,Tennessee State,Robert Covington,200.66,94.800728,PF,48,779,102,229,0.445,54,136,0.397,30,40,0.75,31,135,166,57,38,33,32,86,288,127,82,10,-50,-84,20,78.7,-114,-35.3,0.44541484716157204,0.39705882352941174,0.75
2022,Philadelphia 76ers,DePaul,Paul Reed,205.74,95.25432,C,69,755,124,209,0.593,1,6,0.167,38,51,0.745,112,150,262,27,46,51,45,123,287,85,5,13,78,-12,25,120.1,91,211.1,0.5933014354066986,0.16666666666666666,0.7450980392156863
2022,Houston Rockets,Ohio State,Jae'Sean Tate,195.58,104.32616,SF,31,677,110,229,0.48,13,46,0.283,50,69,0.725,41,77,118,84,21,7,47,106,283,119,33,19,-18,-60,31,45.95,-47,-1.0499999999999972,0.48034934497816595,0.2826086956521739,0.7246376811594203
2022,Detroit Pistons,Oregon,Eugene Omoruyi,198.12,106.59412,SF,40,645,101,228,0.443,25,89,0.281,51,75,0.68,43,68,111,28,28,3,34,91,278,127,64,24,-52,-117,27,39.45,-142,-102.55,0.44298245614035087,0.2808988764044944,0.68
2022,Detroit Pistons,Oregon,Eugene Omoruyi,198.12,106.59412,SF,40,645,101,228,0.443,25,89,0.281,51,75,0.68,43,68,111,28,28,3,34,91,278,127,64,24,-52,-117,27,39.45,-142,-102.55,0.44298245614035087,0.2808988764044944,0.68
2022,Detroit Pistons,Oregon,Eugene Omoruyi,198.12,106.59412,SF,40,645,101,228,0.443,25,89,0.281,51,75,0.68,43,68,111,28,28,3,34,91,278,127,64,24,-52,-117,27,39.45,-142,-102.55,0.44298245614035087,0.2808988764044944,0.68
2022,Detroit Pistons,Oregon,Eugene Omoruyi,198.12,106.59412,SF,40,645,101,228,0.443,25,89,0.281,51,75,0.68,43,68,111,28,28,3,34,91,278,127,64,24,-52,-117,27,39.45,-142,-102.55,0.44298245614035087,0.2808988764044944,0.68
2022,Detroit Pistons,Oregon,Eugene Omoruyi,198.12,106.59412,SF,40,645,101,228,0.443,25,89,0.281,51,75,0.68,43,68,111,28,28,3,34,91,278,127,64,24,-52,-117,27,39.45,-142,-102.55,0.44298245614035087,0.2808988764044944,0.68
2022,Detroit Pistons,Oregon,Eugene Omoruyi,198.12,106.59412,SF,40,645,101,228,0.443,25,89,0.281,51,75,0.68,43,68,111,28,28,3,34,91,278,127,64,24,-52,-117,27,39.45,-142,-102.55,0.44298245614035087,0.2808988764044944,0.68
2022,Detroit Pistons,Oregon,Eugene Omoruyi,198.12,106.59412,SF,40,645,101,228,0.443,25,89,0.281,51,75,0.68,43,68,111,28,28,3,34,91,278,127,64,24,-52,-117,27,39.45,-142,-102.55,0.44298245614035087,0.2808988764044944,0.68
2022,Detroit Pistons,Oregon,Eugene Omoruyi,198.12,106.59412,SF,40,645,101,228,0.443,25,89,0.281,51,75,0.68,43,68,111,28,28,3,34,91,278,127,64,24,-52,-117,27,39.45,-142,-102.55,0.44298245614035087,0.2808988764044944,0.68
2022,Detroit Pistons,Oregon,Eugene Omoruyi,198.12,106.59412,SF,40,645,101,228,0.443,25,89,0.281,51,75,0.68,43,68,111,28,28,3,34,91,278,127,64,24,-52,-117,27,39.45,-142,-102.55,0.44298245614035087,0.2808988764044944,0.68
2022,Denver Nuggets,Arizona,Zeke Nnaji,205.74,108.86208,PF,53,728,110,196,0.561,17,65,0.262,40,62,0.645,65,73,138,18,17,23,31,105,277,86,48,22,48,-93,18,54.5,-27,27.5,0.5612244897959183,0.26153846153846155,0.6451612903225806
2022,Oklahoma City Thunder,,Aleksej Pokusevski,213.36,95.25432,PF,34,701,108,249,0.434,38,104,0.365,22,35,0.629,45,114,159,64,20,43,43,58,276,141,66,13,-66,-84,9,74.1,-141,-66.9,0.43373493975903615,0.36538461538461536,0.6285714285714286
2022,Boston Celtics,Oregon,Payton Pritchard,185.42,88.45044,PG,48,643,101,245,0.412,56,154,0.364,12,16,0.75,25,63,88,64,14,1,40,37,270,144,98,4,-86,-126,8,29.9,-204,-174.1,0.4122448979591837,0.36363636363636365,0.75
2022,Philadelphia 76ers,Texas A&M,Danuel House Jr.,198.12,99.79024,SF,56,807,93,197,0.472,37,110,0.336,45,60,0.75,9,85,94,44,14,9,26,69,268,104,73,15,-22,-108,30,31.8,-100,-68.2,0.4720812182741117,0.33636363636363636,0.75
2022,Miami Heat,Michigan,Duncan Robinson,200.66,97.52228,SF,42,690,88,237,0.371,63,192,0.328,29,32,0.906,8,61,69,46,14,0,28,77,268,149,129,3,-122,-198,26,19.9,-294,-274.1,0.37130801687763715,0.328125,0.90625
2022,Milwaukee Bucks,,MarJon Beauchamp,200.66,90.264808,SF,52,701,96,243,0.395,47,142,0.331,27,37,0.73,38,77,115,35,21,7,45,71,266,147,95,10,-102,-144,17,34.95,-229,-194.05,0.3950617283950617,0.33098591549295775,0.7297297297297297
2022,Philadelphia 76ers,Texas,P.J. Tucker,195.58,111.13004,PF,75,1920,96,225,0.427,55,140,0.393,19,23,0.826,95,200,295,60,39,15,44,180,266,129,85,4,-66,-90,15,108.5,-141,-32.5,0.4266666666666667,0.39285714285714285,0.8260869565217391
2022,Phoenix Suns,,Bismack Biyombo,203.2,115.66596,C,61,874,119,206,0.578,0,0,0.0,25,70,0.357,89,171,260,56,18,88,51,114,263,87,0,45,64,0,-20,123.05,44,167.05,0.5776699029126213,,0.35714285714285715
2022,San Antonio Spurs,Seton Hall,Sandro Mamukelashvili,208.28,108.86208,C,43,660,97,230,0.422,30,99,0.303,39,57,0.684,70,115,185,62,14,12,35,52,263,133,69,18,-72,-117,21,72.15,-168,-95.85,0.4217391304347826,0.30303030303030304,0.6842105263157895
2022,San Antonio Spurs,Seton Hall,Sandro Mamukelashvili,208.28,108.86208,C,43,660,97,230,0.422,30,99,0.303,39,57,0.684,70,115,185,62,14,12,35,52,263,133,69,18,-72,-117,21,72.15,-168,-95.85,0.4217391304347826,0.30303030303030304,0.6842105263157895
2022,San Antonio Spurs,Seton Hall,Sandro Mamukelashvili,208.28,108.86208,C,43,660,97,230,0.422,30,99,0.303,39,57,0.684,70,115,185,62,14,12,35,52,263,133,69,18,-72,-117,21,72.15,-168,-95.85,0.4217391304347826,0.30303030303030304,0.6842105263157895
2022,San Antonio Spurs,Seton Hall,Sandro Mamukelashvili,208.28,108.86208,C,43,660,97,230,0.422,30,99,0.303,39,57,0.684,70,115,185,62,14,12,35,52,263,133,69,18,-72,-117,21,72.15,-168,-95.85,0.4217391304347826,0.30303030303030304,0.6842105263157895
2022,San Antonio Spurs,Seton Hall,Sandro Mamukelashvili,208.28,108.86208,C,43,660,97,230,0.422,30,99,0.303,39,57,0.684,70,115,185,62,14,12,35,52,263,133,69,18,-72,-117,21,72.15,-168,-95.85,0.4217391304347826,0.30303030303030304,0.6842105263157895
2022,San Antonio Spurs,Seton Hall,Sandro Mamukelashvili,208.28,108.86208,C,43,660,97,230,0.422,30,99,0.303,39,57,0.684,70,115,185,62,14,12,35,52,263,133,69,18,-72,-117,21,72.15,-168,-95.85,0.4217391304347826,0.30303030303030304,0.6842105263157895
2022,San Antonio Spurs,Seton Hall,Sandro Mamukelashvili,208.28,108.86208,C,43,660,97,230,0.422,30,99,0.303,39,57,0.684,70,115,185,62,14,12,35,52,263,133,69,18,-72,-117,21,72.15,-168,-95.85,0.4217391304347826,0.30303030303030304,0.6842105263157895
2022,San Antonio Spurs,Seton Hall,Sandro Mamukelashvili,208.28,108.86208,C,43,660,97,230,0.422,30,99,0.303,39,57,0.684,70,115,185,62,14,12,35,52,263,133,69,18,-72,-117,21,72.15,-168,-95.85,0.4217391304347826,0.30303030303030304,0.6842105263157895
2022,San Antonio Spurs,Seton Hall,Sandro Mamukelashvili,208.28,108.86208,C,43,660,97,230,0.422,30,99,0.303,39,57,0.684,70,115,185,62,14,12,35,52,263,133,69,18,-72,-117,21,72.15,-168,-95.85,0.4217391304347826,0.30303030303030304,0.6842105263157895
2022,Charlotte Hornets,Auburn,JT Thor,205.74,92.079176,PF,69,969,95,238,0.399,39,123,0.317,33,47,0.702,36,116,152,36,22,23,44,66,262,143,84,14,-96,-135,19,53.2,-212,-158.8,0.39915966386554624,0.3170731707317073,0.7021276595744681
2022,Boston Celtics,Vanderbilt,Luke Kornet,218.44,113.398,C,69,804,113,170,0.665,3,13,0.231,32,39,0.821,86,111,197,53,11,46,25,81,261,57,10,7,112,-21,25,95.95,116,211.95,0.6647058823529411,0.23076923076923078,0.8205128205128205
2022,Atlanta Hawks,Lipscomb,Garrison Mathews,198.12,97.52228,SG,54,686,73,201,0.363,63,180,0.35,48,53,0.906,11,62,73,26,24,5,19,62,257,128,117,5,-110,-162,43,29.4,-229,-199.6,0.36318407960199006,0.35,0.9056603773584906
2022,Atlanta Hawks,Lipscomb,Garrison Mathews,198.12,97.52228,SG,54,686,73,201,0.363,63,180,0.35,48,53,0.906,11,62,73,26,24,5,19,62,257,128,117,5,-110,-162,43,29.4,-229,-199.6,0.36318407960199006,0.35,0.9056603773584906
2022,Atlanta Hawks,Lipscomb,Garrison Mathews,198.12,97.52228,SG,54,686,73,201,0.363,63,180,0.35,48,53,0.906,11,62,73,26,24,5,19,62,257,128,117,5,-110,-162,43,29.4,-229,-199.6,0.36318407960199006,0.35,0.9056603773584906
2022,Atlanta Hawks,Lipscomb,Garrison Mathews,198.12,97.52228,SG,54,686,73,201,0.363,63,180,0.35,48,53,0.906,11,62,73,26,24,5,19,62,257,128,117,5,-110,-162,43,29.4,-229,-199.6,0.36318407960199006,0.35,0.9056603773584906
2022,Atlanta Hawks,Lipscomb,Garrison Mathews,198.12,97.52228,SG,54,686,73,201,0.363,63,180,0.35,48,53,0.906,11,62,73,26,24,5,19,62,257,128,117,5,-110,-162,43,29.4,-229,-199.6,0.36318407960199006,0.35,0.9056603773584906
2022,Atlanta Hawks,Lipscomb,Garrison Mathews,198.12,97.52228,SG,54,686,73,201,0.363,63,180,0.35,48,53,0.906,11,62,73,26,24,5,19,62,257,128,117,5,-110,-162,43,29.4,-229,-199.6,0.36318407960199006,0.35,0.9056603773584906
2022,Atlanta Hawks,Lipscomb,Garrison Mathews,198.12,97.52228,SG,54,686,73,201,0.363,63,180,0.35,48,53,0.906,11,62,73,26,24,5,19,62,257,128,117,5,-110,-162,43,29.4,-229,-199.6,0.36318407960199006,0.35,0.9056603773584906
2022,Atlanta Hawks,Lipscomb,Garrison Mathews,198.12,97.52228,SG,54,686,73,201,0.363,63,180,0.35,48,53,0.906,11,62,73,26,24,5,19,62,257,128,117,5,-110,-162,43,29.4,-229,-199.6,0.36318407960199006,0.35,0.9056603773584906
2022,Atlanta Hawks,Lipscomb,Garrison Mathews,198.12,97.52228,SG,54,686,73,201,0.363,63,180,0.35,48,53,0.906,11,62,73,26,24,5,19,62,257,128,117,5,-110,-162,43,29.4,-229,-199.6,0.36318407960199006,0.35,0.9056603773584906
2022,Minnesota Timberwolves,Duke,Austin Rivers,193.04,90.7184,SG,52,1016,91,209,0.435,43,123,0.35,30,39,0.769,5,78,83,75,28,4,23,80,255,118,80,9,-54,-111,21,41.25,-144,-102.75,0.4354066985645933,0.34959349593495936,0.7692307692307693
2022,Phoenix Suns,Baylor,Ish Wainright,195.58,113.398,SF,60,915,84,227,0.37,57,173,0.329,26,31,0.839,45,94,139,53,38,22,22,117,251,143,116,5,-118,-177,21,72.4,-274,-201.6,0.3700440528634361,0.32947976878612717,0.8387096774193549
2022,Atlanta Hawks,UCLA,Aaron Holiday,182.88,83.91452,PG,63,845,92,220,0.418,36,88,0.409,27,32,0.844,25,49,74,89,37,12,36,79,247,128,52,5,-72,-48,22,49.55,-98,-48.45,0.41818181818181815,0.4090909090909091,0.84375
2022,Charlotte Hornets,Nebraska,Bryce McGowens,198.12,79.3786,SG,46,787,80,202,0.396,26,80,0.325,60,80,0.75,20,73,93,54,15,6,43,48,246,122,54,20,-84,-84,40,28.35,-128,-99.65,0.39603960396039606,0.325,0.75
2022,Toronto Raptors,San Diego State,Malachi Flynn,185.42,79.3786,PG,53,691,87,242,0.36,47,133,0.353,25,33,0.758,15,61,76,70,21,4,25,65,246,155,86,8,-136,-117,17,37.0,-236,-199.0,0.359504132231405,0.3533834586466165,0.7575757575757576
2022,Brooklyn Nets,St. Mary's,Patty Mills,182.88,81.64656,PG,40,567,86,209,0.411,49,134,0.366,25,30,0.833,8,36,44,56,15,3,30,32,246,123,85,5,-74,-108,20,19.4,-162,-142.6,0.41148325358851673,0.3656716417910448,0.8333333333333334
2022,New York Knicks,Ohio State,Duane Washington Jr.,187.96,89.357624,SG,31,394,94,256,0.367,40,111,0.36,16,24,0.667,2,34,36,63,6,4,34,23,244,162,71,8,-136,-93,8,12.1,-221,-208.9,0.3671875,0.36036036036036034,0.6666666666666666
2022,Toronto Raptors,Georgia Tech,Thaddeus Young,203.2,106.59412,PF,54,795,108,198,0.545,6,34,0.176,18,26,0.692,71,95,166,75,54,5,42,88,240,90,28,8,36,-66,10,82.1,-20,62.099999999999994,0.5454545454545454,0.17647058823529413,0.6923076923076923
2022,Detroit Pistons,Oklahoma State,Cade Cunningham,200.66,99.79024,PG,12,400,93,224,0.415,17,61,0.279,36,43,0.837,12,62,74,72,10,7,39,34,239,131,44,7,-76,-81,29,26.8,-128,-101.2,0.41517857142857145,0.2786885245901639,0.8372093023255814
2022,Miami Heat,Wheeling Jesuit,Haywood Highsmith,195.58,99.79024,PF,54,969,93,216,0.431,37,109,0.339,13,28,0.464,57,131,188,43,36,17,45,82,236,123,72,15,-60,-105,-2,71.9,-167,-95.1,0.4305555555555556,0.3394495412844037,0.4642857142857143
2022,New Orleans Pelicans,Texas,Jaxson Hayes,213.36,99.79024,C,47,610,86,156,0.551,3,29,0.103,58,83,0.699,39,93,132,34,20,19,31,67,233,70,26,25,32,-69,33,51.9,-4,47.9,0.5512820512820513,0.10344827586206896,0.6987951807228916
2022,Indiana Pacers,Indiana-Purdue Indianapolis,George Hill,193.04,85.275296,PG,46,833,78,166,0.47,34,95,0.358,42,55,0.764,15,70,85,110,26,6,34,55,232,88,61,13,-20,-81,29,48.75,-72,-23.25,0.46987951807228917,0.35789473684210527,0.7636363636363637
2022,Indiana Pacers,Indiana-Purdue Indianapolis,George Hill,193.04,85.275296,PG,46,833,78,166,0.47,34,95,0.358,42,55,0.764,15,70,85,110,26,6,34,55,232,88,61,13,-20,-81,29,48.75,-72,-23.25,0.46987951807228917,0.35789473684210527,0.7636363636363637
2022,Indiana Pacers,Indiana-Purdue Indianapolis,George Hill,193.04,85.275296,PG,46,833,78,166,0.47,34,95,0.358,42,55,0.764,15,70,85,110,26,6,34,55,232,88,61,13,-20,-81,29,48.75,-72,-23.25,0.46987951807228917,0.35789473684210527,0.7636363636363637
2022,Indiana Pacers,Indiana-Purdue Indianapolis,George Hill,193.04,85.275296,PG,46,833,78,166,0.47,34,95,0.358,42,55,0.764,15,70,85,110,26,6,34,55,232,88,61,13,-20,-81,29,48.75,-72,-23.25,0.46987951807228917,0.35789473684210527,0.7636363636363637
2022,Indiana Pacers,Indiana-Purdue Indianapolis,George Hill,193.04,85.275296,PG,46,833,78,166,0.47,34,95,0.358,42,55,0.764,15,70,85,110,26,6,34,55,232,88,61,13,-20,-81,29,48.75,-72,-23.25,0.46987951807228917,0.35789473684210527,0.7636363636363637
2022,Indiana Pacers,Indiana-Purdue Indianapolis,George Hill,193.04,85.275296,PG,46,833,78,166,0.47,34,95,0.358,42,55,0.764,15,70,85,110,26,6,34,55,232,88,61,13,-20,-81,29,48.75,-72,-23.25,0.46987951807228917,0.35789473684210527,0.7636363636363637
2022,Indiana Pacers,Indiana-Purdue Indianapolis,George Hill,193.04,85.275296,SG,46,833,78,166,0.47,34,95,0.358,42,55,0.764,15,70,85,110,26,6,34,55,232,88,61,13,-20,-81,29,48.75,-72,-23.25,0.46987951807228917,0.35789473684210527,0.7636363636363637
2022,Indiana Pacers,Indiana-Purdue Indianapolis,George Hill,193.04,85.275296,SG,46,833,78,166,0.47,34,95,0.358,42,55,0.764,15,70,85,110,26,6,34,55,232,88,61,13,-20,-81,29,48.75,-72,-23.25,0.46987951807228917,0.35789473684210527,0.7636363636363637
2022,Indiana Pacers,Indiana-Purdue Indianapolis,George Hill,193.04,85.275296,SG,46,833,78,166,0.47,34,95,0.358,42,55,0.764,15,70,85,110,26,6,34,55,232,88,61,13,-20,-81,29,48.75,-72,-23.25,0.46987951807228917,0.35789473684210527,0.7636363636363637
2022,Brooklyn Nets,North Carolina,Day'Ron Sharpe,205.74,120.20188,C,48,553,93,171,0.544,6,11,0.545,35,55,0.636,99,101,200,37,15,32,42,89,227,78,5,20,30,3,15,82.05,48,130.05,0.543859649122807,0.5454545454545454,0.6363636363636364
2022,New Orleans Pelicans,,Dyson Daniels,200.66,90.264808,PG,59,1042,87,208,0.418,27,86,0.314,26,40,0.65,36,152,188,134,43,11,57,99,227,121,59,14,-68,-96,12,83.05,-152,-68.95,0.4182692307692308,0.313953488372093,0.65
2022,Houston Rockets,,Daishen Nix,193.04,102.511792,PG,57,914,81,237,0.342,40,140,0.286,24,36,0.667,18,80,98,132,31,7,86,59,226,156,100,12,-150,-180,12,35.05,-318,-282.95,0.34177215189873417,0.2857142857142857,0.6666666666666666
2022,Houston Rockets,,Usman Garuba,203.2,103.872568,C,75,970,86,177,0.486,24,59,0.407,29,47,0.617,120,187,307,64,44,29,47,135,225,91,35,18,-10,-33,11,129.0,-32,97.0,0.4858757062146893,0.4067796610169492,0.6170212765957447
2022,Phoenix Suns,,Darius Bazley,205.74,97.975872,C,43,616,83,183,0.454,20,53,0.377,38,70,0.543,34,104,138,38,22,34,27,44,224,100,33,32,-34,-39,6,64.8,-67,-2.200000000000003,0.453551912568306,0.37735849056603776,0.5428571428571428
2022,Phoenix Suns,,Darius Bazley,205.74,97.975872,C,43,616,83,183,0.454,20,53,0.377,38,70,0.543,34,104,138,38,22,34,27,44,224,100,33,32,-34,-39,6,64.8,-67,-2.200000000000003,0.453551912568306,0.37735849056603776,0.5428571428571428
2022,Phoenix Suns,,Darius Bazley,205.74,97.975872,C,43,616,83,183,0.454,20,53,0.377,38,70,0.543,34,104,138,38,22,34,27,44,224,100,33,32,-34,-39,6,64.8,-67,-2.200000000000003,0.453551912568306,0.37735849056603776,0.5428571428571428
2022,Phoenix Suns,,Darius Bazley,205.74,97.975872,C,43,616,83,183,0.454,20,53,0.377,38,70,0.543,34,104,138,38,22,34,27,44,224,100,33,32,-34,-39,6,64.8,-67,-2.200000000000003,0.453551912568306,0.37735849056603776,0.5428571428571428
2022,Phoenix Suns,,Darius Bazley,205.74,97.975872,C,43,616,83,183,0.454,20,53,0.377,38,70,0.543,34,104,138,38,22,34,27,44,224,100,33,32,-34,-39,6,64.8,-67,-2.200000000000003,0.453551912568306,0.37735849056603776,0.5428571428571428
2022,Phoenix Suns,,Darius Bazley,205.74,97.975872,C,43,616,83,183,0.454,20,53,0.377,38,70,0.543,34,104,138,38,22,34,27,44,224,100,33,32,-34,-39,6,64.8,-67,-2.200000000000003,0.453551912568306,0.37735849056603776,0.5428571428571428
2022,Phoenix Suns,,Darius Bazley,205.74,97.975872,C,43,616,83,183,0.454,20,53,0.377,38,70,0.543,34,104,138,38,22,34,27,44,224,100,33,32,-34,-39,6,64.8,-67,-2.200000000000003,0.453551912568306,0.37735849056603776,0.5428571428571428
2022,Phoenix Suns,,Darius Bazley,205.74,97.975872,C,43,616,83,183,0.454,20,53,0.377,38,70,0.543,34,104,138,38,22,34,27,44,224,100,33,32,-34,-39,6,64.8,-67,-2.200000000000003,0.453551912568306,0.37735849056603776,0.5428571428571428
2022,Phoenix Suns,,Darius Bazley,205.74,97.975872,C,43,616,83,183,0.454,20,53,0.377,38,70,0.543,34,104,138,38,22,34,27,44,224,100,33,32,-34,-39,6,64.8,-67,-2.200000000000003,0.453551912568306,0.37735849056603776,0.5428571428571428
2022,New York Knicks,West Virginia,Miles McBride,187.96,88.45044,PG,64,760,77,215,0.358,40,134,0.299,28,42,0.667,13,37,50,72,37,8,25,60,222,138,94,14,-122,-162,14,40.75,-270,-229.25,0.3581395348837209,0.29850746268656714,0.6666666666666666
2022,Charlotte Hornets,Kansas,Svi Mykhailiuk,200.66,92.98636,SF,32,468,77,173,0.445,42,99,0.424,26,39,0.667,15,38,53,53,15,4,24,23,222,96,57,13,-38,-45,13,26.6,-70,-43.4,0.44508670520231214,0.42424242424242425,0.6666666666666666
2022,Charlotte Hornets,Kansas,Svi Mykhailiuk,200.66,92.98636,SF,32,468,77,173,0.445,42,99,0.424,26,39,0.667,15,38,53,53,15,4,24,23,222,96,57,13,-38,-45,13,26.6,-70,-43.4,0.44508670520231214,0.42424242424242425,0.6666666666666666
2022,Charlotte Hornets,Kansas,Svi Mykhailiuk,200.66,92.98636,SF,32,468,77,173,0.445,42,99,0.424,26,39,0.667,15,38,53,53,15,4,24,23,222,96,57,13,-38,-45,13,26.6,-70,-43.4,0.44508670520231214,0.42424242424242425,0.6666666666666666
2022,Charlotte Hornets,Kansas,Svi Mykhailiuk,200.66,92.98636,SF,32,468,77,173,0.445,42,99,0.424,26,39,0.667,15,38,53,53,15,4,24,23,222,96,57,13,-38,-45,13,26.6,-70,-43.4,0.44508670520231214,0.42424242424242425,0.6666666666666666
2022,Charlotte Hornets,Kansas,Svi Mykhailiuk,200.66,92.98636,SF,32,468,77,173,0.445,42,99,0.424,26,39,0.667,15,38,53,53,15,4,24,23,222,96,57,13,-38,-45,13,26.6,-70,-43.4,0.44508670520231214,0.42424242424242425,0.6666666666666666
2022,Charlotte Hornets,Kansas,Svi Mykhailiuk,200.66,92.98636,SF,32,468,77,173,0.445,42,99,0.424,26,39,0.667,15,38,53,53,15,4,24,23,222,96,57,13,-38,-45,13,26.6,-70,-43.4,0.44508670520231214,0.42424242424242425,0.6666666666666666
2022,Charlotte Hornets,Kansas,Svi Mykhailiuk,200.66,92.98636,SF,32,468,77,173,0.445,42,99,0.424,26,39,0.667,15,38,53,53,15,4,24,23,222,96,57,13,-38,-45,13,26.6,-70,-43.4,0.44508670520231214,0.42424242424242425,0.6666666666666666
2022,Charlotte Hornets,Kansas,Svi Mykhailiuk,200.66,92.98636,SF,32,468,77,173,0.445,42,99,0.424,26,39,0.667,15,38,53,53,15,4,24,23,222,96,57,13,-38,-45,13,26.6,-70,-43.4,0.44508670520231214,0.42424242424242425,0.6666666666666666
2022,Charlotte Hornets,Kansas,Svi Mykhailiuk,200.66,92.98636,SF,32,468,77,173,0.445,42,99,0.424,26,39,0.667,15,38,53,53,15,4,24,23,222,96,57,13,-38,-45,13,26.6,-70,-43.4,0.44508670520231214,0.42424242424242425,0.6666666666666666
2022,Dallas Mavericks,,Maxi Kleber,208.28,108.86208,PF,37,930,77,169,0.456,39,112,0.348,27,38,0.711,30,105,135,52,12,30,27,85,220,92,73,11,-30,-102,16,57.5,-116,-58.5,0.4556213017751479,0.3482142857142857,0.7105263157894737
2022,Portland Trail Blazers,Colorado,Jabari Walker,200.66,90.7184,SF,56,619,83,198,0.419,16,56,0.286,34,45,0.756,48,83,131,34,10,13,29,69,216,115,40,11,-64,-72,23,46.8,-113,-66.2,0.41919191919191917,0.2857142857142857,0.7555555555555555
2022,Oklahoma City Thunder,Oklahoma State,Lindy Waters III,198.12,95.25432,SG,41,531,70,178,0.393,58,162,0.358,16,20,0.8,16,59,75,28,14,11,10,42,214,108,104,4,-76,-138,12,35.15,-202,-166.85,0.39325842696629215,0.35802469135802467,0.8
2022,Memphis Grizzlies,Stanford,Ziaire Williams,205.74,83.91452,SF,37,561,84,196,0.429,25,97,0.258,17,22,0.773,16,63,79,35,14,6,37,58,210,112,72,5,-56,-141,12,21.1,-185,-163.9,0.42857142857142855,0.25773195876288657,0.7727272727272727
2022,Cleveland Cavaliers,Kansas State,Dean Wade,205.74,103.418976,PF,44,892,73,177,0.412,45,127,0.354,15,23,0.652,20,130,150,37,28,21,17,89,206,104,82,8,-62,-111,7,63.3,-166,-102.7,0.4124293785310734,0.3543307086614173,0.6521739130434783
2022,Dallas Mavericks,Washington,Justin Holiday,198.12,81.64656,SF,46,706,77,204,0.377,46,143,0.322,5,8,0.625,5,50,55,41,19,19,22,68,205,127,97,3,-100,-153,2,29.85,-251,-221.15,0.37745098039215685,0.32167832167832167,0.625
2022,Dallas Mavericks,Washington,Justin Holiday,198.12,81.64656,SF,46,706,77,204,0.377,46,143,0.322,5,8,0.625,5,50,55,41,19,19,22,68,205,127,97,3,-100,-153,2,29.85,-251,-221.15,0.37745098039215685,0.32167832167832167,0.625
2022,Dallas Mavericks,Washington,Justin Holiday,198.12,81.64656,SF,46,706,77,204,0.377,46,143,0.322,5,8,0.625,5,50,55,41,19,19,22,68,205,127,97,3,-100,-153,2,29.85,-251,-221.15,0.37745098039215685,0.32167832167832167,0.625
2022,Dallas Mavericks,Washington,Justin Holiday,198.12,81.64656,SF,46,706,77,204,0.377,46,143,0.322,5,8,0.625,5,50,55,41,19,19,22,68,205,127,97,3,-100,-153,2,29.85,-251,-221.15,0.37745098039215685,0.32167832167832167,0.625
2022,Dallas Mavericks,Washington,Justin Holiday,198.12,81.64656,SF,46,706,77,204,0.377,46,143,0.322,5,8,0.625,5,50,55,41,19,19,22,68,205,127,97,3,-100,-153,2,29.85,-251,-221.15,0.37745098039215685,0.32167832167832167,0.625
2022,Dallas Mavericks,Washington,Justin Holiday,198.12,81.64656,SF,46,706,77,204,0.377,46,143,0.322,5,8,0.625,5,50,55,41,19,19,22,68,205,127,97,3,-100,-153,2,29.85,-251,-221.15,0.37745098039215685,0.32167832167832167,0.625
2022,Dallas Mavericks,Washington,Justin Holiday,198.12,81.64656,SF,46,706,77,204,0.377,46,143,0.322,5,8,0.625,5,50,55,41,19,19,22,68,205,127,97,3,-100,-153,2,29.85,-251,-221.15,0.37745098039215685,0.32167832167832167,0.625
2022,Dallas Mavericks,Washington,Justin Holiday,198.12,81.64656,SF,46,706,77,204,0.377,46,143,0.322,5,8,0.625,5,50,55,41,19,19,22,68,205,127,97,3,-100,-153,2,29.85,-251,-221.15,0.37745098039215685,0.32167832167832167,0.625
2022,Dallas Mavericks,Washington,Justin Holiday,198.12,81.64656,SF,46,706,77,204,0.377,46,143,0.322,5,8,0.625,5,50,55,41,19,19,22,68,205,127,97,3,-100,-153,2,29.85,-251,-221.15,0.37745098039215685,0.32167832167832167,0.625
2022,San Antonio Spurs,Western Kentucky,Charles Bassey,205.74,104.32616,C,35,508,87,135,0.644,3,8,0.375,22,37,0.595,75,118,193,48,16,33,41,74,199,48,5,15,78,-6,7,79.3,79,158.3,0.6444444444444445,0.375,0.5945945945945946
2022,Denver Nuggets,Texas A&M,DeAndre Jordan,210.82,120.20188,C,39,586,88,115,0.765,1,1,1.0,22,48,0.458,52,150,202,34,12,23,48,71,199,27,0,26,122,3,-4,61.95,121,182.95,0.7652173913043478,1.0,0.4583333333333333
2022,Philadelphia 76ers,Southern California,Dewayne Dedmon,208.28,111.13004,C,38,426,77,151,0.51,12,39,0.308,33,49,0.673,34,100,134,26,9,19,25,75,199,74,27,16,6,-45,17,46.25,-22,24.25,0.5099337748344371,0.3076923076923077,0.673469387755102
2022,Philadelphia 76ers,Southern California,Dewayne Dedmon,208.28,111.13004,C,38,426,77,151,0.51,12,39,0.308,33,49,0.673,34,100,134,26,9,19,25,75,199,74,27,16,6,-45,17,46.25,-22,24.25,0.5099337748344371,0.3076923076923077,0.673469387755102
2022,Philadelphia 76ers,Southern California,Dewayne Dedmon,208.28,111.13004,C,38,426,77,151,0.51,12,39,0.308,33,49,0.673,34,100,134,26,9,19,25,75,199,74,27,16,6,-45,17,46.25,-22,24.25,0.5099337748344371,0.3076923076923077,0.673469387755102
2022,Philadelphia 76ers,Southern California,Dewayne Dedmon,208.28,111.13004,C,38,426,77,151,0.51,12,39,0.308,33,49,0.673,34,100,134,26,9,19,25,75,199,74,27,16,6,-45,17,46.25,-22,24.25,0.5099337748344371,0.3076923076923077,0.673469387755102
2022,Philadelphia 76ers,Southern California,Dewayne Dedmon,208.28,111.13004,C,38,426,77,151,0.51,12,39,0.308,33,49,0.673,34,100,134,26,9,19,25,75,199,74,27,16,6,-45,17,46.25,-22,24.25,0.5099337748344371,0.3076923076923077,0.673469387755102
2022,Philadelphia 76ers,Southern California,Dewayne Dedmon,208.28,111.13004,C,38,426,77,151,0.51,12,39,0.308,33,49,0.673,34,100,134,26,9,19,25,75,199,74,27,16,6,-45,17,46.25,-22,24.25,0.5099337748344371,0.3076923076923077,0.673469387755102
2022,Philadelphia 76ers,Southern California,Dewayne Dedmon,208.28,111.13004,C,38,426,77,151,0.51,12,39,0.308,33,49,0.673,34,100,134,26,9,19,25,75,199,74,27,16,6,-45,17,46.25,-22,24.25,0.5099337748344371,0.3076923076923077,0.673469387755102
2022,Philadelphia 76ers,Southern California,Dewayne Dedmon,208.28,111.13004,C,38,426,77,151,0.51,12,39,0.308,33,49,0.673,34,100,134,26,9,19,25,75,199,74,27,16,6,-45,17,46.25,-22,24.25,0.5099337748344371,0.3076923076923077,0.673469387755102
2022,Philadelphia 76ers,Southern California,Dewayne Dedmon,208.28,111.13004,C,38,426,77,151,0.51,12,39,0.308,33,49,0.673,34,100,134,26,9,19,25,75,199,74,27,16,6,-45,17,46.25,-22,24.25,0.5099337748344371,0.3076923076923077,0.673469387755102
2022,Portland Trail Blazers,Duke,Justise Winslow,198.12,100.697424,PF,29,776,81,198,0.409,14,45,0.311,20,28,0.714,49,96,145,98,30,11,43,89,196,117,31,8,-72,-51,12,67.55,-111,-43.45,0.4090909090909091,0.3111111111111111,0.7142857142857143
2022,Washington Wizards,Virginia,Anthony Gill,203.2,104.32616,PF,59,625,71,132,0.538,4,29,0.138,49,67,0.731,37,62,99,34,7,12,15,70,195,61,25,18,20,-63,31,41.0,-12,29.0,0.5378787878787878,0.13793103448275862,0.7313432835820896
2022,Orlando Magic,Michigan,Caleb Houstan,203.2,92.98636,SF,51,812,66,182,0.363,46,136,0.338,15,18,0.833,34,65,99,30,12,7,18,63,193,116,90,3,-100,-132,12,38.1,-220,-181.9,0.3626373626373626,0.3382352941176471,0.8333333333333334
2022,Oklahoma City Thunder,,Ousmane Dieng,205.74,83.91452,PF,39,569,76,181,0.42,26,98,0.265,15,23,0.652,19,86,105,46,14,7,26,42,193,105,72,8,-58,-138,7,37.9,-189,-151.1,0.4198895027624309,0.2653061224489796,0.6521739130434783
2022,Charlotte Hornets,Connecticut,James Bouknight,193.04,86.18248,SG,34,515,69,193,0.358,33,109,0.303,20,30,0.667,8,64,72,41,14,5,32,49,191,124,76,10,-110,-129,10,21.3,-229,-207.7,0.35751295336787564,0.30275229357798167,0.6666666666666666
2022,Portland Trail Blazers,Tennessee,Keon Johnson,190.5,83.91452,SG,40,416,67,178,0.376,28,81,0.346,27,41,0.659,11,33,44,59,19,6,43,43,189,111,53,14,-88,-75,13,17.35,-150,-132.65,0.37640449438202245,0.345679012345679,0.6585365853658537
2022,Dallas Mavericks,Nevada,JaVale McGee,213.36,122.46984,C,42,355,80,125,0.64,2,5,0.4,24,41,0.585,30,77,107,11,4,26,36,54,186,45,3,17,70,-3,7,31.3,74,105.3,0.64,0.4,0.5853658536585366
2022,San Antonio Spurs,Notre Dame,Blake Wesley,193.04,83.91452,SG,37,669,69,215,0.321,20,52,0.385,26,44,0.591,12,70,82,98,25,5,65,67,184,146,32,18,-154,-36,8,27.15,-182,-154.85,0.3209302325581395,0.38461538461538464,0.5909090909090909
2022,Detroit Pistons,Kansas State,Rodney McGruder,193.04,92.98636,SG,32,524,62,152,0.408,41,97,0.423,18,22,0.818,20,54,74,28,16,1,11,39,183,90,56,4,-56,-45,14,31.55,-87,-55.45,0.40789473684210525,0.422680412371134,0.8181818181818182
2022,Toronto Raptors,Arizona,Christian Koloko,213.36,104.32616,C,58,802,72,150,0.48,1,12,0.083,37,59,0.627,84,87,171,31,21,57,20,128,182,78,11,22,-12,-30,15,94.1,-27,67.1,0.48,0.08333333333333333,0.6271186440677966
2022,Minnesota Timberwolves,Iowa,Luka Garza,208.28,110.222856,C,28,243,63,116,0.543,14,39,0.359,41,52,0.788,33,30,63,18,3,2,14,43,181,53,25,11,20,-33,30,21.85,17,38.85,0.5431034482758621,0.358974358974359,0.7884615384615384
2022,Milwaukee Bucks,Marquette,Wesley Matthews,195.58,99.79024,SF,52,820,58,160,0.363,39,124,0.315,24,28,0.857,34,79,113,34,20,13,18,71,179,102,85,4,-88,-138,20,49.2,-206,-156.8,0.3625,0.31451612903225806,0.8571428571428571
2022,New York Knicks,Texas,Jericho Sims,208.28,113.398,C,52,812,83,107,0.776,0,1,0.0,12,16,0.75,99,143,242,25,15,28,27,96,178,24,1,4,118,-3,8,94.7,123,217.7,0.7757009345794392,0.0,0.75
2022,San Antonio Spurs,Arizona,Stanley Johnson,198.12,109.769264,SF,30,470,65,122,0.533,18,40,0.45,26,39,0.667,22,73,95,67,16,6,33,48,174,57,22,13,16,-12,13,38.1,17,55.1,0.5327868852459017,0.45,0.6666666666666666
2022,Los Angeles Clippers,Minnesota,Amir Coffey,200.66,95.25432,SF,50,625,56,145,0.386,11,40,0.275,49,63,0.778,17,36,53,53,7,5,21,50,172,89,29,14,-66,-54,35,23.75,-85,-61.25,0.38620689655172413,0.275,0.7777777777777778
2022,New York Knicks,Nebraska,Isaiah Roby,203.2,104.32616,PF,42,474,67,155,0.432,18,60,0.3,20,41,0.488,21,86,107,38,18,7,31,53,172,88,42,21,-42,-72,-1,35.85,-115,-79.15,0.432258064516129,0.3,0.4878048780487805
2022,Cleveland Cavaliers,,Ricky Rubio,187.96,86.18248,PG,33,566,61,178,0.343,21,82,0.256,28,35,0.8,9,61,70,115,26,6,31,51,171,117,61,7,-112,-120,21,46.45,-211,-164.55,0.34269662921348315,0.25609756097560976,0.8
2022,Boston Celtics,Oklahoma,Blake Griffin,205.74,113.398,C,41,569,63,130,0.485,23,66,0.348,21,32,0.656,47,108,155,61,14,9,22,75,170,67,43,11,-8,-60,10,62.5,-58,4.5,0.4846153846153846,0.3484848484848485,0.65625
2022,Washington Wizards,Southern California,Taj Gibson,205.74,105.233344,C,49,480,65,125,0.52,8,24,0.333,30,42,0.714,32,61,93,34,15,12,26,84,168,60,16,12,10,-24,18,36.05,4,40.05,0.52,0.3333333333333333,0.7142857142857143
2022,Orlando Magic,,Goga Bitadze,210.82,113.398,C,38,457,69,125,0.552,6,26,0.231,23,42,0.548,61,76,137,39,16,26,22,64,167,56,20,19,26,-42,4,66.05,-12,54.05,0.552,0.23076923076923078,0.5476190476190477
2022,Orlando Magic,,Goga Bitadze,210.82,113.398,C,38,457,69,125,0.552,6,26,0.231,23,42,0.548,61,76,137,39,16,26,22,64,167,56,20,19,26,-42,4,66.05,-12,54.05,0.552,0.23076923076923078,0.5476190476190477
2022,Orlando Magic,,Goga Bitadze,210.82,113.398,C,38,457,69,125,0.552,6,26,0.231,23,42,0.548,61,76,137,39,16,26,22,64,167,56,20,19,26,-42,4,66.05,-12,54.05,0.552,0.23076923076923078,0.5476190476190477
2022,Orlando Magic,,Goga Bitadze,210.82,113.398,C,38,457,69,125,0.552,6,26,0.231,23,42,0.548,61,76,137,39,16,26,22,64,167,56,20,19,26,-42,4,66.05,-12,54.05,0.552,0.23076923076923078,0.5476190476190477
2022,Orlando Magic,,Goga Bitadze,210.82,113.398,C,38,457,69,125,0.552,6,26,0.231,23,42,0.548,61,76,137,39,16,26,22,64,167,56,20,19,26,-42,4,66.05,-12,54.05,0.552,0.23076923076923078,0.5476190476190477
2022,Orlando Magic,,Goga Bitadze,210.82,113.398,C,38,457,69,125,0.552,6,26,0.231,23,42,0.548,61,76,137,39,16,26,22,64,167,56,20,19,26,-42,4,66.05,-12,54.05,0.552,0.23076923076923078,0.5476190476190477
2022,Orlando Magic,,Goga Bitadze,210.82,113.398,C,38,457,69,125,0.552,6,26,0.231,23,42,0.548,61,76,137,39,16,26,22,64,167,56,20,19,26,-42,4,66.05,-12,54.05,0.552,0.23076923076923078,0.5476190476190477
2022,Orlando Magic,,Goga Bitadze,210.82,113.398,C,38,457,69,125,0.552,6,26,0.231,23,42,0.548,61,76,137,39,16,26,22,64,167,56,20,19,26,-42,4,66.05,-12,54.05,0.552,0.23076923076923078,0.5476190476190477
2022,Orlando Magic,,Goga Bitadze,210.82,113.398,C,38,457,69,125,0.552,6,26,0.231,23,42,0.548,61,76,137,39,16,26,22,64,167,56,20,19,26,-42,4,66.05,-12,54.05,0.552,0.23076923076923078,0.5476190476190477
2022,New York Knicks,,Evan Fournier,198.12,92.98636,SG,27,459,56,166,0.337,35,114,0.307,18,21,0.857,4,45,49,36,16,3,22,46,165,110,79,3,-108,-132,15,18.45,-225,-206.55,0.3373493975903614,0.30701754385964913,0.8571428571428571
2022,Chicago Bulls,Radford,Javonte Green,195.58,92.98636,SF,32,480,61,108,0.565,13,35,0.371,30,45,0.667,27,61,88,23,24,21,20,52,165,47,22,15,28,-27,15,44.4,16,60.4,0.5648148148148148,0.37142857142857144,0.6666666666666666
2022,San Antonio Spurs,St. John's,Julian Champagnie,200.66,98.429464,SF,17,320,59,130,0.454,33,82,0.402,14,17,0.824,10,50,60,10,6,5,11,26,165,71,49,3,-24,-48,11,18.7,-61,-42.3,0.45384615384615384,0.4024390243902439,0.8235294117647058
2022,San Antonio Spurs,St. John's,Julian Champagnie,200.66,98.429464,SF,17,320,59,130,0.454,33,82,0.402,14,17,0.824,10,50,60,10,6,5,11,26,165,71,49,3,-24,-48,11,18.7,-61,-42.3,0.45384615384615384,0.4024390243902439,0.8235294117647058
2022,San Antonio Spurs,St. John's,Julian Champagnie,200.66,98.429464,SF,17,320,59,130,0.454,33,82,0.402,14,17,0.824,10,50,60,10,6,5,11,26,165,71,49,3,-24,-48,11,18.7,-61,-42.3,0.45384615384615384,0.4024390243902439,0.8235294117647058
2022,San Antonio Spurs,St. John's,Julian Champagnie,200.66,98.429464,SF,17,320,59,130,0.454,33,82,0.402,14,17,0.824,10,50,60,10,6,5,11,26,165,71,49,3,-24,-48,11,18.7,-61,-42.3,0.45384615384615384,0.4024390243902439,0.8235294117647058
2022,San Antonio Spurs,St. John's,Julian Champagnie,200.66,98.429464,SF,17,320,59,130,0.454,33,82,0.402,14,17,0.824,10,50,60,10,6,5,11,26,165,71,49,3,-24,-48,11,18.7,-61,-42.3,0.45384615384615384,0.4024390243902439,0.8235294117647058
2022,San Antonio Spurs,St. John's,Julian Champagnie,200.66,98.429464,SF,17,320,59,130,0.454,33,82,0.402,14,17,0.824,10,50,60,10,6,5,11,26,165,71,49,3,-24,-48,11,18.7,-61,-42.3,0.45384615384615384,0.4024390243902439,0.8235294117647058
2022,San Antonio Spurs,St. John's,Julian Champagnie,200.66,98.429464,SF,17,320,59,130,0.454,33,82,0.402,14,17,0.824,10,50,60,10,6,5,11,26,165,71,49,3,-24,-48,11,18.7,-61,-42.3,0.45384615384615384,0.4024390243902439,0.8235294117647058
2022,San Antonio Spurs,St. John's,Julian Champagnie,200.66,98.429464,SF,17,320,59,130,0.454,33,82,0.402,14,17,0.824,10,50,60,10,6,5,11,26,165,71,49,3,-24,-48,11,18.7,-61,-42.3,0.45384615384615384,0.4024390243902439,0.8235294117647058
2022,San Antonio Spurs,St. John's,Julian Champagnie,200.66,98.429464,SF,17,320,59,130,0.454,33,82,0.402,14,17,0.824,10,50,60,10,6,5,11,26,165,71,49,3,-24,-48,11,18.7,-61,-42.3,0.45384615384615384,0.4024390243902439,0.8235294117647058
2022,Washington Wizards,Wisconsin,Johnny Davis,193.04,88.45044,SG,28,423,66,171,0.386,17,70,0.243,14,27,0.519,10,55,65,28,10,8,17,48,163,105,53,13,-78,-108,1,23.85,-185,-161.15,0.38596491228070173,0.24285714285714285,0.5185185185185185
2022,Minnesota Timberwolves,Southern California,Jordan McLaughlin,182.88,83.91452,PG,43,679,61,145,0.421,24,78,0.308,15,18,0.833,15,47,62,148,32,4,33,28,161,84,54,3,-46,-90,12,56.35,-124,-67.65,0.4206896551724138,0.3076923076923077,0.8333333333333334
2022,Charlotte Hornets,Texas,Kai Jones,210.82,100.243832,C,46,550,67,120,0.558,4,19,0.211,19,26,0.731,37,86,123,15,17,30,31,65,157,53,15,7,28,-33,12,48.5,7,55.5,0.5583333333333333,0.21052631578947367,0.7307692307692307
2022,Cleveland Cavaliers,,Raul Neto,187.96,81.64656,PG,48,505,57,110,0.518,12,42,0.286,31,34,0.912,10,36,46,79,17,4,24,49,157,53,30,3,8,-54,28,29.8,-18,11.8,0.5181818181818182,0.2857142857142857,0.9117647058823529
2022,Orlando Magic,Tennessee,Admiral Schofield,195.58,109.315672,PF,37,451,55,122,0.451,24,74,0.324,21,23,0.913,23,39,62,31,8,5,16,61,155,67,50,2,-24,-78,19,24.45,-83,-58.55,0.45081967213114754,0.32432432432432434,0.9130434782608695
2022,Utah Jazz,Marquette,Juan Toscano-Anderson,198.12,94.800728,SF,52,700,64,143,0.448,8,43,0.186,19,24,0.792,28,96,124,65,16,10,34,80,155,79,35,5,-30,-81,14,46.25,-97,-50.75,0.44755244755244755,0.18604651162790697,0.7916666666666666
2022,Utah Jazz,Marquette,Juan Toscano-Anderson,198.12,94.800728,SF,52,700,64,143,0.448,8,43,0.186,19,24,0.792,28,96,124,65,16,10,34,80,155,79,35,5,-30,-81,14,46.25,-97,-50.75,0.44755244755244755,0.18604651162790697,0.7916666666666666
2022,Utah Jazz,Marquette,Juan Toscano-Anderson,198.12,94.800728,SF,52,700,64,143,0.448,8,43,0.186,19,24,0.792,28,96,124,65,16,10,34,80,155,79,35,5,-30,-81,14,46.25,-97,-50.75,0.44755244755244755,0.18604651162790697,0.7916666666666666
2022,Utah Jazz,Marquette,Juan Toscano-Anderson,198.12,94.800728,SF,52,700,64,143,0.448,8,43,0.186,19,24,0.792,28,96,124,65,16,10,34,80,155,79,35,5,-30,-81,14,46.25,-97,-50.75,0.44755244755244755,0.18604651162790697,0.7916666666666666
2022,Utah Jazz,Marquette,Juan Toscano-Anderson,198.12,94.800728,SF,52,700,64,143,0.448,8,43,0.186,19,24,0.792,28,96,124,65,16,10,34,80,155,79,35,5,-30,-81,14,46.25,-97,-50.75,0.44755244755244755,0.18604651162790697,0.7916666666666666
2022,Utah Jazz,Marquette,Juan Toscano-Anderson,198.12,94.800728,SF,52,700,64,143,0.448,8,43,0.186,19,24,0.792,28,96,124,65,16,10,34,80,155,79,35,5,-30,-81,14,46.25,-97,-50.75,0.44755244755244755,0.18604651162790697,0.7916666666666666
2022,Utah Jazz,Marquette,Juan Toscano-Anderson,198.12,94.800728,SF,52,700,64,143,0.448,8,43,0.186,19,24,0.792,28,96,124,65,16,10,34,80,155,79,35,5,-30,-81,14,46.25,-97,-50.75,0.44755244755244755,0.18604651162790697,0.7916666666666666
2022,Utah Jazz,Marquette,Juan Toscano-Anderson,198.12,94.800728,SF,52,700,64,143,0.448,8,43,0.186,19,24,0.792,28,96,124,65,16,10,34,80,155,79,35,5,-30,-81,14,46.25,-97,-50.75,0.44755244755244755,0.18604651162790697,0.7916666666666666
2022,Utah Jazz,Marquette,Juan Toscano-Anderson,198.12,94.800728,SF,52,700,64,143,0.448,8,43,0.186,19,24,0.792,28,96,124,65,16,10,34,80,155,79,35,5,-30,-81,14,46.25,-97,-50.75,0.44755244755244755,0.18604651162790697,0.7916666666666666
2022,Brooklyn Nets,UCLA,Moses Brown,218.44,111.13004,C,36,294,61,96,0.635,0,0,0.0,33,72,0.458,57,82,139,4,4,14,15,39,155,35,0,39,52,0,-6,49.55,46,95.55,0.6354166666666666,,0.4583333333333333
2022,Brooklyn Nets,UCLA,Moses Brown,218.44,111.13004,C,36,294,61,96,0.635,0,0,0.0,33,72,0.458,57,82,139,4,4,14,15,39,155,35,0,39,52,0,-6,49.55,46,95.55,0.6354166666666666,,0.4583333333333333
2022,Brooklyn Nets,UCLA,Moses Brown,218.44,111.13004,C,36,294,61,96,0.635,0,0,0.0,33,72,0.458,57,82,139,4,4,14,15,39,155,35,0,39,52,0,-6,49.55,46,95.55,0.6354166666666666,,0.4583333333333333
2022,Brooklyn Nets,UCLA,Moses Brown,218.44,111.13004,C,36,294,61,96,0.635,0,0,0.0,33,72,0.458,57,82,139,4,4,14,15,39,155,35,0,39,52,0,-6,49.55,46,95.55,0.6354166666666666,,0.4583333333333333
2022,Brooklyn Nets,UCLA,Moses Brown,218.44,111.13004,C,36,294,61,96,0.635,0,0,0.0,33,72,0.458,57,82,139,4,4,14,15,39,155,35,0,39,52,0,-6,49.55,46,95.55,0.6354166666666666,,0.4583333333333333
2022,Brooklyn Nets,UCLA,Moses Brown,218.44,111.13004,C,36,294,61,96,0.635,0,0,0.0,33,72,0.458,57,82,139,4,4,14,15,39,155,35,0,39,52,0,-6,49.55,46,95.55,0.6354166666666666,,0.4583333333333333
2022,Brooklyn Nets,UCLA,Moses Brown,218.44,111.13004,C,36,294,61,96,0.635,0,0,0.0,33,72,0.458,57,82,139,4,4,14,15,39,155,35,0,39,52,0,-6,49.55,46,95.55,0.6354166666666666,,0.4583333333333333
2022,Brooklyn Nets,UCLA,Moses Brown,218.44,111.13004,C,36,294,61,96,0.635,0,0,0.0,33,72,0.458,57,82,139,4,4,14,15,39,155,35,0,39,52,0,-6,49.55,46,95.55,0.6354166666666666,,0.4583333333333333
2022,Brooklyn Nets,UCLA,Moses Brown,218.44,111.13004,C,36,294,61,96,0.635,0,0,0.0,33,72,0.458,57,82,139,4,4,14,15,39,155,35,0,39,52,0,-6,49.55,46,95.55,0.6354166666666666,,0.4583333333333333
2022,Atlanta Hawks,Maryland,Bruno Fernando,208.28,108.86208,C,39,405,59,112,0.527,0,4,0.0,35,50,0.7,54,83,137,31,6,34,25,74,153,53,4,15,12,-12,20,59.3,20,79.3,0.5267857142857143,0.0,0.7
2022,Atlanta Hawks,Maryland,Bruno Fernando,208.28,108.86208,C,39,405,59,112,0.527,0,4,0.0,35,50,0.7,54,83,137,31,6,34,25,74,153,53,4,15,12,-12,20,59.3,20,79.3,0.5267857142857143,0.0,0.7
2022,Atlanta Hawks,Maryland,Bruno Fernando,208.28,108.86208,C,39,405,59,112,0.527,0,4,0.0,35,50,0.7,54,83,137,31,6,34,25,74,153,53,4,15,12,-12,20,59.3,20,79.3,0.5267857142857143,0.0,0.7
2022,Atlanta Hawks,Maryland,Bruno Fernando,208.28,108.86208,C,39,405,59,112,0.527,0,4,0.0,35,50,0.7,54,83,137,31,6,34,25,74,153,53,4,15,12,-12,20,59.3,20,79.3,0.5267857142857143,0.0,0.7
2022,Atlanta Hawks,Maryland,Bruno Fernando,208.28,108.86208,C,39,405,59,112,0.527,0,4,0.0,35,50,0.7,54,83,137,31,6,34,25,74,153,53,4,15,12,-12,20,59.3,20,79.3,0.5267857142857143,0.0,0.7
2022,Atlanta Hawks,Maryland,Bruno Fernando,208.28,108.86208,C,39,405,59,112,0.527,0,4,0.0,35,50,0.7,54,83,137,31,6,34,25,74,153,53,4,15,12,-12,20,59.3,20,79.3,0.5267857142857143,0.0,0.7
2022,Atlanta Hawks,Maryland,Bruno Fernando,208.28,108.86208,C,39,405,59,112,0.527,0,4,0.0,35,50,0.7,54,83,137,31,6,34,25,74,153,53,4,15,12,-12,20,59.3,20,79.3,0.5267857142857143,0.0,0.7
2022,Atlanta Hawks,Maryland,Bruno Fernando,208.28,108.86208,C,39,405,59,112,0.527,0,4,0.0,35,50,0.7,54,83,137,31,6,34,25,74,153,53,4,15,12,-12,20,59.3,20,79.3,0.5267857142857143,0.0,0.7
2022,Atlanta Hawks,Maryland,Bruno Fernando,208.28,108.86208,C,39,405,59,112,0.527,0,4,0.0,35,50,0.7,54,83,137,31,6,34,25,74,153,53,4,15,12,-12,20,59.3,20,79.3,0.5267857142857143,0.0,0.7
2022,New York Knicks,Memphis,Derrick Rose,190.5,90.7184,PG,27,338,61,159,0.384,19,63,0.302,11,12,0.917,8,32,40,46,7,5,22,18,152,98,44,1,-74,-75,10,17.6,-139,-121.4,0.3836477987421384,0.30158730158730157,0.9166666666666666
2022,Phoenix Suns,Vanderbilt,Saben Lee,187.96,83.007336,PG,25,374,49,121,0.405,11,30,0.367,42,57,0.737,13,32,45,67,19,1,24,32,151,72,19,15,-46,-24,27,27.65,-43,-15.350000000000001,0.4049586776859504,0.36666666666666664,0.7368421052631579
2022,Phoenix Suns,Vanderbilt,Saben Lee,187.96,83.007336,PG,25,374,49,121,0.405,11,30,0.367,42,57,0.737,13,32,45,67,19,1,24,32,151,72,19,15,-46,-24,27,27.65,-43,-15.350000000000001,0.4049586776859504,0.36666666666666664,0.7368421052631579
2022,Phoenix Suns,Vanderbilt,Saben Lee,187.96,83.007336,PG,25,374,49,121,0.405,11,30,0.367,42,57,0.737,13,32,45,67,19,1,24,32,151,72,19,15,-46,-24,27,27.65,-43,-15.350000000000001,0.4049586776859504,0.36666666666666664,0.7368421052631579
2022,Phoenix Suns,Vanderbilt,Saben Lee,187.96,83.007336,PG,25,374,49,121,0.405,11,30,0.367,42,57,0.737,13,32,45,67,19,1,24,32,151,72,19,15,-46,-24,27,27.65,-43,-15.350000000000001,0.4049586776859504,0.36666666666666664,0.7368421052631579
2022,Phoenix Suns,Vanderbilt,Saben Lee,187.96,83.007336,PG,25,374,49,121,0.405,11,30,0.367,42,57,0.737,13,32,45,67,19,1,24,32,151,72,19,15,-46,-24,27,27.65,-43,-15.350000000000001,0.4049586776859504,0.36666666666666664,0.7368421052631579
2022,Phoenix Suns,Vanderbilt,Saben Lee,187.96,83.007336,PG,25,374,49,121,0.405,11,30,0.367,42,57,0.737,13,32,45,67,19,1,24,32,151,72,19,15,-46,-24,27,27.65,-43,-15.350000000000001,0.4049586776859504,0.36666666666666664,0.7368421052631579
2022,Phoenix Suns,Vanderbilt,Saben Lee,187.96,83.007336,PG,25,374,49,121,0.405,11,30,0.367,42,57,0.737,13,32,45,67,19,1,24,32,151,72,19,15,-46,-24,27,27.65,-43,-15.350000000000001,0.4049586776859504,0.36666666666666664,0.7368421052631579
2022,Phoenix Suns,Vanderbilt,Saben Lee,187.96,83.007336,PG,25,374,49,121,0.405,11,30,0.367,42,57,0.737,13,32,45,67,19,1,24,32,151,72,19,15,-46,-24,27,27.65,-43,-15.350000000000001,0.4049586776859504,0.36666666666666664,0.7368421052631579
2022,Phoenix Suns,Vanderbilt,Saben Lee,187.96,83.007336,PG,25,374,49,121,0.405,11,30,0.367,42,57,0.737,13,32,45,67,19,1,24,32,151,72,19,15,-46,-24,27,27.65,-43,-15.350000000000001,0.4049586776859504,0.36666666666666664,0.7368421052631579
2022,Houston Rockets,Kentucky,TyTy Washington Jr.,190.5,88.45044,PG,31,433,58,160,0.363,19,80,0.238,10,18,0.556,2,43,45,47,15,2,14,29,145,102,61,8,-88,-126,2,23.55,-212,-188.45,0.3625,0.2375,0.5555555555555556
2022,Los Angeles Clippers,Kentucky,Brandon Boston Jr.,198.12,85.275296,SF,22,248,51,122,0.418,12,29,0.414,29,38,0.763,7,23,30,20,9,0,12,21,143,71,17,9,-40,-15,20,11.7,-35,-23.3,0.4180327868852459,0.41379310344827586,0.7631578947368421
2022,Toronto Raptors,Nebraska,Dalano Banton,200.66,92.532768,PG,31,279,55,130,0.423,15,51,0.294,17,24,0.708,11,34,45,36,13,13,18,34,142,75,36,7,-40,-63,10,25.3,-93,-67.7,0.4230769230769231,0.29411764705882354,0.7083333333333334
2022,Utah Jazz,Vanderbilt,Damian Jones,210.82,111.13004,C,41,477,55,86,0.64,10,17,0.588,22,29,0.759,42,80,122,15,8,21,23,55,142,31,7,7,48,9,15,45.0,72,117.0,0.6395348837209303,0.5882352941176471,0.7586206896551724
2022,Utah Jazz,Vanderbilt,Damian Jones,210.82,111.13004,C,41,477,55,86,0.64,10,17,0.588,22,29,0.759,42,80,122,15,8,21,23,55,142,31,7,7,48,9,15,45.0,72,117.0,0.6395348837209303,0.5882352941176471,0.7586206896551724
2022,Utah Jazz,Vanderbilt,Damian Jones,210.82,111.13004,C,41,477,55,86,0.64,10,17,0.588,22,29,0.759,42,80,122,15,8,21,23,55,142,31,7,7,48,9,15,45.0,72,117.0,0.6395348837209303,0.5882352941176471,0.7586206896551724
2022,Utah Jazz,Vanderbilt,Damian Jones,210.82,111.13004,C,41,477,55,86,0.64,10,17,0.588,22,29,0.759,42,80,122,15,8,21,23,55,142,31,7,7,48,9,15,45.0,72,117.0,0.6395348837209303,0.5882352941176471,0.7586206896551724
2022,Utah Jazz,Vanderbilt,Damian Jones,210.82,111.13004,C,41,477,55,86,0.64,10,17,0.588,22,29,0.759,42,80,122,15,8,21,23,55,142,31,7,7,48,9,15,45.0,72,117.0,0.6395348837209303,0.5882352941176471,0.7586206896551724
2022,Utah Jazz,Vanderbilt,Damian Jones,210.82,111.13004,C,41,477,55,86,0.64,10,17,0.588,22,29,0.759,42,80,122,15,8,21,23,55,142,31,7,7,48,9,15,45.0,72,117.0,0.6395348837209303,0.5882352941176471,0.7586206896551724
2022,Utah Jazz,Vanderbilt,Damian Jones,210.82,111.13004,C,41,477,55,86,0.64,10,17,0.588,22,29,0.759,42,80,122,15,8,21,23,55,142,31,7,7,48,9,15,45.0,72,117.0,0.6395348837209303,0.5882352941176471,0.7586206896551724
2022,Utah Jazz,Vanderbilt,Damian Jones,210.82,111.13004,C,41,477,55,86,0.64,10,17,0.588,22,29,0.759,42,80,122,15,8,21,23,55,142,31,7,7,48,9,15,45.0,72,117.0,0.6395348837209303,0.5882352941176471,0.7586206896551724
2022,Utah Jazz,Vanderbilt,Damian Jones,210.82,111.13004,C,41,477,55,86,0.64,10,17,0.588,22,29,0.759,42,80,122,15,8,21,23,55,142,31,7,7,48,9,15,45.0,72,117.0,0.6395348837209303,0.5882352941176471,0.7586206896551724
2022,Orlando Magic,Stephen F. Austin,Kevon Harris,198.12,97.975872,SG,34,457,47,107,0.439,16,43,0.372,31,41,0.756,28,42,70,16,17,5,21,53,141,60,27,10,-26,-33,21,26.35,-38,-11.649999999999999,0.4392523364485981,0.37209302325581395,0.7560975609756098
2022,Philadelphia 76ers,,Furkan Korkmaz,200.66,91.625584,SG,37,353,48,111,0.432,18,46,0.391,26,36,0.722,6,36,42,22,10,3,24,18,140,63,28,10,-30,-30,16,11.1,-44,-32.9,0.43243243243243246,0.391304347826087,0.7222222222222222
2022,Minnesota Timberwolves,William & Mary,Nathan Knight,203.2,114.758776,C,38,291,46,81,0.568,8,22,0.364,39,57,0.684,22,34,56,13,10,6,21,41,139,35,14,18,22,-18,21,18.2,25,43.2,0.5679012345679012,0.36363636363636365,0.6842105263157895
2022,Dallas Mavericks,,Frank Ntilikina,193.04,90.7184,SG,47,608,48,132,0.364,17,67,0.254,22,33,0.667,7,55,62,58,16,7,29,65,135,84,50,11,-72,-99,11,25.5,-160,-134.5,0.36363636363636365,0.2537313432835821,0.6666666666666666
2022,Dallas Mavericks,Kansas,Markieff Morris,205.74,111.13004,PF,35,355,47,115,0.409,28,71,0.394,10,10,1.0,13,58,71,31,9,5,18,48,132,68,43,0,-42,-45,10,24.35,-77,-52.65,0.40869565217391307,0.39436619718309857,1.0
2022,Dallas Mavericks,Kansas,Markieff Morris,205.74,111.13004,PF,35,355,47,115,0.409,28,71,0.394,10,10,1.0,13,58,71,31,9,5,18,48,132,68,43,0,-42,-45,10,24.35,-77,-52.65,0.40869565217391307,0.39436619718309857,1.0
2022,Dallas Mavericks,Kansas,Markieff Morris,205.74,111.13004,PF,35,355,47,115,0.409,28,71,0.394,10,10,1.0,13,58,71,31,9,5,18,48,132,68,43,0,-42,-45,10,24.35,-77,-52.65,0.40869565217391307,0.39436619718309857,1.0
2022,Dallas Mavericks,Kansas,Markieff Morris,205.74,111.13004,PF,35,355,47,115,0.409,28,71,0.394,10,10,1.0,13,58,71,31,9,5,18,48,132,68,43,0,-42,-45,10,24.35,-77,-52.65,0.40869565217391307,0.39436619718309857,1.0
2022,Dallas Mavericks,Kansas,Markieff Morris,205.74,111.13004,PF,35,355,47,115,0.409,28,71,0.394,10,10,1.0,13,58,71,31,9,5,18,48,132,68,43,0,-42,-45,10,24.35,-77,-52.65,0.40869565217391307,0.39436619718309857,1.0
2022,Dallas Mavericks,Kansas,Markieff Morris,205.74,111.13004,PF,35,355,47,115,0.409,28,71,0.394,10,10,1.0,13,58,71,31,9,5,18,48,132,68,43,0,-42,-45,10,24.35,-77,-52.65,0.40869565217391307,0.39436619718309857,1.0
2022,Dallas Mavericks,Kansas,Markieff Morris,205.74,111.13004,PF,35,355,47,115,0.409,28,71,0.394,10,10,1.0,13,58,71,31,9,5,18,48,132,68,43,0,-42,-45,10,24.35,-77,-52.65,0.40869565217391307,0.39436619718309857,1.0
2022,Dallas Mavericks,Kansas,Markieff Morris,205.74,111.13004,PF,35,355,47,115,0.409,28,71,0.394,10,10,1.0,13,58,71,31,9,5,18,48,132,68,43,0,-42,-45,10,24.35,-77,-52.65,0.40869565217391307,0.39436619718309857,1.0
2022,Dallas Mavericks,Kansas,Markieff Morris,205.74,111.13004,PF,35,355,47,115,0.409,28,71,0.394,10,10,1.0,13,58,71,31,9,5,18,48,132,68,43,0,-42,-45,10,24.35,-77,-52.65,0.40869565217391307,0.39436619718309857,1.0
2022,Sacramento Kings,Bowling Green,Richaun Holmes,203.2,106.59412,C,42,348,55,89,0.618,5,8,0.625,15,19,0.789,29,51,80,9,3,11,14,50,130,34,3,4,42,6,11,27.0,59,86.0,0.6179775280898876,0.625,0.7894736842105263
2022,Orlando Magic,Auburn,Chuma Okeke,203.2,103.872568,SF,27,518,43,122,0.352,26,86,0.302,16,21,0.762,26,70,96,37,19,11,17,40,128,79,60,5,-72,-102,11,44.25,-163,-118.75,0.3524590163934426,0.3023255813953488,0.7619047619047619
2022,Los Angeles Lakers,Michigan State,Max Christie,195.58,86.18248,SG,41,512,44,106,0.415,26,62,0.419,14,16,0.875,7,68,75,21,9,7,13,33,128,62,36,2,-36,-30,12,25.6,-54,-28.4,0.41509433962264153,0.41935483870967744,0.875
2022,Utah Jazz,Kansas,Udoka Azubuike,210.82,122.46984,C,36,359,59,72,0.819,0,0,0.0,7,20,0.35,31,88,119,11,6,15,18,34,125,13,0,13,92,0,-6,40.05,86,126.05,0.8194444444444444,,0.35
2022,Milwaukee Bucks,Marquette,Jae Crowder,198.12,106.59412,PF,18,340,45,94,0.479,24,55,0.436,10,12,0.833,17,52,69,27,12,6,7,27,124,49,31,2,-8,-21,8,32.4,-21,11.399999999999999,0.4787234042553192,0.43636363636363634,0.8333333333333334
2022,Minnesota Timberwolves,Tennessee-Chattanooga,Matt Ryan,198.12,97.52228,SF,34,310,40,108,0.37,32,84,0.381,10,12,0.833,4,22,26,16,5,1,7,27,122,68,52,2,-56,-60,8,9.65,-108,-98.35,0.37037037037037035,0.38095238095238093,0.8333333333333334
2022,Minnesota Timberwolves,Tennessee-Chattanooga,Matt Ryan,198.12,97.52228,SF,34,310,40,108,0.37,32,84,0.381,10,12,0.833,4,22,26,16,5,1,7,27,122,68,52,2,-56,-60,8,9.65,-108,-98.35,0.37037037037037035,0.38095238095238093,0.8333333333333334
2022,Minnesota Timberwolves,Tennessee-Chattanooga,Matt Ryan,198.12,97.52228,SF,34,310,40,108,0.37,32,84,0.381,10,12,0.833,4,22,26,16,5,1,7,27,122,68,52,2,-56,-60,8,9.65,-108,-98.35,0.37037037037037035,0.38095238095238093,0.8333333333333334
2022,Minnesota Timberwolves,Tennessee-Chattanooga,Matt Ryan,198.12,97.52228,SF,34,310,40,108,0.37,32,84,0.381,10,12,0.833,4,22,26,16,5,1,7,27,122,68,52,2,-56,-60,8,9.65,-108,-98.35,0.37037037037037035,0.38095238095238093,0.8333333333333334
2022,Minnesota Timberwolves,Tennessee-Chattanooga,Matt Ryan,198.12,97.52228,SF,34,310,40,108,0.37,32,84,0.381,10,12,0.833,4,22,26,16,5,1,7,27,122,68,52,2,-56,-60,8,9.65,-108,-98.35,0.37037037037037035,0.38095238095238093,0.8333333333333334
2022,Minnesota Timberwolves,Tennessee-Chattanooga,Matt Ryan,198.12,97.52228,SF,34,310,40,108,0.37,32,84,0.381,10,12,0.833,4,22,26,16,5,1,7,27,122,68,52,2,-56,-60,8,9.65,-108,-98.35,0.37037037037037035,0.38095238095238093,0.8333333333333334
2022,Minnesota Timberwolves,Tennessee-Chattanooga,Matt Ryan,198.12,97.52228,SF,34,310,40,108,0.37,32,84,0.381,10,12,0.833,4,22,26,16,5,1,7,27,122,68,52,2,-56,-60,8,9.65,-108,-98.35,0.37037037037037035,0.38095238095238093,0.8333333333333334
2022,Minnesota Timberwolves,Tennessee-Chattanooga,Matt Ryan,198.12,97.52228,SF,34,310,40,108,0.37,32,84,0.381,10,12,0.833,4,22,26,16,5,1,7,27,122,68,52,2,-56,-60,8,9.65,-108,-98.35,0.37037037037037035,0.38095238095238093,0.8333333333333334
2022,Minnesota Timberwolves,Tennessee-Chattanooga,Matt Ryan,198.12,97.52228,SF,34,310,40,108,0.37,32,84,0.381,10,12,0.833,4,22,26,16,5,1,7,27,122,68,52,2,-56,-60,8,9.65,-108,-98.35,0.37037037037037035,0.38095238095238093,0.8333333333333334
2022,San Antonio Spurs,Louisville,Gorgui Dieng,208.28,112.490816,C,31,358,45,117,0.385,21,75,0.28,10,13,0.769,27,80,107,53,4,14,32,57,121,72,54,3,-54,-99,7,36.9,-146,-109.1,0.38461538461538464,0.28,0.7692307692307693
2022,Memphis Grizzlies,Louisiana Tech,Kenneth Lofton Jr.,198.12,124.7378,PF,24,176,49,93,0.527,6,17,0.353,16,27,0.593,19,32,51,20,5,2,12,28,120,44,11,11,10,-15,5,18.6,0,18.6,0.5268817204301075,0.35294117647058826,0.5925925925925926
2022,Miami Heat,Fresno State,Orlando Robinson,208.28,106.59412,C,31,425,47,89,0.528,0,6,0.0,22,31,0.71,48,78,126,25,12,12,16,53,116,42,6,9,10,-18,13,51.1,5,56.1,0.5280898876404494,0.0,0.7096774193548387
2022,New Orleans Pelicans,Alabama,Kira Lewis Jr.,185.42,77.11064,PG,25,235,40,88,0.455,15,34,0.441,19,22,0.864,5,28,33,23,10,2,10,24,114,48,19,3,-16,-12,16,15.05,-12,3.0500000000000007,0.45454545454545453,0.4411764705882353,0.8636363636363636
2022,Dallas Mavericks,Colorado,McKinley Wright IV,180.34,87.089664,PG,27,335,46,98,0.469,9,28,0.321,13,19,0.684,9,38,47,58,8,5,19,24,114,52,19,6,-12,-30,7,24.3,-35,-10.7,0.46938775510204084,0.32142857142857145,0.6842105263157895
2022,Cleveland Cavaliers,Stanford,Robin Lopez,213.36,127.459352,C,37,299,48,75,0.64,2,4,0.5,14,18,0.778,23,28,51,19,2,8,25,43,112,27,2,4,42,0,10,13.6,52,65.6,0.64,0.5,0.7777777777777778
2022,San Antonio Spurs,,Dominick Barlow,205.74,97.52228,PF,28,408,46,86,0.535,0,4,0.0,18,25,0.72,46,56,102,24,10,19,15,56,110,40,4,7,12,-12,11,47.2,11,58.2,0.5348837209302325,0.0,0.72
2022,Denver Nuggets,Wake Forest,Ish Smith,182.88,79.3786,PG,43,398,52,131,0.397,2,12,0.167,2,4,0.5,5,49,54,100,8,7,44,33,108,79,10,2,-54,-24,0,23.6,-78,-54.4,0.3969465648854962,0.16666666666666666,0.5
2022,Memphis Grizzlies,Wake Forest,Jake LaRavia,200.66,106.59412,PF,35,414,37,95,0.389,24,71,0.338,7,9,0.778,19,44,63,21,12,4,18,49,105,58,47,2,-42,-69,5,22.3,-106,-83.7,0.3894736842105263,0.3380281690140845,0.7777777777777778
2022,Golden State Warriors,Oregon State,Gary Payton II,187.96,88.45044,SG,22,368,41,69,0.594,13,26,0.5,6,7,0.857,24,45,69,30,22,5,16,43,101,28,13,1,26,0,5,34.1,31,65.1,0.5942028985507246,0.5,0.8571428571428571
2022,Golden State Warriors,Oregon State,Gary Payton II,187.96,88.45044,SG,22,368,41,69,0.594,13,26,0.5,6,7,0.857,24,45,69,30,22,5,16,43,101,28,13,1,26,0,5,34.1,31,65.1,0.5942028985507246,0.5,0.8571428571428571
2022,Golden State Warriors,Oregon State,Gary Payton II,187.96,88.45044,SG,22,368,41,69,0.594,13,26,0.5,6,7,0.857,24,45,69,30,22,5,16,43,101,28,13,1,26,0,5,34.1,31,65.1,0.5942028985507246,0.5,0.8571428571428571
2022,Golden State Warriors,Oregon State,Gary Payton II,187.96,88.45044,SG,22,368,41,69,0.594,13,26,0.5,6,7,0.857,24,45,69,30,22,5,16,43,101,28,13,1,26,0,5,34.1,31,65.1,0.5942028985507246,0.5,0.8571428571428571
2022,Golden State Warriors,Oregon State,Gary Payton II,187.96,88.45044,SG,22,368,41,69,0.594,13,26,0.5,6,7,0.857,24,45,69,30,22,5,16,43,101,28,13,1,26,0,5,34.1,31,65.1,0.5942028985507246,0.5,0.8571428571428571
2022,Golden State Warriors,Oregon State,Gary Payton II,187.96,88.45044,SG,22,368,41,69,0.594,13,26,0.5,6,7,0.857,24,45,69,30,22,5,16,43,101,28,13,1,26,0,5,34.1,31,65.1,0.5942028985507246,0.5,0.8571428571428571
2022,Golden State Warriors,Oregon State,Gary Payton II,187.96,88.45044,SG,22,368,41,69,0.594,13,26,0.5,6,7,0.857,24,45,69,30,22,5,16,43,101,28,13,1,26,0,5,34.1,31,65.1,0.5942028985507246,0.5,0.8571428571428571
2022,Golden State Warriors,Oregon State,Gary Payton II,187.96,88.45044,SG,22,368,41,69,0.594,13,26,0.5,6,7,0.857,24,45,69,30,22,5,16,43,101,28,13,1,26,0,5,34.1,31,65.1,0.5942028985507246,0.5,0.8571428571428571
2022,Golden State Warriors,Oregon State,Gary Payton II,187.96,88.45044,SG,22,368,41,69,0.594,13,26,0.5,6,7,0.857,24,45,69,30,22,5,16,43,101,28,13,1,26,0,5,34.1,31,65.1,0.5942028985507246,0.5,0.8571428571428571
2022,Sacramento Kings,Pepperdine,Kessler Edwards,200.66,92.079176,SF,36,386,36,93,0.387,17,55,0.309,11,15,0.733,23,38,61,23,14,6,13,40,100,57,38,4,-42,-63,7,28.25,-98,-69.75,0.3870967741935484,0.3090909090909091,0.7333333333333333
2022,Sacramento Kings,Pepperdine,Kessler Edwards,200.66,92.079176,SF,36,386,36,93,0.387,17,55,0.309,11,15,0.733,23,38,61,23,14,6,13,40,100,57,38,4,-42,-63,7,28.25,-98,-69.75,0.3870967741935484,0.3090909090909091,0.7333333333333333
2022,Sacramento Kings,Pepperdine,Kessler Edwards,200.66,92.079176,SF,36,386,36,93,0.387,17,55,0.309,11,15,0.733,23,38,61,23,14,6,13,40,100,57,38,4,-42,-63,7,28.25,-98,-69.75,0.3870967741935484,0.3090909090909091,0.7333333333333333
2022,Sacramento Kings,Pepperdine,Kessler Edwards,200.66,92.079176,SF,36,386,36,93,0.387,17,55,0.309,11,15,0.733,23,38,61,23,14,6,13,40,100,57,38,4,-42,-63,7,28.25,-98,-69.75,0.3870967741935484,0.3090909090909091,0.7333333333333333
2022,Sacramento Kings,Pepperdine,Kessler Edwards,200.66,92.079176,SF,36,386,36,93,0.387,17,55,0.309,11,15,0.733,23,38,61,23,14,6,13,40,100,57,38,4,-42,-63,7,28.25,-98,-69.75,0.3870967741935484,0.3090909090909091,0.7333333333333333
2022,Sacramento Kings,Pepperdine,Kessler Edwards,200.66,92.079176,SF,36,386,36,93,0.387,17,55,0.309,11,15,0.733,23,38,61,23,14,6,13,40,100,57,38,4,-42,-63,7,28.25,-98,-69.75,0.3870967741935484,0.3090909090909091,0.7333333333333333
2022,Sacramento Kings,Pepperdine,Kessler Edwards,200.66,92.079176,SF,36,386,36,93,0.387,17,55,0.309,11,15,0.733,23,38,61,23,14,6,13,40,100,57,38,4,-42,-63,7,28.25,-98,-69.75,0.3870967741935484,0.3090909090909091,0.7333333333333333
2022,Sacramento Kings,Pepperdine,Kessler Edwards,200.66,92.079176,SF,36,386,36,93,0.387,17,55,0.309,11,15,0.733,23,38,61,23,14,6,13,40,100,57,38,4,-42,-63,7,28.25,-98,-69.75,0.3870967741935484,0.3090909090909091,0.7333333333333333
2022,Sacramento Kings,Pepperdine,Kessler Edwards,200.66,92.079176,SF,36,386,36,93,0.387,17,55,0.309,11,15,0.733,23,38,61,23,14,6,13,40,100,57,38,4,-42,-63,7,28.25,-98,-69.75,0.3870967741935484,0.3090909090909091,0.7333333333333333
2022,Miami Heat,Indiana,Cody Zeller,210.82,108.86208,C,15,217,37,59,0.627,0,2,0.0,24,35,0.686,25,39,64,10,3,4,14,33,98,22,2,11,30,-6,13,19.6,37,56.6,0.6271186440677966,0.0,0.6857142857142857
2022,Miami Heat,Oakland,Jamal Cain,198.12,86.636072,PF,18,240,37,66,0.561,7,20,0.35,17,22,0.773,15,37,52,12,11,1,6,21,98,29,13,5,16,-18,12,21.7,10,31.7,0.5606060606060606,0.35,0.7727272727272727
2022,Dallas Mavericks,North Carolina,Theo Pinson,200.66,96.161504,SG,40,323,31,87,0.356,22,62,0.355,11,13,0.846,10,53,63,46,6,1,12,34,95,56,40,2,-50,-54,9,25.55,-95,-69.45,0.3563218390804598,0.3548387096774194,0.8461538461538461
2022,Portland Trail Blazers,Louisiana State,Skylar Mays,193.04,92.98636,PG,6,189,34,68,0.5,12,26,0.462,12,13,0.923,2,17,19,50,6,1,10,11,92,34,14,1,0,-6,11,15.7,5,20.7,0.5,0.46153846153846156,0.9230769230769231
2022,Minnesota Timberwolves,Michigan State,Bryn Forbes,187.96,92.98636,SG,25,268,30,83,0.361,14,46,0.304,15,15,1.0,4,11,15,17,7,2,12,22,89,53,32,0,-46,-54,15,6.4,-85,-78.6,0.3614457831325301,0.30434782608695654,1.0
2022,Los Angeles Lakers,Miami,Davon Reed,195.58,93.439952,SG,43,343,28,84,0.333,17,46,0.37,16,24,0.667,10,49,59,23,15,4,20,39,89,56,29,8,-56,-36,8,20.55,-84,-63.45,0.3333333333333333,0.3695652173913043,0.6666666666666666
2022,Los Angeles Lakers,Miami,Davon Reed,195.58,93.439952,SG,43,343,28,84,0.333,17,46,0.37,16,24,0.667,10,49,59,23,15,4,20,39,89,56,29,8,-56,-36,8,20.55,-84,-63.45,0.3333333333333333,0.3695652173913043,0.6666666666666666
2022,Los Angeles Lakers,Miami,Davon Reed,195.58,93.439952,SG,43,343,28,84,0.333,17,46,0.37,16,24,0.667,10,49,59,23,15,4,20,39,89,56,29,8,-56,-36,8,20.55,-84,-63.45,0.3333333333333333,0.3695652173913043,0.6666666666666666
2022,Los Angeles Lakers,Miami,Davon Reed,195.58,93.439952,SG,43,343,28,84,0.333,17,46,0.37,16,24,0.667,10,49,59,23,15,4,20,39,89,56,29,8,-56,-36,8,20.55,-84,-63.45,0.3333333333333333,0.3695652173913043,0.6666666666666666
2022,Los Angeles Lakers,Miami,Davon Reed,195.58,93.439952,SG,43,343,28,84,0.333,17,46,0.37,16,24,0.667,10,49,59,23,15,4,20,39,89,56,29,8,-56,-36,8,20.55,-84,-63.45,0.3333333333333333,0.3695652173913043,0.6666666666666666
2022,Los Angeles Lakers,Miami,Davon Reed,195.58,93.439952,SG,43,343,28,84,0.333,17,46,0.37,16,24,0.667,10,49,59,23,15,4,20,39,89,56,29,8,-56,-36,8,20.55,-84,-63.45,0.3333333333333333,0.3695652173913043,0.6666666666666666
2022,Los Angeles Lakers,Miami,Davon Reed,195.58,93.439952,SG,43,343,28,84,0.333,17,46,0.37,16,24,0.667,10,49,59,23,15,4,20,39,89,56,29,8,-56,-36,8,20.55,-84,-63.45,0.3333333333333333,0.3695652173913043,0.6666666666666666
2022,Los Angeles Lakers,Miami,Davon Reed,195.58,93.439952,SG,43,343,28,84,0.333,17,46,0.37,16,24,0.667,10,49,59,23,15,4,20,39,89,56,29,8,-56,-36,8,20.55,-84,-63.45,0.3333333333333333,0.3695652173913043,0.6666666666666666
2022,Los Angeles Lakers,Miami,Davon Reed,195.58,93.439952,SG,43,343,28,84,0.333,17,46,0.37,16,24,0.667,10,49,59,23,15,4,20,39,89,56,29,8,-56,-36,8,20.55,-84,-63.45,0.3333333333333333,0.3695652173913043,0.6666666666666666
2022,Houston Rockets,Wisconsin,Frank Kaminsky,213.36,108.86208,C,36,235,31,63,0.492,13,33,0.394,14,16,0.875,7,45,52,32,6,4,9,22,89,32,20,2,-2,-21,12,22.15,-11,11.149999999999999,0.49206349206349204,0.3939393939393939,0.875
2022,Houston Rockets,Wisconsin,Frank Kaminsky,213.36,108.86208,C,36,235,31,63,0.492,13,33,0.394,14,16,0.875,7,45,52,32,6,4,9,22,89,32,20,2,-2,-21,12,22.15,-11,11.149999999999999,0.49206349206349204,0.3939393939393939,0.875
2022,Houston Rockets,Wisconsin,Frank Kaminsky,213.36,108.86208,C,36,235,31,63,0.492,13,33,0.394,14,16,0.875,7,45,52,32,6,4,9,22,89,32,20,2,-2,-21,12,22.15,-11,11.149999999999999,0.49206349206349204,0.3939393939393939,0.875
2022,Houston Rockets,Wisconsin,Frank Kaminsky,213.36,108.86208,C,36,235,31,63,0.492,13,33,0.394,14,16,0.875,7,45,52,32,6,4,9,22,89,32,20,2,-2,-21,12,22.15,-11,11.149999999999999,0.49206349206349204,0.3939393939393939,0.875
2022,Houston Rockets,Wisconsin,Frank Kaminsky,213.36,108.86208,C,36,235,31,63,0.492,13,33,0.394,14,16,0.875,7,45,52,32,6,4,9,22,89,32,20,2,-2,-21,12,22.15,-11,11.149999999999999,0.49206349206349204,0.3939393939393939,0.875
2022,Houston Rockets,Wisconsin,Frank Kaminsky,213.36,108.86208,C,36,235,31,63,0.492,13,33,0.394,14,16,0.875,7,45,52,32,6,4,9,22,89,32,20,2,-2,-21,12,22.15,-11,11.149999999999999,0.49206349206349204,0.3939393939393939,0.875
2022,Houston Rockets,Wisconsin,Frank Kaminsky,213.36,108.86208,C,36,235,31,63,0.492,13,33,0.394,14,16,0.875,7,45,52,32,6,4,9,22,89,32,20,2,-2,-21,12,22.15,-11,11.149999999999999,0.49206349206349204,0.3939393939393939,0.875
2022,Houston Rockets,Wisconsin,Frank Kaminsky,213.36,108.86208,C,36,235,31,63,0.492,13,33,0.394,14,16,0.875,7,45,52,32,6,4,9,22,89,32,20,2,-2,-21,12,22.15,-11,11.149999999999999,0.49206349206349204,0.3939393939393939,0.875
2022,Houston Rockets,Wisconsin,Frank Kaminsky,213.36,108.86208,C,36,235,31,63,0.492,13,33,0.394,14,16,0.875,7,45,52,32,6,4,9,22,89,32,20,2,-2,-21,12,22.15,-11,11.149999999999999,0.49206349206349204,0.3939393939393939,0.875
2022,Chicago Bulls,Austin Peay,Terry Taylor,193.04,104.32616,PF,31,263,39,75,0.52,5,19,0.263,6,11,0.545,27,20,47,10,3,6,9,26,89,36,14,5,6,-27,1,19.7,-20,-0.3000000000000007,0.52,0.2631578947368421,0.5454545454545454
2022,Chicago Bulls,Austin Peay,Terry Taylor,193.04,104.32616,PF,31,263,39,75,0.52,5,19,0.263,6,11,0.545,27,20,47,10,3,6,9,26,89,36,14,5,6,-27,1,19.7,-20,-0.3000000000000007,0.52,0.2631578947368421,0.5454545454545454
2022,Chicago Bulls,Austin Peay,Terry Taylor,193.04,104.32616,PF,31,263,39,75,0.52,5,19,0.263,6,11,0.545,27,20,47,10,3,6,9,26,89,36,14,5,6,-27,1,19.7,-20,-0.3000000000000007,0.52,0.2631578947368421,0.5454545454545454
2022,Chicago Bulls,Austin Peay,Terry Taylor,193.04,104.32616,PF,31,263,39,75,0.52,5,19,0.263,6,11,0.545,27,20,47,10,3,6,9,26,89,36,14,5,6,-27,1,19.7,-20,-0.3000000000000007,0.52,0.2631578947368421,0.5454545454545454
2022,Chicago Bulls,Austin Peay,Terry Taylor,193.04,104.32616,PF,31,263,39,75,0.52,5,19,0.263,6,11,0.545,27,20,47,10,3,6,9,26,89,36,14,5,6,-27,1,19.7,-20,-0.3000000000000007,0.52,0.2631578947368421,0.5454545454545454
2022,Chicago Bulls,Austin Peay,Terry Taylor,193.04,104.32616,PF,31,263,39,75,0.52,5,19,0.263,6,11,0.545,27,20,47,10,3,6,9,26,89,36,14,5,6,-27,1,19.7,-20,-0.3000000000000007,0.52,0.2631578947368421,0.5454545454545454
2022,Chicago Bulls,Austin Peay,Terry Taylor,193.04,104.32616,PF,31,263,39,75,0.52,5,19,0.263,6,11,0.545,27,20,47,10,3,6,9,26,89,36,14,5,6,-27,1,19.7,-20,-0.3000000000000007,0.52,0.2631578947368421,0.5454545454545454
2022,Chicago Bulls,Austin Peay,Terry Taylor,193.04,104.32616,PF,31,263,39,75,0.52,5,19,0.263,6,11,0.545,27,20,47,10,3,6,9,26,89,36,14,5,6,-27,1,19.7,-20,-0.3000000000000007,0.52,0.2631578947368421,0.5454545454545454
2022,Chicago Bulls,Austin Peay,Terry Taylor,193.04,104.32616,PF,31,263,39,75,0.52,5,19,0.263,6,11,0.545,27,20,47,10,3,6,9,26,89,36,14,5,6,-27,1,19.7,-20,-0.3000000000000007,0.52,0.2631578947368421,0.5454545454545454
2022,Utah Jazz,UCLA,Johnny Juzang,198.12,94.800728,SG,18,232,35,104,0.337,15,63,0.238,2,4,0.5,8,31,39,8,4,3,3,13,87,69,48,2,-68,-99,0,15.1,-167,-151.9,0.33653846153846156,0.23809523809523808,0.5
2022,Chicago Bulls,Arizona,Dalen Terry,200.66,88.45044,SG,38,214,32,72,0.444,7,27,0.259,14,21,0.667,12,25,37,22,11,5,8,24,85,40,20,7,-16,-39,7,20.55,-48,-27.45,0.4444444444444444,0.25925925925925924,0.6666666666666666
2022,Brooklyn Nets,Providence,David Duke Jr.,193.04,92.532768,SG,23,228,36,78,0.462,1,12,0.083,12,17,0.706,11,18,29,21,10,1,18,31,85,42,11,5,-12,-30,7,10.2,-35,-24.8,0.46153846153846156,0.08333333333333333,0.7058823529411765
2022,Memphis Grizzlies,Tennessee,Kennedy Chandler,180.34,77.11064,PG,36,282,35,83,0.422,2,15,0.133,6,13,0.462,9,29,38,58,12,5,18,15,78,48,13,7,-26,-33,-1,25.0,-60,-35.0,0.42168674698795183,0.13333333333333333,0.46153846153846156
2022,Denver Nuggets,UCLA,Peyton Watson,200.66,90.7184,SG,23,186,29,59,0.492,6,14,0.429,11,20,0.55,8,29,37,11,2,11,8,14,75,30,8,9,-2,-6,2,15.8,-6,9.8,0.4915254237288136,0.42857142857142855,0.55
2022,Dallas Mavericks,Connecticut,Kemba Walker,182.88,83.46092800000001,PG,9,144,24,57,0.421,7,28,0.25,17,21,0.81,3,13,16,19,2,2,4,11,72,33,21,4,-18,-42,13,8.95,-47,-38.05,0.42105263157894735,0.25,0.8095238095238095
2022,Milwaukee Bucks,,Serge Ibaka,210.82,106.59412,C,16,185,26,54,0.481,6,18,0.333,8,13,0.615,15,29,44,4,2,7,11,23,66,28,12,5,-4,-18,3,13.6,-19,-5.4,0.48148148148148145,0.3333333333333333,0.6153846153846154
2022,Cleveland Cavaliers,North Carolina,Danny Green,198.12,97.52228,SG,11,139,22,49,0.449,16,37,0.432,1,1,1.0,3,11,14,6,6,3,10,16,61,27,21,0,-10,-15,1,4.45,-24,-19.55,0.4489795918367347,0.43243243243243246,1.0
2022,Cleveland Cavaliers,North Carolina,Danny Green,198.12,97.52228,SG,11,139,22,49,0.449,16,37,0.432,1,1,1.0,3,11,14,6,6,3,10,16,61,27,21,0,-10,-15,1,4.45,-24,-19.55,0.4489795918367347,0.43243243243243246,1.0
2022,Cleveland Cavaliers,North Carolina,Danny Green,198.12,97.52228,SG,11,139,22,49,0.449,16,37,0.432,1,1,1.0,3,11,14,6,6,3,10,16,61,27,21,0,-10,-15,1,4.45,-24,-19.55,0.4489795918367347,0.43243243243243246,1.0
2022,Cleveland Cavaliers,North Carolina,Danny Green,198.12,97.52228,SG,11,139,22,49,0.449,16,37,0.432,1,1,1.0,3,11,14,6,6,3,10,16,61,27,21,0,-10,-15,1,4.45,-24,-19.55,0.4489795918367347,0.43243243243243246,1.0
2022,Cleveland Cavaliers,North Carolina,Danny Green,198.12,97.52228,SG,11,139,22,49,0.449,16,37,0.432,1,1,1.0,3,11,14,6,6,3,10,16,61,27,21,0,-10,-15,1,4.45,-24,-19.55,0.4489795918367347,0.43243243243243246,1.0
2022,Cleveland Cavaliers,North Carolina,Danny Green,198.12,97.52228,SG,11,139,22,49,0.449,16,37,0.432,1,1,1.0,3,11,14,6,6,3,10,16,61,27,21,0,-10,-15,1,4.45,-24,-19.55,0.4489795918367347,0.43243243243243246,1.0
2022,Cleveland Cavaliers,North Carolina,Danny Green,198.12,97.52228,SG,11,139,22,49,0.449,16,37,0.432,1,1,1.0,3,11,14,6,6,3,10,16,61,27,21,0,-10,-15,1,4.45,-24,-19.55,0.4489795918367347,0.43243243243243246,1.0
2022,Cleveland Cavaliers,North Carolina,Danny Green,198.12,97.52228,SG,11,139,22,49,0.449,16,37,0.432,1,1,1.0,3,11,14,6,6,3,10,16,61,27,21,0,-10,-15,1,4.45,-24,-19.55,0.4489795918367347,0.43243243243243246,1.0
2022,Cleveland Cavaliers,North Carolina,Danny Green,198.12,97.52228,SG,11,139,22,49,0.449,16,37,0.432,1,1,1.0,3,11,14,6,6,3,10,16,61,27,21,0,-10,-15,1,4.45,-24,-19.55,0.4489795918367347,0.43243243243243246,1.0
2022,Cleveland Cavaliers,Virginia,Mamadi Diakite,205.74,103.418976,C,22,176,24,50,0.48,7,21,0.333,2,2,1.0,8,22,30,8,4,9,12,26,57,26,14,0,-4,-21,2,10.7,-23,-12.3,0.48,0.3333333333333333,1.0
2022,Washington Wizards,Texas A&M,Quenton Jackson,195.58,78.471416,PG,9,135,19,42,0.452,1,12,0.083,17,22,0.773,2,6,8,15,4,1,4,10,56,23,11,5,-8,-30,12,6.25,-26,-19.75,0.4523809523809524,0.08333333333333333,0.7727272727272727
2022,Orlando Magic,Florida State,Jonathan Isaac,208.28,104.32616,PF,11,124,22,53,0.415,6,15,0.4,5,9,0.556,15,29,44,6,14,4,4,5,55,31,9,4,-18,-9,1,23.0,-26,-3.0,0.41509433962264153,0.4,0.5555555555555556
2022,Atlanta Hawks,Florida State,Trent Forrest,193.04,95.25432,SG,23,277,25,60,0.417,0,2,0.0,2,3,0.667,5,32,37,38,7,2,15,17,52,35,2,1,-20,-6,1,16.15,-25,-8.850000000000001,0.4166666666666667,0.0,0.6666666666666666
2022,Indiana Pacers,Wake Forest,James Johnson,200.66,108.86208,PF,18,162,22,49,0.449,3,15,0.2,4,8,0.5,4,26,30,15,7,6,8,32,51,27,12,4,-10,-27,0,13.15,-37,-23.85,0.4489795918367347,0.2,0.5
2022,Washington Wizards,Virginia,Jay Huff,215.9,108.86208,C,7,95,15,25,0.6,6,12,0.5,15,16,0.938,6,15,21,10,3,4,5,15,51,10,6,1,10,0,14,9.5,24,33.5,0.6,0.5,0.9375
2022,Milwaukee Bucks,,Thanasis Antetokounmpo,200.66,99.336648,PF,37,206,20,46,0.435,0,8,0.0,11,22,0.5,15,29,44,15,3,3,12,22,51,26,8,11,-12,-24,0,14.4,-36,-21.6,0.43478260869565216,0.0,0.5
2022,New Orleans Pelicans,Louisiana State,Garrett Temple,198.12,88.45044,SG,25,162,18,45,0.4,11,26,0.423,3,4,0.75,5,12,17,13,9,2,4,15,50,27,15,1,-18,-12,2,11.5,-28,-16.5,0.4,0.4230769230769231,0.75
2022,Milwaukee Bucks,Iowa State,Lindell Wigginton,185.42,85.728888,PG,7,87,18,37,0.486,6,18,0.333,8,9,0.889,0,7,7,14,0,2,12,7,50,19,12,1,-2,-18,7,-0.10000000000000003,-13,-13.1,0.4864864864864865,0.3333333333333333,0.8888888888888888
2022,Indiana Pacers,,Daniel Theis,203.2,111.13004,C,7,109,21,44,0.477,2,11,0.182,5,12,0.417,7,15,22,9,2,6,3,7,49,23,9,7,-4,-21,-2,11.65,-27,-15.35,0.4772727272727273,0.18181818181818182,0.4166666666666667
2022,Sacramento Kings,,Matthew Dellavedova,190.5,90.7184,PG,32,213,17,50,0.34,9,27,0.333,4,7,0.571,1,12,13,41,7,0,10,20,47,33,18,3,-32,-27,1,11.25,-58,-46.75,0.34,0.3333333333333333,0.5714285714285714
2022,Minnesota Timberwolves,Memphis,Josh Minott,203.2,92.98636,SF,15,96,18,36,0.5,2,6,0.333,8,8,1.0,5,20,25,5,4,6,3,10,46,18,4,0,0,-6,8,11.75,2,13.75,0.5,0.3333333333333333,1.0
2022,Sacramento Kings,Stanford,KZ Okpala,203.2,97.52228,PF,35,248,16,38,0.421,7,21,0.333,7,8,0.875,7,27,34,13,7,7,7,39,46,22,14,1,-12,-21,6,15.05,-27,-11.95,0.42105263157894735,0.3333333333333333,0.875
2022,Detroit Pistons,Seton Hall,Jared Rhoden,198.12,95.25432,SG,14,198,17,44,0.386,5,20,0.25,6,6,1.0,11,26,37,4,4,1,3,23,45,27,15,0,-20,-30,6,12.85,-44,-31.15,0.38636363636363635,0.25,1.0
2022,Brooklyn Nets,Missouri,Dru Smith,190.5,92.079176,SG,15,158,18,45,0.4,5,19,0.263,3,3,1.0,2,22,24,22,10,4,3,23,44,27,14,0,-18,-27,3,16.35,-42,-25.65,0.4,0.2631578947368421,1.0
2022,Brooklyn Nets,Missouri,Dru Smith,190.5,92.079176,SG,15,158,18,45,0.4,5,19,0.263,3,3,1.0,2,22,24,22,10,4,3,23,44,27,14,0,-18,-27,3,16.35,-42,-25.65,0.4,0.2631578947368421,1.0
2022,Brooklyn Nets,Missouri,Dru Smith,190.5,92.079176,SG,15,158,18,45,0.4,5,19,0.263,3,3,1.0,2,22,24,22,10,4,3,23,44,27,14,0,-18,-27,3,16.35,-42,-25.65,0.4,0.2631578947368421,1.0
2022,Brooklyn Nets,Missouri,Dru Smith,190.5,92.079176,SG,15,158,18,45,0.4,5,19,0.263,3,3,1.0,2,22,24,22,10,4,3,23,44,27,14,0,-18,-27,3,16.35,-42,-25.65,0.4,0.2631578947368421,1.0
2022,Brooklyn Nets,Missouri,Dru Smith,190.5,92.079176,SG,15,158,18,45,0.4,5,19,0.263,3,3,1.0,2,22,24,22,10,4,3,23,44,27,14,0,-18,-27,3,16.35,-42,-25.65,0.4,0.2631578947368421,1.0
2022,Brooklyn Nets,Missouri,Dru Smith,190.5,92.079176,SG,15,158,18,45,0.4,5,19,0.263,3,3,1.0,2,22,24,22,10,4,3,23,44,27,14,0,-18,-27,3,16.35,-42,-25.65,0.4,0.2631578947368421,1.0
2022,Brooklyn Nets,Missouri,Dru Smith,190.5,92.079176,SG,15,158,18,45,0.4,5,19,0.263,3,3,1.0,2,22,24,22,10,4,3,23,44,27,14,0,-18,-27,3,16.35,-42,-25.65,0.4,0.2631578947368421,1.0
2022,Brooklyn Nets,Missouri,Dru Smith,190.5,92.079176,SG,15,158,18,45,0.4,5,19,0.263,3,3,1.0,2,22,24,22,10,4,3,23,44,27,14,0,-18,-27,3,16.35,-42,-25.65,0.4,0.2631578947368421,1.0
2022,Brooklyn Nets,Missouri,Dru Smith,190.5,92.079176,SG,15,158,18,45,0.4,5,19,0.263,3,3,1.0,2,22,24,22,10,4,3,23,44,27,14,0,-18,-27,3,16.35,-42,-25.65,0.4,0.2631578947368421,1.0
2022,Atlanta Hawks,Texas Tech,Jarrett Culver,198.12,88.45044,SF,10,137,17,43,0.395,1,12,0.083,9,13,0.692,10,28,38,6,6,2,7,14,44,26,11,4,-18,-30,5,13.3,-43,-29.7,0.3953488372093023,0.08333333333333333,0.6923076923076923
2022,Toronto Raptors,Georgetown,Otto Porter Jr.,203.2,89.811216,SF,8,146,15,30,0.5,6,17,0.353,8,8,1.0,6,13,19,8,11,0,4,7,44,15,11,0,0,-15,8,11.4,-7,4.4,0.5,0.35294117647058826,1.0
2022,Los Angeles Lakers,Tulsa,Shaquille Harrison,193.04,88.45044,SG,5,120,15,36,0.417,3,10,0.3,11,15,0.733,1,21,22,30,11,2,6,12,44,21,7,4,-12,-12,7,16.15,-17,-0.8500000000000014,0.4166666666666667,0.3,0.7333333333333333
2022,Sacramento Kings,Maryland,Alex Len,218.44,113.398,C,26,161,16,30,0.533,0,2,0.0,11,16,0.688,24,36,60,12,4,11,16,28,43,14,2,5,4,-6,6,22.1,4,26.1,0.5333333333333333,0.0,0.6875
2022,San Antonio Spurs,UNLV,Khem Birch,203.2,105.68693600000002,C,20,162,19,32,0.594,1,2,0.5,4,5,0.8,8,17,25,7,5,5,8,24,43,13,1,1,12,0,3,9.8,15,24.8,0.59375,0.5,0.8
2022,Milwaukee Bucks,Illinois,Meyers Leonard,213.36,117.93392,C,9,114,14,29,0.483,7,18,0.389,8,9,0.889,12,22,34,1,2,0,6,16,43,15,11,1,-2,-12,7,8.95,-7,1.9499999999999993,0.4827586206896552,0.3888888888888889,0.8888888888888888
2022,Philadelphia 76ers,Tennessee,Jaden Springer,193.04,91.625584,SG,16,89,17,35,0.486,2,5,0.4,6,8,0.75,6,8,14,8,7,3,3,15,42,18,3,2,-2,-3,4,9.75,-1,8.75,0.4857142857142857,0.4,0.75
2022,Minnesota Timberwolves,Duke,Wendell Moore Jr.,195.58,97.52228,SG,29,153,18,43,0.419,2,17,0.118,4,5,0.8,4,14,18,18,8,5,8,13,42,25,15,1,-14,-39,3,11.85,-50,-38.15,0.4186046511627907,0.11764705882352941,0.8
2022,Los Angeles Clippers,Ohio,Jason Preston,190.5,82.10015200000001,PG,14,124,18,41,0.439,5,18,0.278,0,2,0.0,2,20,22,27,2,0,10,7,41,23,13,2,-10,-24,-2,8.4,-36,-27.6,0.43902439024390244,0.2777777777777778,0.0
2022,Miami Heat,Georgetown,Omer Yurtseven,210.82,124.7378,C,9,83,16,27,0.593,3,7,0.429,5,6,0.833,8,15,23,2,2,2,4,16,40,11,4,1,10,-3,4,7.45,11,18.45,0.5925925925925926,0.42857142857142855,0.8333333333333334
2022,Washington Wizards,Winthrop,Xavier Cooks,203.2,83.007336,PF,10,126,17,28,0.607,0,1,0.0,4,10,0.4,16,22,38,6,6,4,8,13,38,11,1,6,12,-3,-2,15.35,7,22.35,0.6071428571428571,0.0,0.4
2022,Oklahoma City Thunder,Baylor,Jared Butler,190.5,87.543256,PG,6,77,15,32,0.469,7,14,0.5,0,0,0.0,1,3,4,8,5,0,5,5,37,17,7,0,-4,0,0,3.0,-4,-1.0,0.46875,0.5,
2022,Oklahoma City Thunder,Kentucky,Olivier Sarr,210.82,108.86208,C,9,114,15,30,0.5,1,8,0.125,5,7,0.714,12,19,31,4,1,5,4,17,36,15,7,2,0,-18,3,11.9,-15,-3.0999999999999996,0.5,0.125,0.7142857142857143
2022,Atlanta Hawks,,Vit Krejci,203.2,88.45044,PG,29,165,15,37,0.405,5,21,0.238,1,2,0.5,6,20,26,17,5,1,5,17,36,22,16,1,-14,-33,0,11.9,-47,-35.1,0.40540540540540543,0.23809523809523808,0.5
2022,Charlotte Hornets,Nevada,Cody Martin,198.12,92.98636,SF,7,134,14,36,0.389,3,14,0.214,4,7,0.571,8,16,24,11,4,1,2,13,35,22,11,3,-16,-24,1,11.6,-39,-27.4,0.3888888888888889,0.21428571428571427,0.5714285714285714
2022,Brooklyn Nets,Kentucky,Nerlens Noel,208.28,99.79024,C,17,195,13,36,0.361,1,2,0.5,8,12,0.667,10,36,46,10,16,10,13,32,35,23,1,4,-20,0,4,21.4,-16,5.399999999999999,0.3611111111111111,0.5,0.6666666666666666
2022,Brooklyn Nets,Kentucky,Nerlens Noel,208.28,99.79024,C,17,195,13,36,0.361,1,2,0.5,8,12,0.667,10,36,46,10,16,10,13,32,35,23,1,4,-20,0,4,21.4,-16,5.399999999999999,0.3611111111111111,0.5,0.6666666666666666
2022,Brooklyn Nets,Kentucky,Nerlens Noel,208.28,99.79024,C,17,195,13,36,0.361,1,2,0.5,8,12,0.667,10,36,46,10,16,10,13,32,35,23,1,4,-20,0,4,21.4,-16,5.399999999999999,0.3611111111111111,0.5,0.6666666666666666
2022,Brooklyn Nets,Kentucky,Nerlens Noel,208.28,99.79024,C,17,195,13,36,0.361,1,2,0.5,8,12,0.667,10,36,46,10,16,10,13,32,35,23,1,4,-20,0,4,21.4,-16,5.399999999999999,0.3611111111111111,0.5,0.6666666666666666
2022,Brooklyn Nets,Kentucky,Nerlens Noel,208.28,99.79024,C,17,195,13,36,0.361,1,2,0.5,8,12,0.667,10,36,46,10,16,10,13,32,35,23,1,4,-20,0,4,21.4,-16,5.399999999999999,0.3611111111111111,0.5,0.6666666666666666
2022,Brooklyn Nets,Kentucky,Nerlens Noel,208.28,99.79024,C,17,195,13,36,0.361,1,2,0.5,8,12,0.667,10,36,46,10,16,10,13,32,35,23,1,4,-20,0,4,21.4,-16,5.399999999999999,0.3611111111111111,0.5,0.6666666666666666
2022,Brooklyn Nets,Kentucky,Nerlens Noel,208.28,99.79024,C,17,195,13,36,0.361,1,2,0.5,8,12,0.667,10,36,46,10,16,10,13,32,35,23,1,4,-20,0,4,21.4,-16,5.399999999999999,0.3611111111111111,0.5,0.6666666666666666
2022,Brooklyn Nets,Kentucky,Nerlens Noel,208.28,99.79024,C,17,195,13,36,0.361,1,2,0.5,8,12,0.667,10,36,46,10,16,10,13,32,35,23,1,4,-20,0,4,21.4,-16,5.399999999999999,0.3611111111111111,0.5,0.6666666666666666
2022,Brooklyn Nets,Kentucky,Nerlens Noel,208.28,99.79024,C,17,195,13,36,0.361,1,2,0.5,8,12,0.667,10,36,46,10,16,10,13,32,35,23,1,4,-20,0,4,21.4,-16,5.399999999999999,0.3611111111111111,0.5,0.6666666666666666
2022,Cleveland Cavaliers,Southern California,Isaiah Mobley,203.2,107.954896,PF,12,84,12,28,0.429,3,8,0.375,4,4,1.0,4,16,20,3,4,3,1,8,31,16,5,0,-8,-6,4,9.35,-10,-0.6500000000000004,0.42857142857142855,0.375,1.0
2022,Memphis Grizzlies,Virginia Commonwealth,Vince Williams Jr.,193.04,92.98636,SG,15,105,12,40,0.3,4,28,0.143,2,2,1.0,4,11,15,4,6,2,5,12,30,28,24,0,-32,-60,2,6.65,-90,-83.35,0.3,0.14285714285714285,1.0
2022,Portland Trail Blazers,Texas,Greg Brown III,200.66,93.439952,PF,16,93,11,28,0.393,1,7,0.143,5,12,0.417,2,17,19,3,4,5,6,13,28,17,6,7,-12,-15,-2,6.85,-29,-22.15,0.39285714285714285,0.14285714285714285,0.4166666666666667
2022,San Antonio Spurs,St. Joseph's (PA),Jordan Hall,200.66,97.52228,SF,9,83,9,28,0.321,3,15,0.2,7,9,0.778,3,9,12,11,1,0,7,6,28,19,12,2,-20,-27,5,3.2,-42,-38.8,0.32142857142857145,0.2,0.7777777777777778
2022,San Antonio Spurs,Alabama,Joshua Primo,198.12,85.728888,SG,4,93,9,26,0.346,3,12,0.25,7,9,0.778,2,11,13,18,1,2,11,8,28,17,9,2,-16,-18,5,3.85,-29,-25.15,0.34615384615384615,0.25,0.7777777777777778
2022,Miami Heat,Florida,Udonis Haslem,200.66,106.59412,C,7,72,10,29,0.345,3,9,0.333,4,5,0.8,4,7,11,0,1,2,1,11,27,19,6,1,-18,-9,3,4.2,-24,-19.8,0.3448275862068966,0.3333333333333333,0.8
2022,Portland Trail Blazers,Villanova,Ryan Arcidiacono,190.5,88.45044,PG,20,172,9,37,0.243,8,23,0.348,0,0,0.0,0,15,15,23,5,0,7,17,26,28,15,0,-38,-21,0,7.65,-59,-51.35,0.24324324324324326,0.34782608695652173,
2022,Portland Trail Blazers,Villanova,Ryan Arcidiacono,190.5,88.45044,PG,20,172,9,37,0.243,8,23,0.348,0,0,0.0,0,15,15,23,5,0,7,17,26,28,15,0,-38,-21,0,7.65,-59,-51.35,0.24324324324324326,0.34782608695652173,
2022,Portland Trail Blazers,Villanova,Ryan Arcidiacono,190.5,88.45044,PG,20,172,9,37,0.243,8,23,0.348,0,0,0.0,0,15,15,23,5,0,7,17,26,28,15,0,-38,-21,0,7.65,-59,-51.35,0.24324324324324326,0.34782608695652173,
2022,Portland Trail Blazers,Villanova,Ryan Arcidiacono,190.5,88.45044,PG,20,172,9,37,0.243,8,23,0.348,0,0,0.0,0,15,15,23,5,0,7,17,26,28,15,0,-38,-21,0,7.65,-59,-51.35,0.24324324324324326,0.34782608695652173,
2022,Portland Trail Blazers,Villanova,Ryan Arcidiacono,190.5,88.45044,PG,20,172,9,37,0.243,8,23,0.348,0,0,0.0,0,15,15,23,5,0,7,17,26,28,15,0,-38,-21,0,7.65,-59,-51.35,0.24324324324324326,0.34782608695652173,
2022,Portland Trail Blazers,Villanova,Ryan Arcidiacono,190.5,88.45044,PG,20,172,9,37,0.243,8,23,0.348,0,0,0.0,0,15,15,23,5,0,7,17,26,28,15,0,-38,-21,0,7.65,-59,-51.35,0.24324324324324326,0.34782608695652173,
2022,Portland Trail Blazers,Villanova,Ryan Arcidiacono,190.5,88.45044,PG,20,172,9,37,0.243,8,23,0.348,0,0,0.0,0,15,15,23,5,0,7,17,26,28,15,0,-38,-21,0,7.65,-59,-51.35,0.24324324324324326,0.34782608695652173,
2022,Portland Trail Blazers,Villanova,Ryan Arcidiacono,190.5,88.45044,PG,20,172,9,37,0.243,8,23,0.348,0,0,0.0,0,15,15,23,5,0,7,17,26,28,15,0,-38,-21,0,7.65,-59,-51.35,0.24324324324324326,0.34782608695652173,
2022,Portland Trail Blazers,Villanova,Ryan Arcidiacono,190.5,88.45044,PG,20,172,9,37,0.243,8,23,0.348,0,0,0.0,0,15,15,23,5,0,7,17,26,28,15,0,-38,-21,0,7.65,-59,-51.35,0.24324324324324326,0.34782608695652173,
2022,Philadelphia 76ers,Texas Tech,Mac McClung,187.96,83.91452,SG,2,41,9,20,0.45,4,11,0.364,3,5,0.6,3,7,10,9,0,0,3,3,25,11,7,2,-4,-9,1,3.85,-12,-8.15,0.45,0.36363636363636365,0.6
2022,Boston Celtics,Indiana,Noah Vonleh,208.28,116.573144,C,23,172,11,24,0.458,1,4,0.25,2,2,1.0,18,30,48,7,2,8,11,35,25,13,3,0,-4,-6,2,16.0,-8,8.0,0.4583333333333333,0.25,1.0
2022,Cleveland Cavaliers,Utah State,Sam Merrill,193.04,92.98636,SG,5,59,9,22,0.409,5,18,0.278,2,2,1.0,0,9,9,5,4,0,0,3,25,13,13,0,-8,-24,2,5.35,-30,-24.65,0.4090909090909091,0.2777777777777778,1.0
2022,Indiana Pacers,Arizona,Gabe York,190.5,86.18248,SG,3,56,8,21,0.381,6,18,0.333,2,2,1.0,0,6,6,5,2,0,0,5,24,13,12,0,-10,-18,2,3.5,-26,-22.5,0.38095238095238093,0.3333333333333333,1.0
2022,Sacramento Kings,Alabama,Keon Ellis,190.5,79.3786,SG,16,71,7,16,0.438,6,12,0.5,4,7,0.571,4,4,8,6,5,1,1,10,24,9,6,3,-4,0,1,6.5,-3,3.5,0.4375,0.5,0.5714285714285714
2022,Utah Jazz,Wisconsin,Micah Potter,203.2,112.490816,PF,7,52,10,15,0.667,4,7,0.571,0,0,0.0,3,13,16,4,1,0,2,5,24,5,3,0,10,3,0,5.0,13,18.0,0.6666666666666666,0.5714285714285714,
2022,Golden State Warriors,Toledo,Ryan Rollins,190.5,81.64656,PG,12,62,7,20,0.35,3,9,0.333,6,6,1.0,3,9,12,6,1,1,16,10,23,13,6,0,-12,-9,6,-2.25,-15,-17.25,0.35,0.3333333333333333,1.0
2022,Utah Jazz,College of Charleston,Jarrell Brantley,195.58,113.398,PF,4,39,8,14,0.571,4,9,0.444,2,2,1.0,1,5,6,3,0,2,2,3,22,6,5,0,4,-3,2,2.35,3,5.35,0.5714285714285714,0.4444444444444444,1.0
2022,Sacramento Kings,South Carolina,PJ Dozier,198.12,92.98636,SF,16,79,10,33,0.303,2,16,0.125,0,0,0.0,1,13,14,10,6,1,5,7,22,23,14,0,-26,-36,0,6.9,-62,-55.1,0.30303030303030304,0.125,
2022,Denver Nuggets,Duke,Jack White,200.66,102.0582,SF,17,66,8,19,0.421,3,9,0.333,2,3,0.667,6,11,17,4,3,2,2,9,21,11,6,1,-6,-9,1,7.8,-14,-6.2,0.42105263157894735,0.3333333333333333,0.6666666666666666
2022,Indiana Pacers,New Mexico State,Trevelin Queen,198.12,86.18248,SG,7,70,7,29,0.241,2,15,0.133,5,5,1.0,8,9,17,6,2,5,7,4,21,22,13,0,-30,-33,5,7.55,-58,-50.45,0.2413793103448276,0.13333333333333333,1.0
2022,Atlanta Hawks,Connecticut,Tyrese Martin,198.12,97.52228,SG,16,66,9,23,0.391,1,7,0.143,2,2,1.0,5,7,12,2,1,0,2,2,21,14,6,0,-10,-15,2,4.15,-23,-18.85,0.391304347826087,0.14285714285714285,1.0
2022,Chicago Bulls,Louisville,Carlik Jones,182.88,78.92500799999999,PG,7,56,6,15,0.4,3,6,0.5,5,8,0.625,1,4,5,6,2,0,2,2,20,9,3,3,-6,0,2,2.9,-4,-1.1,0.4,0.5,0.625
2022,Boston Celtics,North Carolina,Justin Jackson,203.2,99.79024,SF,23,107,7,27,0.259,5,20,0.25,1,2,0.5,2,15,17,9,4,4,2,7,20,20,15,1,-26,-30,0,9.65,-56,-46.35,0.25925925925925924,0.25,0.5
2022,Philadelphia 76ers,Oregon,Louis King,200.66,92.98636,PF,1,29,8,13,0.615,4,8,0.5,0,1,0.0,2,2,4,2,1,0,2,4,20,5,4,1,6,0,-1,1.3,5,6.3,0.6153846153846154,0.5,0.0
2022,Toronto Raptors,Rutgers,Ron Harper Jr.,195.58,111.13004,PF,9,48,8,16,0.5,3,9,0.333,1,1,1.0,3,4,7,4,0,1,0,3,20,8,6,0,0,-9,1,3.85,-8,-4.15,0.5,0.3333333333333333,1.0
2022,Boston Celtics,Alabama,JD Davison,185.42,88.45044,SG,12,66,8,19,0.421,2,7,0.286,1,2,0.5,2,7,9,11,2,2,4,5,19,11,5,1,-6,-9,0,5.25,-15,-9.75,0.42105263157894735,0.2857142857142857,0.5
2022,Chicago Bulls,North Carolina,Tony Bradley,210.82,112.490816,C,12,33,6,12,0.5,3,5,0.6,4,4,1.0,1,10,11,1,1,1,1,2,19,6,2,0,0,3,4,3.65,7,10.65,0.5,0.6,1.0
2022,Golden State Warriors,Arizona,Andre Iguodala,198.12,97.52228,PF,8,113,7,15,0.467,1,9,0.111,2,3,0.667,3,14,17,19,4,3,9,11,17,8,8,1,-2,-21,1,8.2,-22,-13.8,0.4666666666666667,0.1111111111111111,0.6666666666666666
2022,Portland Trail Blazers,Providence,Justin Minaya,200.66,95.25432,SF,4,89,7,23,0.304,3,12,0.25,0,1,0.0,3,12,15,4,2,5,4,9,17,16,9,1,-18,-18,-1,6.55,-37,-30.45,0.30434782608695654,0.25,0.0
2022,Orlando Magic,Syracuse,Michael Carter-Williams,195.58,86.18248,PG,4,44,6,14,0.429,1,3,0.333,4,7,0.571,1,4,5,7,1,1,4,5,17,8,2,3,-4,-3,1,2.0,-6,-4.0,0.42857142857142855,0.3333333333333333,0.5714285714285714
2022,Charlotte Hornets,Kansas State,Xavier Sneed,195.58,97.52228,SF,4,48,5,10,0.5,3,6,0.5,4,4,1.0,0,5,5,5,0,1,3,7,17,5,3,0,0,0,4,1.15,4,5.15,0.5,0.5,1.0
2022,Detroit Pistons,Syracuse,Buddy Boeheim,198.12,92.98636,SF,10,90,5,27,0.185,4,25,0.16,2,2,1.0,2,4,6,4,2,0,0,6,16,22,21,0,-34,-51,2,3.7,-83,-79.3,0.18518518518518517,0.16,1.0
2022,Brooklyn Nets,Florida State,RaiQuan Gray,200.66,122.016248,PF,1,35,6,12,0.5,2,5,0.4,2,2,1.0,3,6,9,7,0,1,4,5,16,6,3,0,0,-3,2,3.0,-1,2.0,0.5,0.4,1.0
2022,Houston Rockets,Louisiana State,Darius Days,200.66,111.13004,SF,4,25,5,12,0.417,3,10,0.3,2,2,1.0,1,5,6,1,0,1,0,2,15,7,7,0,-4,-12,2,2.4,-14,-11.6,0.4166666666666667,0.3,1.0
2022,Washington Wizards,San Francisco,Jamaree Bouyea,187.96,81.64656,PG,5,71,6,14,0.429,2,6,0.333,1,2,0.5,1,5,6,4,4,2,4,6,15,8,4,1,-4,-6,0,3.45,-10,-6.55,0.42857142857142855,0.3333333333333333,0.5
2022,Washington Wizards,San Francisco,Jamaree Bouyea,187.96,81.64656,PG,5,71,6,14,0.429,2,6,0.333,1,2,0.5,1,5,6,4,4,2,4,6,15,8,4,1,-4,-6,0,3.45,-10,-6.55,0.42857142857142855,0.3333333333333333,0.5
2022,Washington Wizards,San Francisco,Jamaree Bouyea,187.96,81.64656,PG,5,71,6,14,0.429,2,6,0.333,1,2,0.5,1,5,6,4,4,2,4,6,15,8,4,1,-4,-6,0,3.45,-10,-6.55,0.42857142857142855,0.3333333333333333,0.5
2022,Washington Wizards,San Francisco,Jamaree Bouyea,187.96,81.64656,PG,5,71,6,14,0.429,2,6,0.333,1,2,0.5,1,5,6,4,4,2,4,6,15,8,4,1,-4,-6,0,3.45,-10,-6.55,0.42857142857142855,0.3333333333333333,0.5
2022,Washington Wizards,San Francisco,Jamaree Bouyea,187.96,81.64656,PG,5,71,6,14,0.429,2,6,0.333,1,2,0.5,1,5,6,4,4,2,4,6,15,8,4,1,-4,-6,0,3.45,-10,-6.55,0.42857142857142855,0.3333333333333333,0.5
2022,Washington Wizards,San Francisco,Jamaree Bouyea,187.96,81.64656,PG,5,71,6,14,0.429,2,6,0.333,1,2,0.5,1,5,6,4,4,2,4,6,15,8,4,1,-4,-6,0,3.45,-10,-6.55,0.42857142857142855,0.3333333333333333,0.5
2022,Washington Wizards,San Francisco,Jamaree Bouyea,187.96,81.64656,PG,5,71,6,14,0.429,2,6,0.333,1,2,0.5,1,5,6,4,4,2,4,6,15,8,4,1,-4,-6,0,3.45,-10,-6.55,0.42857142857142855,0.3333333333333333,0.5
2022,Washington Wizards,San Francisco,Jamaree Bouyea,187.96,81.64656,PG,5,71,6,14,0.429,2,6,0.333,1,2,0.5,1,5,6,4,4,2,4,6,15,8,4,1,-4,-6,0,3.45,-10,-6.55,0.42857142857142855,0.3333333333333333,0.5
2022,Washington Wizards,San Francisco,Jamaree Bouyea,187.96,81.64656,PG,5,71,6,14,0.429,2,6,0.333,1,2,0.5,1,5,6,4,4,2,4,6,15,8,4,1,-4,-6,0,3.45,-10,-6.55,0.42857142857142855,0.3333333333333333,0.5
2022,Los Angeles Lakers,Vanderbilt,Scotty Pippen Jr.,185.42,77.11064,PG,6,32,4,12,0.333,1,3,0.333,5,9,0.556,2,2,4,2,2,1,2,3,14,8,2,4,-8,-3,1,2.35,-10,-7.65,0.3333333333333333,0.3333333333333333,0.5555555555555556
2022,Orlando Magic,John A. Logan,Jay Scrubb,195.58,99.79024,SG,2,30,5,7,0.714,2,2,1.0,1,2,0.5,0,6,6,1,2,0,3,2,13,2,0,1,6,6,0,1.15,12,13.15,0.7142857142857143,1.0,0.5
2022,Sacramento Kings,Utah State,Neemias Queta,213.36,112.490816,C,5,29,6,9,0.667,0,0,0.0,0,2,0.0,5,6,11,1,0,2,1,7,12,3,0,2,6,0,-2,4.4,4,8.4,0.6666666666666666,,0.0
2022,Boston Celtics,Pittsburgh,Justin Champagnie,198.12,93.439952,SF,5,34,5,15,0.333,1,5,0.2,0,0,0.0,3,5,8,4,1,0,0,2,11,10,4,0,-10,-9,0,4.15,-19,-14.85,0.3333333333333333,0.2,
2022,Boston Celtics,Pittsburgh,Justin Champagnie,198.12,93.439952,SF,5,34,5,15,0.333,1,5,0.2,0,0,0.0,3,5,8,4,1,0,0,2,11,10,4,0,-10,-9,0,4.15,-19,-14.85,0.3333333333333333,0.2,
2022,Boston Celtics,Pittsburgh,Justin Champagnie,198.12,93.439952,SF,5,34,5,15,0.333,1,5,0.2,0,0,0.0,3,5,8,4,1,0,0,2,11,10,4,0,-10,-9,0,4.15,-19,-14.85,0.3333333333333333,0.2,
2022,Boston Celtics,Pittsburgh,Justin Champagnie,198.12,93.439952,SF,5,34,5,15,0.333,1,5,0.2,0,0,0.0,3,5,8,4,1,0,0,2,11,10,4,0,-10,-9,0,4.15,-19,-14.85,0.3333333333333333,0.2,
2022,Boston Celtics,Pittsburgh,Justin Champagnie,198.12,93.439952,SF,5,34,5,15,0.333,1,5,0.2,0,0,0.0,3,5,8,4,1,0,0,2,11,10,4,0,-10,-9,0,4.15,-19,-14.85,0.3333333333333333,0.2,
2022,Boston Celtics,Pittsburgh,Justin Champagnie,198.12,93.439952,SF,5,34,5,15,0.333,1,5,0.2,0,0,0.0,3,5,8,4,1,0,0,2,11,10,4,0,-10,-9,0,4.15,-19,-14.85,0.3333333333333333,0.2,
2022,Boston Celtics,Pittsburgh,Justin Champagnie,198.12,93.439952,SF,5,34,5,15,0.333,1,5,0.2,0,0,0.0,3,5,8,4,1,0,0,2,11,10,4,0,-10,-9,0,4.15,-19,-14.85,0.3333333333333333,0.2,
2022,Boston Celtics,Pittsburgh,Justin Champagnie,198.12,93.439952,SF,5,34,5,15,0.333,1,5,0.2,0,0,0.0,3,5,8,4,1,0,0,2,11,10,4,0,-10,-9,0,4.15,-19,-14.85,0.3333333333333333,0.2,
2022,Boston Celtics,Pittsburgh,Justin Champagnie,198.12,93.439952,SF,5,34,5,15,0.333,1,5,0.2,0,0,0.0,3,5,8,4,1,0,0,2,11,10,4,0,-10,-9,0,4.15,-19,-14.85,0.3333333333333333,0.2,
2022,Dallas Mavericks,,Facundo Campazzo,177.8,88.45044,PG,8,52,3,13,0.231,3,11,0.273,1,2,0.5,0,2,2,9,6,0,3,3,10,10,8,1,-14,-15,0,4.1,-29,-24.9,0.23076923076923078,0.2727272727272727,0.5
2022,Golden State Warriors,Memphis,Lester Quinones,193.04,94.347136,SG,4,18,2,5,0.4,2,4,0.5,4,6,0.667,1,2,3,2,1,0,5,0,10,3,2,2,-2,0,2,-0.5,0,-0.5,0.4,0.5,0.6666666666666666
2022,Los Angeles Lakers,Syracuse,Cole Swider,205.74,99.79024,SF,7,41,3,9,0.333,3,8,0.375,0,0,0.0,1,6,7,4,0,0,0,3,9,6,5,0,-6,-6,0,2.85,-12,-9.15,0.3333333333333333,0.375,
2022,Washington Wizards,,Isaiah Todd,205.74,99.336648,PF,6,61,3,19,0.158,1,10,0.1,2,2,1.0,2,10,12,4,1,0,2,4,9,16,9,0,-26,-24,2,3.8,-48,-44.2,0.15789473684210525,0.1,1.0
2022,Toronto Raptors,Iowa,Joe Wieskamp,198.12,92.98636,SF,9,50,3,14,0.214,3,12,0.25,0,0,0.0,0,4,4,3,0,0,1,3,9,11,9,0,-16,-18,0,1.1,-34,-32.9,0.21428571428571427,0.25,
2022,Indiana Pacers,Baylor,Kendall Brown,200.66,92.98636,SG,6,40,4,7,0.571,0,1,0.0,1,2,0.5,2,4,6,3,4,0,2,9,9,3,1,1,2,-3,0,3.3,-1,2.3,0.5714285714285714,0.0,0.5
2022,Houston Rockets,Northwest Missouri State,Trevor Hudgins,182.88,81.64656,PG,5,28,2,9,0.222,2,8,0.25,3,3,1.0,0,0,0,3,0,0,1,1,9,7,6,0,-10,-12,3,0.2,-19,-18.8,0.2222222222222222,0.25,1.0
2022,Dallas Mavericks,Oregon,Tyler Dorsey,193.04,81.64656,SF,3,8,4,5,0.8,1,2,0.5,0,0,0.0,1,1,2,0,0,0,0,0,9,1,1,0,6,0,0,0.75,6,6.75,0.8,0.5,
2022,San Antonio Spurs,Missouri State,Alize Johnson,203.2,96.161504,PF,4,30,3,6,0.5,0,2,0.0,1,2,0.5,2,8,10,1,1,0,4,3,7,3,2,1,0,-6,0,1.6,-6,-4.4,0.5,0.0,0.5
2022,Portland Trail Blazers,Arizona,Chance Comanche,208.28,95.25432,C,1,21,3,5,0.6,0,0,0.0,1,4,0.25,2,1,3,0,0,1,0,0,7,2,0,3,2,0,-2,1.75,0,1.75,0.6,,0.25
2022,Los Angeles Clippers,Morehead State,Xavier Moon,182.88,74.84268,SG,4,20,3,9,0.333,1,3,0.333,0,0,0.0,0,3,3,5,0,0,1,2,7,6,2,0,-6,-3,0,1.4,-9,-7.6,0.3333333333333333,0.3333333333333333,
2022,Utah Jazz,,Leandro Bolmaro,198.12,90.7184,SF,14,68,3,20,0.15,0,4,0.0,0,0,0.0,4,3,7,7,3,1,7,10,6,17,4,0,-28,-12,0,2.5,-40,-37.5,0.15,0.0,
2022,Chicago Bulls,,Marko Simonovic,213.36,99.79024,C,7,20,2,7,0.286,1,4,0.25,1,2,0.5,1,1,2,0,0,0,0,5,6,5,3,1,-6,-6,0,0.5,-12,-11.5,0.2857142857142857,0.25,0.5
2022,Boston Celtics,Florida State,Mfiondu Kabengele,208.28,113.398,PF,4,36,2,7,0.286,0,3,0.0,2,2,1.0,5,5,10,0,2,0,1,3,6,5,3,0,-6,-9,2,4.1,-13,-8.9,0.2857142857142857,0.0,1.0
2022,Utah Jazz,Duke,Vernon Carey Jr.,208.28,122.46984,C,11,28,2,8,0.25,0,0,0.0,2,2,1.0,3,8,11,3,2,2,2,5,6,6,0,0,-8,0,2,5.0,-6,-1.0,0.25,,1.0
2022,Cleveland Cavaliers,Belmont,Dylan Windler,200.66,88.904032,SF,3,10,2,3,0.667,1,2,0.5,0,0,0.0,0,0,0,1,1,0,1,0,5,1,1,0,2,0,0,0.25,2,2.25,0.6666666666666666,0.5,
2022,Charlotte Hornets,Arizona,Kobi Simmons,195.58,81.64656,SG,5,28,1,6,0.167,1,5,0.2,2,2,1.0,1,3,4,5,0,2,1,0,5,5,4,0,-8,-9,2,3.0,-15,-12.0,0.16666666666666666,0.2,1.0
2022,Chicago Bulls,Illinois,Malcolm Hill,198.12,99.79024,SF,5,9,2,4,0.5,1,3,0.333,0,0,0.0,0,3,3,0,0,0,0,1,5,2,2,0,0,-3,0,0.7,-3,-2.3,0.5,0.3333333333333333,
2022,Detroit Pistons,Virginia,Braxton Key,203.2,102.0582,SF,3,9,1,1,1.0,0,0,0.0,2,2,1.0,0,1,1,0,0,0,0,0,4,0,0,0,2,0,2,0.25,4,4.25,1.0,,1.0
2022,New Orleans Pelicans,North Carolina State,Dereon Seabron,195.58,81.64656,SG,5,12,2,5,0.4,0,0,0.0,0,0,0.0,1,0,1,0,0,0,0,1,4,3,0,0,-2,0,0,0.45,-2,-1.55,0.4,,
2022,Atlanta Hawks,UNLV,Donovan Williams,198.12,86.18248,SG,2,4,2,5,0.4,0,2,0.0,0,0,0.0,0,2,2,0,0,0,0,0,4,3,2,0,-2,-6,0,0.5,-8,-7.5,0.4,0.0,
2022,Washington Wizards,Kansas,Devon Dotson,185.42,83.91452,PG,6,53,1,10,0.1,1,4,0.25,0,0,0.0,6,4,10,8,5,0,3,9,3,9,3,0,-16,-6,0,6.55,-22,-15.45,0.1,0.25,
2022,Memphis Grizzlies,Richmond,Jacob Gilyard,175.26,72.57472,PG,1,41,1,3,0.333,1,3,0.333,0,0,0.0,0,4,4,7,3,0,2,3,3,2,2,0,-2,-3,0,3.1,-5,-1.9,0.3333333333333333,0.3333333333333333,
2022,Washington Wizards,San Diego State,Jordan Schakel,198.12,90.7184,SF,2,6,1,2,0.5,1,1,1.0,0,0,0.0,0,0,0,1,1,0,0,1,3,1,0,0,0,3,0,0.7,3,3.7,0.5,1.0,
2022,New York Knicks,Duke,Trevor Keels,193.04,100.243832,SG,3,8,1,4,0.25,1,4,0.25,0,0,0.0,0,2,2,0,0,0,0,0,3,3,3,0,-4,-6,0,0.5,-10,-9.5,0.25,0.25,
2022,Sacramento Kings,Cal-Davis,Chima Moneke,195.58,101.151016,SF,2,8,1,2,0.5,0,0,0.0,0,2,0.0,2,0,2,1,0,0,2,2,2,1,0,2,0,0,-2,0.15,-2,-1.85,0.5,,0.0
2022,Dallas Mavericks,South Carolina,Chris Silva,203.2,106.140528,PF,1,3,1,1,1.0,0,0,0.0,0,0,0.0,0,0,0,0,0,0,1,2,2,0,0,0,2,0,0,-0.6,2,1.4,1.0,,
2022,Detroit Pistons,Arkansas,Stanley Umude,198.12,95.25432,SG,1,2,0,1,0.0,0,1,0.0,2,2,1.0,0,0,0,0,1,1,0,0,2,1,1,0,-2,-3,2,1.0,-3,-2.0,0.0,0.0,1.0
2022,Brooklyn Nets,Wake Forest,Alondes Williams,193.04,95.25432,SG,1,5,0,0,0.0,0,0,0.0,0,0,0.0,0,1,1,0,0,0,2,1,0,0,0,0,0,0,0,-0.8,0,-0.8,,,
2022,Sacramento Kings,Iowa State,Deonte Burton,193.04,108.86208,PF,2,7,0,2,0.0,0,1,0.0,0,0,0.0,0,0,0,0,0,0,0,0,0,2,1,0,-4,-3,0,0.0,-7,-7.0,0.0,0.0,
2022,Utah Jazz,Duke,Frank Jackson,190.5,92.98636,PG,1,5,0,3,0.0,0,1,0.0,0,0,0.0,1,1,2,1,0,0,0,0,0,3,1,0,-6,-3,0,1.0,-9,-8.0,0.0,0.0,
2022,Philadelphia 76ers,,Michael Foster Jr.,203.2,113.398,PF,1,1,0,0,0.0,0,0,0.0,0,0,0.0,0,0,0,0,0,0,0,0,0,0,0,0,0,0,0,0.0,0,0.0,,,
2022,Los Angeles Lakers,Southern Methodist,Sterling Brown,195.58,99.336648,SF,4,24,0,4,0.0,0,2,0.0,0,0,0.0,3,5,8,2,3,0,0,4,0,4,2,0,-8,-6,0,4.55,-14,-9.45,0.0,0.0,
